aabfnbaaaa	TRUE
aaccfhaaaa	TRUE
ajmhhgaaaa	TRUE
ajndabaaaa	TRUE
beoinbaaaa	TRUE
beokhgaaaa	TRUE
boofloaaaa	TRUE
bopapcaaaa	TRUE
ckagimaaaa	TRUE
ckbihoaaaa	TRUE
deehaoaaaa	TRUE
defjhdaaaa	TRUE
donampaaaa	TRUE
donodfaaaa	TRUE
eikkanaaaa	TRUE
eilkpjaaaa	TRUE
fbnffkaaaa	TRUE
fbnijaaaac	TRUE
fllhliaaaa	TRUE
flmbmlaaaa	TRUE
geoimcaaaa	TRUE
gepdhaaaag	TRUE
gphjjjaaaa	TRUE
gpiajlaaaa	TRUE
hjjipdaaaa	TRUE
hjkaogaaaa	TRUE
iffdhcaaaa	TRUE
iffnbbaaaa	TRUE
jamjjhaaaa	TRUE
jandamaaaa	TRUE
jlechcaaaa	TRUE
jlechpaaaa	TRUE
kgjjcoaaaa	TRUE
kgkpanaaaa	TRUE
lbkcgaaaak	TRUE
lbkdgpaaaa	TRUE
lmedclaaaa	TRUE
lmefpkaaaa	TRUE
mfiignaaaa	TRUE
mfjmhlaaaa	TRUE
mphfkdaaaa	TRUE
mphljjaaaa	TRUE
niemccaaaa	TRUE
niflneaaaa	TRUE
oboolkaaaa	TRUE
oboppmaaaa	TRUE
ombjlgaaaa	TRUE
ombmboaaaa	TRUE
pggcdoaaaa	TRUE
pggcmhaaaa	TRUE
aabfnbcfhe	FALSE
aacfebejch	FALSE
ajoefcgljn	FALSE
ajogjaejon	FALSE
beidbjodba	FALSE
beidhoekfe	FALSE
booebmhekf	FALSE
boohoaeggf	FALSE
ckamdlaipk	FALSE
ckdcjhdhcb	FALSE
denbmmlkpi	FALSE
depllfdkbh	FALSE
donjjibobo	FALSE
dooicnpikm	FALSE
ehlgjbkfhp	FALSE
ehljldodno	FALSE
fbmfbifgkd	FALSE
fbmfekadmk	FALSE
fldlnlnhoe	FALSE
fleghcfmdg	FALSE
gfmcegipmm	FALSE
gfmcgogcha	FALSE
gpkfmdijcg	FALSE
gplnpoekne	FALSE
hkhjbalije	FALSE
hkhkamkhdb	FALSE
iflalfieen	FALSE
ifmfnfmegm	FALSE
jamjbhlejc	FALSE
jankffickp	FALSE
jlkgnbblhi	FALSE
jlkjmhgbcm	FALSE
kgfalnnmjm	FALSE
kgfghinnii	FALSE
lbhoekgfkf	FALSE
lbigikkehf	FALSE
llefapkhih	FALSE
lleoebgddc	FALSE
mflcklcbko	FALSE
mfljomcfde	FALSE
mphoidgpae	FALSE
mpiancdhke	FALSE
niblfdoibj	FALSE
nibnpmbedd	FALSE
obncimpmmo	FALSE
obopnhdbgi	FALSE
olmandngfc	FALSE
olmclpejll	FALSE
pghhjaiaci	FALSE
pgiiallcoh	FALSE
aaaidooaaaa	TRUE
aaaikhoaaaa	TRUE
akpfdpiaaaa	TRUE
akphhdcaaaa	TRUE
bfbddlaaaae	TRUE
bfgcnliaaaa	TRUE
caamidgaaaa	TRUE
caaoldoaaaa	TRUE
ckocgnnaaaa	TRUE
ckpejkpaaaa	TRUE
dfeaalnaaaa	TRUE
dffgjfiaaaa	TRUE
dpljboaaaao	TRUE
dpnkijcaaaa	TRUE
ejaggmbaaaa	TRUE
ejajegcaaaa	TRUE
fdalonoaaaa	TRUE
fdcaicoaaaa	TRUE
fnolhejaaaa	TRUE
fnollddaaaa	TRUE
ghmkmjdaaaa	TRUE
ghnkbjmaaaa	TRUE
hcagkflaaaa	TRUE
hcandegaaaa	TRUE
hmjkkijaaaa	TRUE
hmkcigeaaaa	TRUE
ihekkkcaaaa	TRUE
ihfdjeiaaaa	TRUE
jbkdlceaaaa	TRUE
jbkmdfjaaaa	TRUE
jmbamdpaaaa	TRUE
jmbdmbbaaaa	TRUE
kfimjfjaaaa	TRUE
kfjbncjaaaa	TRUE
koohconaaaa	TRUE
kooijheaaaa	TRUE
ljjdkimaaaa	TRUE
ljkbppaaaai	TRUE
mdpcdemaaaa	TRUE
mebpappaaaa	TRUE
moehodnaaaa	TRUE
mofddhbaaaa	TRUE
nibfmcpaaaa	TRUE
nicmmakaaaa	TRUE
occkpaiaaaa	TRUE
ocdbnhoaaaa	TRUE
oljnagoaaaa	TRUE
olkpnijaaaa	TRUE
pganlldaaaa	TRUE
pgbeaanaaaa	TRUE
aaajdoohomm	FALSE
aaajkknpmpd	FALSE
akoeoielmme	FALSE
akpcoekkmil	FALSE
bfebojmgaol	FALSE
bfefnfphjng	FALSE
caanjebknim	FALSE
caaogjihego	FALSE
clckgbkpogm	FALSE
clebciefjmk	FALSE
denahpeekdi	FALSE
depppjemknf	FALSE
dpkonbnlome	FALSE
dpldfphnplh	FALSE
ejammopadig	FALSE
ejbekgmkgih	FALSE
fcnlfeapddh	FALSE
fcnonfcdcdk	FALSE
fneipcfeomg	FALSE
fnfaknicfej	FALSE
ggnflnlfhfa	FALSE
ggnhdcknpdk	FALSE
hbhphleecjo	FALSE
hbiafimcefc	FALSE
hmdelhaeldp	FALSE
hmdhhkcfjci	FALSE
igngcnjfobb	FALSE
ignpclacihf	FALSE
jbehbnplccm	FALSE
jbflakeckmg	FALSE
jmcjlfjnima	FALSE
jmdekadlgko	FALSE
kflkfnlofbl	FALSE
kfokkkjfdfj	FALSE
kopechdkmpj	FALSE
kpacnlhiknk	FALSE
lhooafmndok	FALSE
libjmjbmekm	FALSE
mddnokkkcjd	FALSE
mddpgbchflg	FALSE
momjlajioaj	FALSE
momokmajpem	FALSE
nhnfhdepecf	FALSE
nhnglpneknn	FALSE
ocfbdbmagcf	FALSE
ocgdoabokkl	FALSE
omcnbafpbio	FALSE
omdkjfdghji	FALSE
pfmlhhlgnoj	FALSE
pfoakmhhdpf	FALSE
aadcoedcaaaa	TRUE
aadilmbnaaaa	TRUE
akdlaadiaaaa	TRUE
akdnhnonaaaa	TRUE
beadjhmpaaaa	TRUE
beahjcbkaaaa	TRUE
bodblnpdaaaa	TRUE
bofgenneaaaa	TRUE
cjajdeilaaaa	TRUE
cjbhbphpaaaa	TRUE
deachcflaaaa	TRUE
deadjdjbaaaa	TRUE
dodgidbdaaaa	TRUE
doeclaooaaaa	TRUE
eiciammiaaaa	TRUE
eicpljmoaaaa	TRUE
fbmbfcliaaaa	TRUE
fbomcnfbaaaa	TRUE
flihehhdaaaa	TRUE
flijgpcaaaan	TRUE
genlkmlfaaaa	TRUE
genlncnpaaaa	TRUE
gpoapapfaaaa	TRUE
gppmdlemaaaa	TRUE
hinnkiebaaaa	TRUE
hiofmmlcaaaa	TRUE
idjckfngaaaa	TRUE
idklojlnaaaa	TRUE
incjgodcaaaa	TRUE
ineefhmfaaaa	TRUE
jhcffbcgaaaa	TRUE
jhcjoipeaaaa	TRUE
kbijpdceaaaa	TRUE
kbjgkfhbaaaa	TRUE
klelkhimaaaa	TRUE
klfnjfbpaaaa	TRUE
lfgpiponaaaa	TRUE
lfhagkamaaaa	TRUE
lpmlagojaaaa	TRUE
lpnokdppaaaa	TRUE
mkahpgegaaaa	TRUE
mkapcfcoaaaa	TRUE
nemkeffeaaaa	TRUE
nemnpaafaaaa	TRUE
npieebplaaaa	TRUE
npifaljeaaaa	TRUE
okdembabaaaa	TRUE
okdhidpgaaaa	TRUE
pfdkgdjkaaaa	TRUE
pfehdghhaaaa	TRUE
aadcoedclmbn	FALSE
aadiconmhbam	FALSE
akebejbfofno	FALSE
akejkbgknoko	FALSE
becpadnmkdmi	FALSE
beekgaoaijpg	FALSE
bnmmmjdinhdh	FALSE
bnnfglfkoomo	FALSE
cjinddbeadem	FALSE
cjjkabihkiij	FALSE
dcofdffbnknb	FALSE
dcpmgjadlncl	FALSE
dnkoojlpepef	FALSE
dnlhccfmlpek	FALSE
ehcihfghnbpd	FALSE
ehdbaillpdif	FALSE
fbahconoiaam	FALSE
fbcekclmcabf	FALSE
flipnhdckkic	FALSE
fljckmlbdflk	FALSE
gfhekpibakcl	FALSE
gfhmegocbkbn	FALSE
gpplibgpkbhm	FALSE
gppnnkknafjp	FALSE
hjnfmpiifilf	FALSE
hjodjkjeggjp	FALSE
icoeeeopeaej	FALSE
icohbileddla	FALSE
ingjobknkmlf	FALSE
ingljnnhgmne	FALSE
jhgfilhnliam	FALSE
jhgodfjiokda	FALSE
kbbekiedfbaf	FALSE
kbbifepmieoc	FALSE
kkppgbjddmlp	FALSE
klamogbmiial	FALSE
lgdkpnghfgln	FALSE
lgecfgejcich	FALSE
lpkbjolplobo	FALSE
lpmikbpmhige	FALSE
mkjkgigpneda	FALSE
mkkialnkombj	FALSE
nfbcdlikdokl	FALSE
nfblhdhkjpnm	FALSE
nplfbeinfgmb	FALSE
npmgpeiodcbn	FALSE
okebgcbhbbbj	FALSE
okefoipohkdl	FALSE
pfflpmhlajnl	FALSE
pfgaameddodk	FALSE
aadcoedclaaaa	TRUE
aadimbncoaaaa	TRUE
akegjkbkgaaaa	TRUE
akggpbldgaaaa	TRUE
bemanjdafaaaa	TRUE
bencnlmcaaaan	TRUE
boeefbnlcaaaa	TRUE
boflbodepaaaa	TRUE
chmigfjieaaaa	TRUE
chomecjkoaaaa	TRUE
dcldkajecaaaa	TRUE
dcmgcdnadaaaa	TRUE
dnlkggcmaaaam	TRUE
dnlmfeehnaaaa	TRUE
ehhgfkhckaaaa	TRUE
ehifekpmmaaaa	TRUE
fblckfipfaaaa	TRUE
fbmhnlnafaaaa	TRUE
flnpppdpaaaaj	TRUE
flpeejbfdaaaa	TRUE
gfclgfdhoaaaa	TRUE
gfcniccchaaaa	TRUE
gpognoijkaaaa	TRUE
gppgmblilaaaa	TRUE
hjiilfldlaaaa	TRUE
hjjeefgmgaaaa	TRUE
iddbiffinaaaa	TRUE
idehlpldgaaaa	TRUE
imoinpngdaaaa	TRUE
imoobgdgjaaaa	TRUE
jhmadnhjkaaaa	TRUE
jhnacdkajaaaa	TRUE
kaplabjdhaaaa	TRUE
kbapndjpgaaaa	TRUE
klcpojehbaaaa	TRUE
kldgiphcaaaan	TRUE
lfclghifnaaaa	TRUE
lfdmdlpogaaaa	TRUE
lplkcmapfaaaa	TRUE
lpngibaelaaaa	TRUE
mkeagpgjoaaaa	TRUE
mkelimmebaaaa	TRUE
nfjkdmjkbaaaa	TRUE
nfjnaijnaaaai	TRUE
npidijofhaaaa	TRUE
npijbejkpaaaa	TRUE
okkmhagfoaaaa	TRUE
okmmmkiapaaaa	TRUE
pebginedcaaaa	TRUE
pebgllhhjaaaa	TRUE
aaaljpjjkfeal	FALSE
aaejacinoeoeo	FALSE
akakofokigbok	FALSE
akbflnmdjecfg	FALSE
beahbmcagoedc	FALSE
beajbpjgfolbm	FALSE
bocmgjledbipm	FALSE
bofiajfpkhfgi	FALSE
ciaaeinfpnije	FALSE
ciaoicamhgdcm	FALSE
dbmbkpahahinn	FALSE
dbmmfccncppfa	FALSE
dllgdbnojokjn	FALSE
dlllmcnmdcpgp	FALSE
egmnchdpgmlkp	FALSE
egppeomlaffaf	FALSE
fbolmlcjikmfb	FALSE
fbonjgncmcbgg	FALSE
fmofhgebgolmf	FALSE
fmooepmgpoeef	FALSE
ggfmahpkiccic	FALSE
ggfmjadlohlmi	FALSE
hagilfhapgjim	FALSE
hahknpepkmoak	FALSE
hkpbkigmhmjkm	FALSE
hkpppoaeimfln	FALSE
igdkhlfaognhd	FALSE
igfphampdefcc	FALSE
jadnoflceokol	FALSE
jaeejhencbcnd	FALSE
jlkfaogpcedfe	FALSE
jlkhjoldoongo	FALSE
kghooafncekhl	FALSE
kgikfbgcjfmdc	FALSE
lbfdoodfinadb	FALSE
lbgdopmeijjpk	FALSE
lmcfhlnodmfnh	FALSE
lmdbgaklfldbm	FALSE
mgjkhifnngnji	FALSE
mglcgmgjinceo	FALSE
nafljjbjjiipp	FALSE
nagckglmeednb	FALSE
nkcbfalgedpon	FALSE
nkcbobflmjoah	FALSE
odijeoedbeegk	FALSE
odipakgipcpdd	FALSE
onfpolpfmlmbc	FALSE
ongcjkklbebmi	FALSE
pghpelkiagbmg	FALSE
pgiaeclloabdo	FALSE
aaapkjpjjkaaaa	TRUE
aaefealjacaaaa	TRUE
akbebmldfgaaaa	TRUE
akbeojmhjaaaaf	TRUE
bdhjfeakbmaaaa	TRUE
bdidekdjajaaaa	TRUE
bnloijnkkoaaaa	TRUE
bnnamdakpcaaaa	TRUE
chmjfnkpdpaaaa	TRUE
chmmhmhedoaaaa	TRUE
dcbleegipbaaaa	TRUE
dccmjmmkenaaaa	TRUE
dmdjfoemboaaaa	TRUE
dmejppdlhbaaaa	TRUE
egdbpclkdjaaaa	TRUE
egedeldnnnaaaa	TRUE
fbiajjcajfaaaa	TRUE
fbindaondpaaaa	TRUE
fmphfkjlieaaaa	TRUE
fnadhhbhekaaaa	TRUE
gggddonhemaaaa	TRUE
gggmalehflaaaa	TRUE
hagophpgjfaaaa	TRUE
haidbeifolaaaa	TRUE
hkkcgmfaalaaaa	TRUE
hklhfoaloiaaaa	TRUE
ifkhejaleoaaaa	TRUE
iflahdpaffaaaa	TRUE
jadehdneljaaaa	TRUE
jadkpjhhndaaaa	TRUE
jkoomalpfaaaal	TRUE
jkpebekdojaaaa	TRUE
kgenakembhaaaa	TRUE
kgfjmbaaeiaaaa	TRUE
lbbaohmcgeaaaa	TRUE
lbbbdjbbhaaaah	TRUE
lmadoafediaaaa	TRUE
lmaihongjkaaaa	TRUE
mgenokojjoaaaa	TRUE
mggbpocenfaaaa	TRUE
nanhnehmbpaaaa	TRUE
napjohdediaaaa	TRUE
njgefmpmphaaaa	TRUE
njgfpmhkbpaaaa	TRUE
ocpliapobmaaaa	TRUE
ocpoddecaiaaaa	TRUE
ondjdjlofpaaaa	TRUE
ondlbckglpaaaa	TRUE
pgdbkadihkaaaa	TRUE
pgelobjonnaaaa	TRUE
aaagdbhbcdpomi	FALSE
aaalioelklnhaf	FALSE
akhjjlhkiccjia	FALSE
akjoghneogjkpn	FALSE
bfapdgcmpjphgp	FALSE
bfblnjmiokmgem	FALSE
boooolejbnkofg	FALSE
bopjaeopakcjbi	FALSE
cilakfapggicdc	FALSE
cildoemnniffkd	FALSE
dddbndejfocehn	FALSE
ddfcojoklipejk	FALSE
dnfaddnofjnhie	FALSE
dnfejhkgmnpnac	FALSE
eimgfpbfajfldb	FALSE
eimjeabhnpdimd	FALSE
fdphoihejngeph	FALSE
fecccinjienkfh	FALSE
foioakmdgdapgf	FALSE
fokekmceffobjo	FALSE
gindhdohohoohc	FALSE
ginkifolkeadbd	FALSE
hchiojiajdegcg	FALSE
hcjedjomlplnlj	FALSE
hmmhldljhdelnd	FALSE
hmmoiakibggafk	FALSE
ihhdbeampejlje	FALSE
ihhibilefbgojn	FALSE
jbjcflpemlgcbl	FALSE
jbjgnegihkagbb	FALSE
jlfdcmfhbfmahk	FALSE
jlhdhklmkpeehc	FALSE
kelkncppdblnfk	FALSE
kelojlbmoikbcg	FALSE
koojodcmnmckea	FALSE
kopjamgemkdhfl	FALSE
ljhpjenmffgkkf	FALSE
ljiempbnhkmekk	FALSE
mdiaemhaljapff	FALSE
mdifpeehmaalmj	FALSE
mnfehkmdpkifkb	FALSE
mngmphlhnkebgj	FALSE
nhidlldafnjacd	FALSE
nhinbeeofbanph	FALSE
oapmjhokilkboa	FALSE
oapoefklpjindl	FALSE
omimgbghcoallb	FALSE
omjblbocjmajbh	FALSE
pglclankfpmmah	FALSE
pglgenmgilfhlb	FALSE
aaafdbhbcdpaaaa	TRUE
aaakomiioelaaaa	TRUE
akfjakmfljiaaaa	TRUE
akflghlcgigaaaa	TRUE
bffipdofllmaaaa	TRUE
bffmbeijdliaaaa	TRUE
bpamhglfdfjaaaa	TRUE
bpbgadlnjfoaaaa	TRUE
cinbggehkpfaaaa	TRUE
cipibcidoniaaaa	TRUE
dcmiienhbceaaaa	TRUE
dcmnkmfooipaaaa	TRUE
dnokkaeakofaaaa	TRUE
doanddcknpdaaaa	TRUE
ejaamljifnjaaaa	TRUE
ejaelobcbbnaaaa	TRUE
fdopljgdphpaaaa	TRUE
fdpbgdimgmnaaaa	TRUE
fohfnpjbnplaaaa	TRUE
foieddbpgkbaaaa	TRUE
gjahigbiiamaaaa	TRUE
gjakcmpnjchaaaa	TRUE
hchagfijmflaaaa	TRUE
hchfbangilhaaaa	TRUE
hndhffmlmfdaaaa	TRUE
hneoloojkjnaaaa	TRUE
ihggccalocbaaaa	TRUE
ihhghpnkcmfaaaa	TRUE
jblnaemilfbaaaa	TRUE
jblnnleofmdaaaa	TRUE
jkgdbchabepaaaa	TRUE
jkgenkifmkmaaaa	TRUE
kejhoajcjppaaaa	TRUE
kellcapdlkmaaaa	TRUE
konodljpkmoaaaa	TRUE
konpaiaglhkaaaa	TRUE
ljahlkjnmenaaaa	TRUE
ljaifdnlgecaaaa	TRUE
meckpeaplmhaaaa	TRUE
meeelgfendcaaaa	TRUE
mncjdcfcnkoaaaa	TRUE
mndcpcikdcfaaaa	TRUE
nhdmpedcogiaaaa	TRUE
nhdnmepbignaaaa	TRUE
obajgdlkkaaaame	TRUE
obamlcmapddaaaa	TRUE
okoidpljgnfaaaa	TRUE
okpmfhbdahoaaaa	TRUE
pgidmfamjgpaaaa	TRUE
pgienenodldaaaa	TRUE
aabmhbpjlkfnbha	FALSE
aadfemddemcmall	FALSE
ajnjhhbaliomdno	FALSE
ajpinpjmkihibog	FALSE
beenmagkhfpknme	FALSE
befhjpfneahimho	FALSE
bogmikmmopgcglk	FALSE
bogppbkohnpncbo	FALSE
cjgnhkibccpdecd	FALSE
cjhoekoplekdbbh	FALSE
dcindieeagohdnj	FALSE
dcjabogdiocblhe	FALSE
dmfldcfjmnhchnb	FALSE
dmfnafcjekdgepp	FALSE
egibdnihfocldfi	FALSE
egifbjgbnhnhdeb	FALSE
fbhaajejchlnaod	FALSE
fbhfpbbmhnckfap	FALSE
fkeahlodpgpcocp	FALSE
fkfbkcblmffhaan	FALSE
genpjfnfpgnoklj	FALSE
geoeipgadgfobna	FALSE
gpibeodndhfkoeo	FALSE
gpjaopphlddbcgf	FALSE
hkdpolpfagilbma	FALSE
hkfecmokcklegkk	FALSE
ifachfmlnpgbiep	FALSE
ifbkdcfnfbadfhe	FALSE
ipkigeepngahegj	FALSE
ipkldpidigiiafp	FALSE
jkaljkhljhoiebg	FALSE
jkanljfndnifhpk	FALSE
kecgeeopplmibmg	FALSE
kedchaaoefihnfg	FALSE
kpgdcpopjoolali	FALSE
kpgleidoaghgmoa	FALSE
ljheenbbkpjhdcg	FALSE
ljkchlhmaknhkjo	FALSE
mdokjkjoglfakof	FALSE
meamkajnhnbkanf	FALSE
mniiaccplimieif	FALSE
mnjnjeajbmcmodh	FALSE
nhkblimajcjbbpi	FALSE
nhknimaipkebgdk	FALSE
obphbbgniajgaaf	FALSE
obpjmaoajeangei	FALSE
olkpmhggafcklob	FALSE
ollfonohjoamddj	FALSE
pgcahmlhbamcmje	FALSE
pgcdndlopkfommd	FALSE
aaabohablgooaaaa	TRUE
aaafembmjnlmaaaa	TRUE
algfnjpclfnjaaaa	TRUE
alggganknoleaaaa	TRUE
bgaodjafnjmlaaaa	TRUE
bgcoapglanajaaaa	TRUE
bpokanbnimmaaaag	TRUE
bpoooglnpegbaaaa	TRUE
clfldhddhehoaaaa	TRUE
clgabolbpgbkaaaa	TRUE
dfafeaeahjfdaaaa	TRUE
dfcdhkajppccaaaa	TRUE
dpdfhbeijdnnaaaa	TRUE
dpdkappaddmgaaaa	TRUE
ejacljcbfkgcaaaa	TRUE
ejdajllippmaaaai	TRUE
fdpdonjedbmcaaaa	TRUE
fdpnghomehdgaaaa	TRUE
fnilefjibdidaaaa	TRUE
fnjfhplgcfjjaaaa	TRUE
gijgekoggjlaaaan	TRUE
gijgmdapcihnaaaa	TRUE
hcdlpbjdegdgaaaa	TRUE
hceinjelgbciaaaa	TRUE
hmkphpjgceglaaaa	TRUE
hmpchcpaikpnaaaa	TRUE
ihhfjinlenldaaaa	TRUE
ihibgcinfnmjaaaa	TRUE
jbkfijocicfdaaaa	TRUE
jblbleeldnkfaaaa	TRUE
jkocoenhbcpjaaaa	TRUE
jkokngllfffcaaaa	TRUE
kfalbeiapodgaaaa	TRUE
kfbbnpcbpgkjaaaa	TRUE
kpjmlcoeeifcaaaa	TRUE
kpkijkljnahdaaaa	TRUE
ljfoofedioagaaaa	TRUE
ljhldfadjpjmaaaa	TRUE
mclcckhgajggaaaa	TRUE
mclgigpmjddfaaaa	TRUE
mneaphebabkoaaaa	TRUE
mnehnifhlgaiaaaa	TRUE
nggmheglblljaaaa	TRUE
nghdelmifgclaaaa	TRUE
obljliijjanpaaaa	TRUE
obnbanknignhaaaa	TRUE
omabidnakofoaaaa	TRUE
omallbanogmmaaaa	TRUE
pgbhphohggmpaaaa	TRUE
pgbkgeahbakdaaaa	TRUE
aaacohablgooefmb	FALSE
aaagjnlmmfkfieka	FALSE
alfjeghoneabdhgk	FALSE
algajgdbblfdfohd	FALSE
bfbciafhdaphnkmc	FALSE
bfbdebiihdjdbeaf	FALSE
bpocdcfkgnfhcbbg	FALSE
bpoknenlohdnlggg	FALSE
cligjhcbeeehpkok	FALSE
cljlgjgmnacokkbo	FALSE
dfaabkifcphimbel	FALSE
dfadpflpmihneneg	FALSE
dpicofagejemllop	FALSE
dpikmipegkedljoo	FALSE
ejjekpmldjgjblia	FALSE
ejjfcnpafekjifdf	FALSE
fdedmfhoadcgegii	FALSE
fdemliacodcllddi	FALSE
fngkecdlghakenjb	FALSE
fnhcgbkkkeidigbb	FALSE
gibfdnjjmjicicmk	FALSE
giggdbejmppmdlim	FALSE
hcimhafhedgnkebk	FALSE
hcjjiekkdlenbbih	FALSE
hmihdcdibeahadca	FALSE
hmioaofdigbmnaih	FALSE
iibifohmdblokcfo	FALSE
iiconnehkijiabje	FALSE
jbkmdlappngicgna	FALSE
jblkpgndogojgldl	FALSE
jkpbklaaihibcoeh	FALSE
jkpmbncbnebbkngo	FALSE
kempbdcglkdpaddo	FALSE
kendmfapliodlklc	FALSE
kpibpidnakofolba	FALSE
kpionogmmbkdhgne	FALSE
ljmgpceabklmpkbl	FALSE
ljndldakljneobkg	FALSE
mdibmlgeeojjepel	FALSE
mdkbhknidoeaceje	FALSE
mmndifoejjgmhafk	FALSE
mmnoflablnjbnfen	FALSE
nhoepbpfolgekfjm	FALSE
nhojejbhebggdegl	FALSE
obpoiijnengnfpcg	FALSE
ocaoamaaemldcgla	FALSE
ompdhbjgfpphoaga	FALSE
onbcchaicchdacca	FALSE
pgneahpfebmfjpoh	FALSE
pgomlbljofhkaomi	FALSE
aaahenhefigoaaaae	TRUE
aaalgjbolkddaaaac	TRUE
akjcongjgcajdaaaa	TRUE
akklladaooccgaaaa	TRUE
bfmoelllcipecaaaa	TRUE
bfnbagnnbbgkeaaaa	TRUE
bplnkheopnapgaaaa	TRUE
bpmflddnmpemgaaaa	TRUE
cifjapokgimcgaaaa	TRUE
cigecnonafgkeaaaa	TRUE
dccehpiealkhdaaaa	TRUE
dccgecobkpjncaaaa	TRUE
dmafdilpkflfmaaaa	TRUE
dmamdonnefjakaaaa	TRUE
egoaaeahffoanaaaa	TRUE
egodbeejompcgaaaa	TRUE
fbmgdbgembmapaaaa	TRUE
fboikahllhcooaaaa	TRUE
fkkmhmocmmkanaaaa	TRUE
fklkoclbjllhmaaaa	TRUE
gemppbhlhekekaaaa	TRUE
genajmdinbnbcaaaa	TRUE
gpploiligbkolaaaa	TRUE
haadpkdckedeiaaaa	TRUE
hjgenjmkonpidaaaa	TRUE
hjghfmhlohlkaaaam	TRUE
idekphiooifmcaaaa	TRUE
idepelihhillaaaal	TRUE
inpmbmfplhlbbaaaa	TRUE
ioaclbbkljmkkaaaa	TRUE
jhnbjpadocbdnaaaa	TRUE
jhndnedigolegaaaa	TRUE
kbjckdplelkflaaaa	TRUE
kbkdcipamdlgmaaaa	TRUE
kllncfgdakhdlaaaa	TRUE
klnogbkppdkmlaaaa	TRUE
lgkjiolmopikaaaac	TRUE
lgldbhpmefbmpaaaa	TRUE
machdpfhjlnfiaaaa	TRUE
macoegpmjmmgeaaaa	TRUE
mkkemdmnjeiodaaaa	TRUE
mklgbmabnadgpaaaa	TRUE
nffblookmhaioaaaa	TRUE
nffoofblodnpeaaaa	TRUE
oamjkipailknaaaal	TRUE
oanelpimjogonaaaa	TRUE
olidaoefdipibaaaa	TRUE
oliphmheefaekaaaa	TRUE
pfkbgfkfoffjfaaaa	TRUE
pflaeaegfaginaaaa	TRUE
aaackhmfpigdkgjjd	FALSE
aaagemmlmohlihabl	FALSE
alpcogeloecjjbnel	FALSE
alpeomocebpgnmegd	FALSE
bfkpjbkcjdpgdbdpk	FALSE
bflmoaidmkngamndd	FALSE
boifodhlbegiocgcf	FALSE
boklpcgbgcbnmphcb	FALSE
chpijehlibplbajlf	FALSE
ciaaibdfbnnamjjmj	FALSE
dchcefjoceehfbcde	FALSE
dcimldepmneejolpa	FALSE
dmckkcdmlnmlimlko	FALSE
dmeghpjhfhldmclkd	FALSE
efjfgfaindpkdfppd	FALSE
efjfmcchainpdggmi	FALSE
eplepnbhhijdldkia	FALSE
epnojfacfhoaioljd	FALSE
fkpddnmallieilhdo	FALSE
fkpdnlgeejcpjhpad	FALSE
gefpfpmkdiicljmpl	FALSE
gegkagcmelpfdggjc	FALSE
gpfhdbjeelfecpaak	FALSE
gpgnkpcjoiingigdd	FALSE
hjombkleoeldfmjoe	FALSE
hkaaiiiagaljpgmbd	FALSE
iedafpjmnfdinbcnd	FALSE
iedhocmaoodcdeank	FALSE
ipaeejpbnombfijdp	FALSE
ipbfhonpbncoblnea	FALSE
jiomimghoejgnjahj	FALSE
jipgfahmlcfgaimen	FALSE
kdmmbndhjppgnlomd	FALSE
kdobopeggmhhhlheb	FALSE
knihfbgggadmjemhd	FALSE
knimhdgjooopoklpf	FALSE
lgmaaigdfdhialpje	FALSE
lgmaliefbfhgnbioe	FALSE
mcklfgidcnennebak	FALSE
mclbalioijoaicfjj	FALSE
mmbkofgbpekchljpn	FALSE
mmcekiifhllfaobmi	FALSE
ngccbdionkopkaobj	FALSE
ngdfckamnjljnhpbp	FALSE
oaabhgofkghhgoogb	FALSE
oadbohnfilgjdobea	FALSE
okbkpkhaacabecpni	FALSE
okcgdlmdfliaognna	FALSE
pdiioafaoplfejdcn	FALSE
pdlfmegppnnkdbbad	FALSE
aaabkhmfpigdkgaaaa	TRUE
aaafjdemmlmohlaaaa	TRUE
alllkegaapgmncaaaa	TRUE
alokpkdbobbkopaaaa	TRUE
bfmjdmnkcnliaeaaaa	TRUE
bfmkgaehhonmjmaaaa	TRUE
bpbfapanlacdlhaaaa	TRUE
bpcfocbjapjefcaaaa	TRUE
ciomeogmblfghpaaaa	TRUE
cipgdbggiblepmaaaa	TRUE
dbookelmejfgoiaaaa	TRUE
dbpblknebojoanaaaa	TRUE
dlfehkhbhfalnhaaaa	TRUE
dlfockppcghpbjaaaa	TRUE
egabioinimafcdaaaa	TRUE
egapfmdfglegcbaaaa	TRUE
epnbnbpaddljhpaaaa	TRUE
epnmlodhccdeohaaaa	TRUE
fkjnekpioaianfaaaa	TRUE
fkkdjfinojfcjkaaaa	TRUE
gfjkbnanafgnmoaaaa	TRUE
gfjljbeoofbphlaaaa	TRUE
gpgoofljcomockaaaa	TRUE
gpijampjjnannjaaaa	TRUE
hjklamencgmbldaaaa	TRUE
hjljckpoeoijjhaaaa	TRUE
iecdekkjiiimbaaaab	TRUE
ieceeilnjjpcelaaaa	TRUE
iopcehechpjcofaaaa	TRUE
ipaaifgbnabgmjaaaa	TRUE
jjfeegempfcbkmaaaa	TRUE
jjfkpphpecbjliaaaa	TRUE
kdgmhhhmffhcipaaaa	TRUE
kdgnphmbmnajaeaaaa	TRUE
kmhdhmhonlciemaaaa	TRUE
kmhhhedlbpkcjlaaaa	TRUE
lhkahpekondjigaaaa	TRUE
lhkbpbghgcabbgaaaa	TRUE
mdbbmgnbaijgpfaaaa	TRUE
mdbcbmmjegheeeaaaa	TRUE
mmpkcaagilfmlcaaaa	TRUE
mnaikcpofdipngaaaa	TRUE
ngbfbhaeogoccoaaaa	TRUE
ngbmojjhanoeflaaaa	TRUE
oaapbmbpjmbbjnaaaa	TRUE
oabdhkdfipfohhaaaa	TRUE
ojlncdbjbechpbaaaa	TRUE
ojnlonhgehcjeaaaaf	TRUE
pfbljadockojgjaaaa	TRUE
pfbpbjgimndiokaaaa	TRUE
aabnemfloafhheojpd	FALSE
aacpjddecolbnpfaln	FALSE
akeeknpemfiakjbkdb	FALSE
akfdoblnhekfahiofc	FALSE
bdkhffjghfmmjncpcn	FALSE
bdmdfajggcemmkeplm	FALSE
bnlaolechlllfkieif	FALSE
bnmgbllgalaolilicd	FALSE
chocgjffhnbhieomhm	FALSE
choclbbmjfddgfmepa	FALSE
dcbjnnojjalfglnann	FALSE
dcblnfndaccfiipnmk	FALSE
docekcakngefamcdcp	FALSE
dockeppnbbddjdglik	FALSE
ehghgcdbbkbjghaomj	FALSE
ehgmmmnehlokcmgjdb	FALSE
fdjfcdjappfnmcenmj	FALSE
fdjjfdfffcodflnkki	FALSE
fngcplnejmiigkmhdm	FALSE
fngmiahnnahekolhig	FALSE
ghlmngfdgaffochgbf	FALSE
ghmmmciiceojdfemdl	FALSE
hbmbgdcdihdaoicaoi	FALSE
hbmjaildaadplioidh	FALSE
hleanfkjccamdcdlim	FALSE
hleklopdeeimobjkkf	FALSE
igkbpcoaomkjmdgdlg	FALSE
igkejehpiofipafcnl	FALSE
jbabhdilpcfmiogjpl	FALSE
jbahnfieekknaagiog	FALSE
jlamohinokkefamhda	FALSE
jlbeaenlgbeoaidnhf	FALSE
kenbcbpoambgnldihf	FALSE
kenfdlonemimkhlmpo	FALSE
kokkonpmfpagejjcbd	FALSE
kokognhdlionkiifmj	FALSE
liooncodmnhickeook	FALSE
ljaipknppfhchbdmoh	FALSE
mdbbngoggjdeipmnml	FALSE
mdbimaafphdjhkfchc	FALSE
mocgfmeaacagaknmah	FALSE
mochcdifldlacnncmo	FALSE
niifecllncfjkogcdm	FALSE
nijdbfondmnkmiioeb	FALSE
ochfgkdldnaelabknp	FALSE
ochjoicjhpdcbggdii	FALSE
olgegaijnnlojohhap	FALSE
olggihpllobkflimfg	FALSE
pflidgagknbkbbneml	FALSE
pfllgblbocjichikco	FALSE
aaafklhnngffajcaaaa	TRUE
aabablcnhcnaoneaaaa	TRUE
ajiaeieknffmcifaaaa	TRUE
ajigoapljhiajemaaaa	TRUE
bdofihncekafmokaaaa	TRUE
bdoljmcknaghohaaaan	TRUE
bpipnjbohelpobgaaaa	TRUE
bpjahmocefeplkfaaaa	TRUE
cjjckkoncchejjbaaaa	TRUE
cjjmojipcoedopeaaaa	TRUE
ddgccgieeocjjacaaaa	TRUE
ddhohjihlacknobaaaa	TRUE
dneheocjfpaniopaaaa	TRUE
dnempdnifpdllhhaaaa	TRUE
eghokfnkhfiomllaaaa	TRUE
egjakflnoedbhcdaaaa	TRUE
fadnfpkkadingekaaaa	TRUE
fafhpfpmniekhdkaaaa	TRUE
fjnikojhmefnekjaaaa	TRUE
fjpfboelpaipligaaaa	TRUE
geepedmlgmkhbemaaaa	TRUE
gegelkecpfbiipdaaaa	TRUE
gobmmkcejhglhegaaaa	TRUE
godpokbnaoggpdjaaaa	TRUE
hjaehkggpfipjngaaaa	TRUE
hjaidnleiplglliaaaa	TRUE
ifchcnchmbekljlaaaa	TRUE
ifcikfffmomilacaaaa	TRUE
ipkdoonpihjncieaaaa	TRUE
iplflkgafgoodjdaaaa	TRUE
jjchgoiachakckpaaaa	TRUE
jjchoieajdmdilcaaaa	TRUE
kebhonfbkgchacdaaaa	TRUE
kebmjipcefnjkhgaaaa	TRUE
knpgbhklabhnhipaaaa	TRUE
koalfapplkanjdeaaaa	TRUE
lhjfgmfckpgnjbgaaaa	TRUE
lhjkhacnienmojoaaaa	TRUE
mbbejfdfelclpoaaaaj	TRUE
mbbgigloolfglghaaaa	TRUE
mkmmpmcnlgnckdhaaaa	TRUE
mkmnplbojodnhadaaaa	TRUE
neodjeigepcobngaaaa	TRUE
nepfgebfpmdnmehaaaa	TRUE
oaclbhmmlekdmadaaaa	TRUE
oacpmojlindlpjoaaaa	TRUE
olldppnidoelhgoaaaa	TRUE
ollkjfomdiompgfaaaa	TRUE
pgdbakclhoclofoaaaa	TRUE
pgedlncnlgodadiaaaa	TRUE
aaafehomgcikcbakpfn	FALSE
aabehncfeeeockbdobn	FALSE
ajhcmdepkjmnnboeimb	FALSE
ajhffhmgkphmeiofkbe	FALSE
bciljeejkfefpdfbchb	FALSE
bcjgloffldfpademmmb	FALSE
bmacmboejmggkopoffh	FALSE
bmaoheloledjgjdmihm	FALSE
cfjdkkjnlfegbjgbkgp	FALSE
cfjjofighipngbjogjk	FALSE
danlgbhcijidmccloeh	FALSE
danmmgbhbdhhkkkempo	FALSE
dkeecglfdemkemhpgnd	FALSE
dkfdkdhemhchciclkgh	FALSE
eemjlekmmhbandbopkp	FALSE
eemlnekpfheaekagbcp	FALSE
epndlolcpidkgaofceb	FALSE
eppglaknkfpeehekikg	FALSE
fkijaoakjkcofpplfbd	FALSE
fkikjlgemncljffiaff	FALSE
gfbmcjjlehngbnfoapo	FALSE
gfcanbgcioadijkldnj	FALSE
gomfgcfnamopalefanm	FALSE
gomjkidmgggmcedpdgm	FALSE
hinpcjmlopdooldiimo	FALSE
hinppojfffipcmcagnh	FALSE
icjjbfegdghnoohljfe	FALSE
ickhicglahfjjmgmjbb	FALSE
inokddomcanfbgpincb	FALSE
inonmkccaimenkmnfme	FALSE
jhndjakpoingmadglhl	FALSE
jhnknfjaccphkpggklo	FALSE
kdglnpolgmchfcodflf	FALSE
kdhjinmpihfcjffkejn	FALSE
kodfhoeegeabhdhlone	FALSE
kofdccbjioeggefgbng	FALSE
lgelekgdaficejdcnpb	FALSE
lgfbehlpoaalbjoopcl	FALSE
mbjlmngipjpfidijoih	FALSE
mbkfeadlkdofilfnodm	FALSE
mkhjhhkjhjfljodahbg	FALSE
mkihgbjenfinpiffcil	FALSE
ngjjkpfflehclhkbhoa	FALSE
ngkiklhogfbkcbpndmp	FALSE
oaopjkamiibjjhainjf	FALSE
oapbpdfmpkeemafdjpi	FALSE
olpnakdmghpjjobfocm	FALSE
omagkbmobcleanmklnl	FALSE
pfnhhapiddcnacnhlgc	FALSE
pfonjppmlaggnbhmpko	FALSE
