aabmcbabab	TRUE
aacecnabab	TRUE
ambgamabab	TRUE
amcmofabab	TRUE
bfiodbabab	TRUE
bfiookabab	TRUE
cakbbababg	TRUE
cakdhaabab	TRUE
cjjcifabab	TRUE
cjjfjdabab	TRUE
denbcababb	TRUE
deollmabab	TRUE
dpiljjabab	TRUE
dpjbooabab	TRUE
ejcjfeabab	TRUE
ejdhlbabab	TRUE
fdkekkabab	TRUE
fdmlnoabab	TRUE
fojlllabab	TRUE
fojpjhabab	TRUE
gjemffabab	TRUE
gjgapnabab	TRUE
hdgoifabab	TRUE
hdhkdlabab	TRUE
hoginkabab	TRUE
hogphoabab	TRUE
iiigfgabab	TRUE
iiinhoabab	TRUE
jdhlcgabab	TRUE
jdhnkkabab	TRUE
jmkpababoa	TRUE
jmmkkcabab	TRUE
kgncniabab	TRUE
kgndchabab	TRUE
lbbogbabab	TRUE
lbdegeabab	TRUE
llaajjabab	TRUE
llaffgabab	TRUE
mfooaeabab	TRUE
mgaplpabab	TRUE
nagfcaabab	TRUE
nagkknabab	TRUE
njkcanabab	TRUE
njkdenabab	TRUE
oegiigabab	TRUE
oegjkdabab	TRUE
oofiedabab	TRUE
ooflkcabab	TRUE
phbeaiabab	TRUE
phcajlabab	TRUE
aabmcblecn	FALSE
aacbgjlonk	FALSE
amdjjbamoj	FALSE
amehichfdc	FALSE
bggdbejpbk	FALSE
bghipncbbk	FALSE
caminknmne	FALSE
caoaomklem	FALSE
cjopnmmpph	FALSE
ckagimppjg	FALSE
dekcpfjddl	FALSE
dekkljhhak	FALSE
dpifpjkojc	FALSE
dpijagmlpo	FALSE
ekabaaolhj	FALSE
ekakcifdei	FALSE
feegebfdmk	FALSE
fefhjbghlp	FALSE
folaaabcbn	FALSE
fomafpdjeg	FALSE
gilgjhempl	FALSE
gilgkdeili	FALSE
hdclngcael	FALSE
hddilnaggj	FALSE
hninigojcd	FALSE
hnjopeckoe	FALSE
iikaolegkc	FALSE
iikkdjejkj	FALSE
jclbhgghig	FALSE
jclihhhgpg	FALSE
jmenikdoee	FALSE
jmgcjjjhaf	FALSE
kgofjgjnho	FALSE
kgoiepbgha	FALSE
lanecjjidj	FALSE
laokkgchbi	FALSE
llgpfbnjhe	FALSE
lliiglmdfl	FALSE
mfomaekjmg	FALSE
mfpfjhmddi	FALSE
naeppmliek	FALSE
nafjjidofb	FALSE
nkkgnnblep	FALSE
nkljlmjghc	FALSE
odmaiefcok	FALSE
odmgbfchkf	FALSE
onpmhjmmfg	FALSE
onppnmpbjn	FALSE
pibejgikpe	FALSE
piblmckgkm	FALSE
aabmcblabab	TRUE
aaccncbabab	TRUE
amepehbabab	TRUE
amfekmbabab	TRUE
bfplhdpabab	TRUE
bgailmnabab	TRUE
camkgfiabab	TRUE
capajioabab	TRUE
ckhgflkabab	TRUE
ckhicnkabab	TRUE
denenoeabab	TRUE
denhkpiabab	TRUE
dpfiamkabab	TRUE
dphofjkabab	TRUE
ejmmbalabab	TRUE
ejpgcbhabab	TRUE
fdibiaoabab	TRUE
fdjekfpabab	TRUE
fokamddabab	TRUE
foloonfabab	TRUE
gjajgfhabab	TRUE
gjbhdeeabab	TRUE
hdgigbmabab	TRUE
hdhkfdhabab	TRUE
hoegbniabab	TRUE
hoehlmkabab	TRUE
ijabnfgabab	TRUE
ijajjhlabab	TRUE
jcgkpneabab	TRUE
jcihnfiabab	TRUE
jmbogacabab	TRUE
jmcbpiiabab	TRUE
kgflomfabab	TRUE
kggfgimabab	TRUE
laohelaabab	TRUE
lapdhlmabab	TRUE
lldbcoababn	TRUE
llemhimabab	TRUE
mfkeideabab	TRUE
mfklcgoabab	TRUE
naemmhfabab	TRUE
naeopgjabab	TRUE
njnfojababf	TRUE
njnngaababk	TRUE
odpfebmabab	TRUE
oeamlphabab	TRUE
ooccmgbabab	TRUE
oochenmabab	TRUE
phgjjifabab	TRUE
phhfnahabab	TRUE
aaafnokiadk	FALSE
aabgminpepd	FALSE
ajljilopjno	FALSE
ajmiolmagkn	FALSE
bfhbmmejpjm	FALSE
bfijifdcahj	FALSE
bpiaahjmchf	FALSE
bpjinoifcli	FALSE
cjngdihofaa	FALSE
cjobofpahbb	FALSE
defnamihihn	FALSE
degnigaakgn	FALSE
dolaelkmmdb	FALSE
dolfkdbgmgl	FALSE
eilkecaffhh	FALSE
eimchajkjoa	FALSE
fcpkpfhplaf	FALSE
fdbfcomkphg	FALSE
fnidnigcjln	FALSE
fnjlladpgpi	FALSE
ghhlnpcbhdn	FALSE
ghkkijapjmd	FALSE
hdgalggomhp	FALSE
hdielemkcid	FALSE
hmfikhgmkfj	FALSE
hmggbpoioci	FALSE
igdodmdkjij	FALSE
igehoinfakl	FALSE
jcbkamieanp	FALSE
jccganegpnh	FALSE
jlhdjlledbf	FALSE
jlhncdodmji	FALSE
kfhkfiiffid	FALSE
kfhpcmffbfh	FALSE
kpglkfkjaie	FALSE
kpgpmbaclkd	FALSE
lihfkakjkbo	FALSE
lihljmhdaje	FALSE
mcnpodmknmd	FALSE
mcoelofajfd	FALSE
mneeplcflij	FALSE
mnepfbaocci	FALSE
nhmnchdbjlm	FALSE
nhmomnceplj	FALSE
objkdflodlb	FALSE
obkblhclaef	FALSE
oklbocfjjnj	FALSE
okmifdioahh	FALSE
peidnilgfbj	FALSE
pekjffcflpg	FALSE
aaafnokiabab	TRUE
aabakgjmabab	TRUE
ajjhanmjabab	TRUE
ajlbgeldabab	TRUE
bfopmnnaabab	TRUE
bgaifpmpabab	TRUE
bpjkkbehabab	TRUE
bpjlfdpeabab	TRUE
ckbhllmdabab	TRUE
ckblnnnjabab	TRUE
deambinmabab	TRUE
debfdobgabab	TRUE
dopmogdfabab	TRUE
dpacnloiabab	TRUE
ejafmfkkabab	TRUE
ejajfolpabab	TRUE
fdjjpfpkabab	TRUE
fdkfphejabab	TRUE
fndadibnabab	TRUE
fndcblbiabab	TRUE
gigchaooabab	TRUE
gihbgkcoabab	TRUE
hcimhmnjabab	TRUE
hcjhdfjgabab	TRUE
hnangnfhabab	TRUE
hnbbgnchabab	TRUE
ihfgiggaabab	TRUE
ihfoeonlabab	TRUE
jchjndpcabab	TRUE
jcimacpnabab	TRUE
jlkefnnhabab	TRUE
jlkfioanabab	TRUE
kfifkogbabab	TRUE
kfilegneabab	TRUE
kpiflppiabab	TRUE
kpiibfgeabab	TRUE
ljjcaacnabab	TRUE
ljjeaedgabab	TRUE
mclacgehabab	TRUE
mcmagaakabab	TRUE
mngjaehdabab	TRUE
mngpdedaabab	TRUE
nhjnnejiabab	TRUE
nhkbfdmababb	TRUE
oblabdeababj	TRUE
oblfjadababo	TRUE
oklagalmabab	TRUE
okljjnibabab	TRUE
peecabnfabab	TRUE
peeimaaababl	TRUE
aaaaehckkmld	FALSE
aaagjaglhpcc	FALSE
akohdhacjnaa	FALSE
akpcigchamjk	FALSE
bfajcdnebjfk	FALSE
bfbdfmghbbpf	FALSE
bpfmmhoohggp	FALSE
bphaikebefbh	FALSE
ckfbkenlplkf	FALSE
ckfbkjbpjpmo	FALSE
demkogibpkej	FALSE
denbmmfhfjde	FALSE
dokbangmdmec	FALSE
dolklinfhnng	FALSE
ejaplnbomcde	FALSE
ejbkjcdmhabk	FALSE
fdkahnnemlnl	FALSE
fdlfniaebiel	FALSE
fncnjdapemcd	FALSE
fndbecdohpfi	FALSE
ghpekfaafjpo	FALSE
giajpdnipboo	FALSE
hdghacblijbj	FALSE
hdhgghpgnhjp	FALSE
hnldgjjjkhhm	FALSE
hnlmafdnecfk	FALSE
ihbjehaaagkd	FALSE
ihdoeajekdbh	FALSE
jcciblepffcl	FALSE
jccodoagcbkm	FALSE
jmembfieodkg	FALSE
jmempkmanaif	FALSE
kheeejafmdmk	FALSE
khflfecnhmbj	FALSE
lbbnondpkcil	FALSE
lbccndaabcpm	FALSE
llffnfgblccl	FALSE
llgnknpdjhmc	FALSE
mefgijlcgbif	FALSE
meglhdebajih	FALSE
mpicpjgedpek	FALSE
mpieimfigpmp	FALSE
nipmbhemgglc	FALSE
njacgcaknaao	FALSE
ocdllflplpgk	FALSE
ocebkpcflmlb	FALSE
omknphkbjggj	FALSE
ommehigbnenk	FALSE
phaampnkhlhh	FALSE
phbdbdopliok	FALSE
aaaaehckkabab	TRUE
aaagmldjaabab	TRUE
akhmnmpnhabab	TRUE
aklbjphmeabab	TRUE
becciglagabab	TRUE
bedmnfpgcabab	TRUE
bpfognbcfabab	TRUE
bpgopdciiabab	TRUE
ckamomffpabab	TRUE
ckcfaimneabab	TRUE
degofelgkabab	TRUE
dehfanklgabab	TRUE
dopepfkdgabab	TRUE
dopjbliababdk	TRUE
eieccboomabab	TRUE
eienlinfiabab	TRUE
fcfgcpgegabab	TRUE
fcfmfelgbabab	TRUE
fnmohdnkhabab	TRUE
fnofganmeabab	TRUE
gibpofackabab	TRUE
gidbcomohabab	TRUE
hdacahhngabab	TRUE
hdalhjgljabab	TRUE
hnepkgiaiabab	TRUE
hnflgomepabab	TRUE
ihkmlknaoabab	TRUE
ihlfboaalabab	TRUE
jdfaenaenabab	TRUE
jdffikfdgabab	TRUE
jmeekjgboabab	TRUE
jmekokjddabab	TRUE
kgjaohanmabab	TRUE
kgjnfdlpbabab	TRUE
lakphlbkhabab	TRUE
lalipnapdabab	TRUE
llkaodhkhabab	TRUE
llkhbkdgjabab	TRUE
memaigcloabab	TRUE
mfagnpaepabab	TRUE
mpipnmlnoabab	TRUE
mpkcghpliabab	TRUE
njacopdncabab	TRUE
njaonnhojabab	TRUE
odaefnhciabab	TRUE
odblljkigabab	TRUE
onbackcmmabab	TRUE
onddpdimdabab	TRUE
pgeeccbheabab	TRUE
pgelmibpfabab	TRUE
aablhefdaapjk	FALSE
aabmeobacjcbo	FALSE
akaefandhpelh	FALSE
akajkhekaefen	FALSE
bdilielfjolnk	FALSE
bdjeiehmiddbc	FALSE
bpckkfbcacfmd	FALSE
bpclocbjibfgf	FALSE
cjippabegmbij	FALSE
cjkdobadmjgci	FALSE
demjmejejpeol	FALSE
demmhdcnkplol	FALSE
dooajlneobjje	FALSE
dpalfehbeojof	FALSE
eimonbohojfap	FALSE
einfedfiihcnk	FALSE
fdfpobkeggodo	FALSE
fdgippgoimhfh	FALSE
fnaklpdlhemcc	FALSE
fnankbdebikgf	FALSE
gidpjplepgejn	FALSE
gieijmlpejgkk	FALSE
hclcpocbheaip	FALSE
hclebppbhmgch	FALSE
hngppbodbkkbh	FALSE
hnhaagdhclkhd	FALSE
igffppjpiallm	FALSE
igflddgkplbko	FALSE
jbjnjofdjlilb	FALSE
jbkiienofobbf	FALSE
jlpmpmbnogcgn	FALSE
jmceinamcfepm	FALSE
khgmgbbpbhfkn	FALSE
khhijkbpnidcg	FALSE
lafgbdbbjlbap	FALSE
lafngbnhkpfml	FALSE
lkgkklihgdcbf	FALSE
lkhomkkppblpl	FALSE
megdehogplcko	FALSE
megkchjlgagjc	FALSE
mogemkpnnihfk	FALSE
moglcfgmcgfhe	FALSE
nidohoianmphc	FALSE
nifcclljngijm	FALSE
ocikpknpidnem	FALSE
ocnfklikhleci	FALSE
ominekhhhlcgo	FALSE
ominlbpinbaok	FALSE
pgbkclnafiaka	FALSE
pgcocbangefeb	FALSE
aablhefdaababj	TRUE
aabmkeobacabab	TRUE
akammnnibcabab	TRUE
akbiijcfckabab	TRUE
bdpeflmaefabab	TRUE
bdpefoaiacabab	TRUE
bpfaalhhdgabab	TRUE
bpfopkbikoabab	TRUE
cjkfnfhmjlabab	TRUE
cjkjcoiankabab	TRUE
dedeldgeefabab	TRUE
dedilnollmabab	TRUE
domkaflplhabab	TRUE
dondlhlifpabab	TRUE
ekhlhcjmjfabab	TRUE
ekhpdidlkjabab	TRUE
fdgnglpadhabab	TRUE
fdhoojolknabab	TRUE
fncfmcfhfkabab	TRUE
fnddlemkljabab	TRUE
gilafpjnmkabab	TRUE
gilcbpelehabab	TRUE
hcojpclhlgabab	TRUE
hcpegofkmdabab	TRUE
hniojghpakabab	TRUE
hnkckiikknabab	TRUE
ignkgihbokabab	TRUE
igocmanomfabab	TRUE
jcgingbifcabab	TRUE
jchaepnglkabab	TRUE
jlnllogfogabab	TRUE
jlpdieaeaeabab	TRUE
khefoopcegabab	TRUE
khfckgpaegabab	TRUE
laeinoopncabab	TRUE
laeipghhijabab	TRUE
lkdfofcaapabab	TRUE
lkfckgfhimabab	TRUE
menngcbgjdabab	TRUE
meojjffhodabab	TRUE
mognhlkpgfabab	TRUE
mohfcjepioabab	TRUE
nineoobeinabab	TRUE
nipdhabljpabab	TRUE
ockkmaheglabab	TRUE
oclcgfkldlabab	TRUE
omicccaojiabab	TRUE
omlbkipaehabab	TRUE
pgmcipiimhabab	TRUE
pgnaidikfdabab	TRUE
aaanjhallldelc	FALSE
aabaacfipgjpoi	FALSE
ajpclmfbdhjbbc	FALSE
ajpkohonpjghoo	FALSE
beahgbgaopgjoi	FALSE
bebfhllngfpgpf	FALSE
bobfhchinbgfbi	FALSE
bobflekfokdhmc	FALSE
cjdbpkobaiphja	FALSE
cjfjofhddkabpd	FALSE
ddjciafbppdgkc	FALSE
ddjnlboiolbglh	FALSE
doakckpdjdagce	FALSE
dobdclldidjlop	FALSE
eikmpnfpfgclmp	FALSE
eikonamijeoigb	FALSE
fcgcoopgfimphd	FALSE
fcgdmnnhdophng	FALSE
fmmnjjleodgdil	FALSE
fmnjjjnknbibem	FALSE
ggobipidkipdao	FALSE
ggocbhhjegamjg	FALSE
hbjokgmcbihejd	FALSE
hbkcclbncefaop	FALSE
hlnmhkgddleijj	FALSE
hlofklboegdmpn	FALSE
ighhepmdfmdmbg	FALSE
ighjgenipaiobn	FALSE
jaccphfifpbpjm	FALSE
jadhmiijmjpegd	FALSE
jkibehkmlbhpcp	FALSE
jkjihdjcpeiknb	FALSE
kepipaijacojeb	FALSE
kepodnkbnlkpoh	FALSE
kokicpmgnopbmp	FALSE
kokophpecocblj	FALSE
libppldcgcahbe	FALSE
licgpccglgpnec	FALSE
mcpalaigadaclc	FALSE
mdaacnbhifjpgi	FALSE
mnkhhjnodgaobj	FALSE
mnlmcmopcpidnj	FALSE
nhpmplodjhpkng	FALSE
niaejnkegnfnjl	FALSE
obpifjhflmacbo	FALSE
obplmcebikkaed	FALSE
olkcffcgfemjfl	FALSE
olkfakcicnjmdf	FALSE
pfefpmdcbpagel	FALSE
pffnckbegglgbj	FALSE
aaanjhallldabab	TRUE
aabechapacfabab	TRUE
ajoffdmpfmpabab	TRUE
ajojpcgdfojabab	TRUE
bdpemklcgmhabab	TRUE
bebgihkgocgabab	TRUE
bocdiaofindabab	TRUE
bodhmpafoohabab	TRUE
cidgmedadmiabab	TRUE
ciffhckijpfabab	TRUE
ddjlgdbgdlababc	TRUE
ddkljdbildmabab	TRUE
dobnjgdbbdoabab	TRUE
doeggdncdoaabab	TRUE
ejajhbnafohabab	TRUE
ejalnlnjofoabab	TRUE
fcilnkpaooababn	TRUE
fclcndmgcceabab	TRUE
fnhknagallcabab	TRUE
fnikkdhjmpdabab	TRUE
ghnhlkoocglabab	TRUE
ghnkpjekpelabab	TRUE
hbmlklkmohoabab	TRUE
hbnibiagjiiabab	TRUE
hmgfabfonjkabab	TRUE
hmgjbhkmmacabab	TRUE
ifefjehfmhlabab	TRUE
iffamnnmabdabab	TRUE
jabmadogbpcabab	TRUE
jabmjggpmaeabab	TRUE
jkecjgabjbiabab	TRUE
jkfibjlaogdabab	TRUE
kegkloapbidabab	TRUE
keibcghlfnpabab	TRUE
kohkokkhlgaabab	TRUE
kohoifjapelabab	TRUE
lifjkcbnkegabab	TRUE
liflffdipjpabab	TRUE
mcjjogjbbmhabab	TRUE
mckjgmmkgngabab	TRUE
mmkolgepjmbabab	TRUE
mmlaceihdddabab	TRUE
nhjmepjcdojabab	TRUE
nhkbbfkhddaabab	TRUE
obgkedjaebnabab	TRUE
obglmfjdiafabab	TRUE
oliliajgfklabab	TRUE
oljcdlnhgniabab	TRUE
pffkeiahkbkabab	TRUE
pffolfenggaabab	TRUE
aaaendjceoobona	FALSE
aaaikfidapnikhh	FALSE
akolbmlhlfajamf	FALSE
akongiifdmkbkaj	FALSE
bebinclgdmplfoj	FALSE
becpjknoamlicge	FALSE
bojilgbkmelkpaf	FALSE
bokhinhikkmahlm	FALSE
chpelapmlpeionb	FALSE
chpflogcajpjpac	FALSE
dcnfigpkmpkkmld	FALSE
dcnmlpgnhbklfjh	FALSE
dohneeddmdgndmm	FALSE
doihgginhpmfofm	FALSE
ejajflbpoefpble	FALSE
ejdinkclmhlnigo	FALSE
febehebebpfhppf	FALSE
febjlcgdlhhhphm	FALSE
fonglombnbcpkpk	FALSE
fononehkjbppmmb	FALSE
gjnhdnliaemfolh	FALSE
gjnobbfbeglhckj	FALSE
hcoekkmkjdfndch	FALSE
hcpebhkhfgmchdl	FALSE
hnmakckpdnbecbf	FALSE
hnoflidmmkcbbcm	FALSE
ihokeihhfhljfbj	FALSE
ihonecgnjfjgphe	FALSE
jbndengdjfbgdcj	FALSE
jbnijdpjeeakflc	FALSE
jnemlofodbofmmh	FALSE
jnfcidhecipphec	FALSE
khakhnbbciokobf	FALSE
khbnjpelhhealgn	FALSE
lcedmpdngldjdle	FALSE
lcekbppgdnmhnfa	FALSE
lllocdnbmkdpjcg	FALSE
lllpdcjcmndnkkj	FALSE
mghfiljjjogmbmj	FALSE
mgjfalbagcchebf	FALSE
naknpekknedjgcc	FALSE
nalgffcjldlicfm	FALSE
nkljnnbkecmolib	FALSE
nkmcgomfljpigpk	FALSE
ofajhdfbhoojfbf	FALSE
ofammhekmajpcdn	FALSE
oobcinhoppapipf	FALSE
oobfbpailhodaig	FALSE
phhkbbnihnjefmm	FALSE
phhlgdgacfcpikf	FALSE
aabigfbnjcliabab	TRUE
aabklfbkpkfdabab	TRUE
akllbjpnbeamabab	TRUE
akndohljaolpabab	TRUE
bfckkghmbenfabab	TRUE
bfdfbjmmncknabab	TRUE
bpcjccjbldgmabab	TRUE
bpconkengbajabab	TRUE
ciombhbgdpnkabab	TRUE
cipblaelhlknabab	TRUE
dcdaafpoochmabab	TRUE
dcdoaboflgfgabab	TRUE
dmikecpdbbadabab	TRUE
dmionoilghlfabab	TRUE
egogehpmjjppabab	TRUE
ehackebbmjfmabab	TRUE
fbemooecghboabab	TRUE
fbepccpjmkolabab	TRUE
flpejfaeefdcabab	TRUE
flpocjojljahabab	TRUE
ghdaeodnhbehabab	TRUE
ghdglcfkiojfabab	TRUE
hakadomipallabab	TRUE
haljjeadpbjcabab	TRUE
hkobmiigonngabab	TRUE
hkokbmjchcomabab	TRUE
ifklnchbkkhjabab	TRUE
ifmhbdjhnlmgabab	TRUE
ipoopgkaclfeabab	TRUE
jabdgbecfcllabab	TRUE
jkfiplingikpabab	TRUE
jkgmkmibiaomabab	TRUE
kehogkmooboababh	TRUE
keiljfmjcnmgabab	TRUE
kodoecchgglfabab	TRUE
kofgkkibbfhiabab	TRUE
llikcnbnilnlabab	TRUE
lljnffcdkngiabab	TRUE
mfpojkhahiikabab	TRUE
mgadimejfhmgabab	TRUE
mplhgefpaijmabab	TRUE
mpmachpmkllpabab	TRUE
nkhdaaaicogababc	TRUE
nkicipkljoipabab	TRUE
odcihffomepaabab	TRUE
oddobfopfgdoabab	TRUE
onbmcmejhjldabab	TRUE
ondjafhpehbjabab	TRUE
pfkcikegnphaabab	TRUE
pfknijmkheljabab	TRUE
aabigfbnjclilfbk	FALSE
aabkpkfdiccmlcil	FALSE
aklknpfcpimgndgf	FALSE
aklnahbidommnffl	FALSE
bfdkijbfilfogkjh	FALSE
bfffhdpjeagmkcbm	FALSE
bokknnjhjnfekoin	FALSE
bolbalfegidjiamj	FALSE
cidhehboeaipdoap	FALSE
cidplgikjopoikpk	FALSE
dcdcpmhnhbpebpoe	FALSE
dcdkajgpheigekcp	FALSE
dmibgnmkeenfjdnn	FALSE
dmjhennebokcglhp	FALSE
egljiipfdagomblj	FALSE
egmnmcemfaaocpoc	FALSE
fbhioflbmkkefale	FALSE
fbhmibhifjganjcg	FALSE
fmdcahoiaefionpa	FALSE
fmdomplgfianhlcj	FALSE
gfnoobejcphhflfm	FALSE
gfpbmnajemchnikh	FALSE
haopbhiokhcbfjkh	FALSE
hbaacfppeiojdhcd	FALSE
hldeahlgapoahiba	FALSE
hlekieekmocnkdnh	FALSE
ifjpcmkfoebhcmfe	FALSE
ifkcailjbhpmeabl	FALSE
ipphngglccimblpo	FALSE
jaaefiigikmpellg	FALSE
jjmaapjlgiljjhkm	FALSE
jjpmkmogjhlmdgie	FALSE
kfcokliojodabnjh	FALSE
kfdocamlmbdgjiia	FALSE
kolidloecjockgma	FALSE
koligeahihbenkdn	FALSE
lklaigaofheaholc	FALSE
lkmgoojicainamjl	FALSE
mfoglaifipbmjkko	FALSE
mgbpjmaldikddbih	FALSE
mpngedejapgkmpdl	FALSE
mpnnadnbjkneneln	FALSE
njgicjgnmaffcgao	FALSE
njhgneiopaiiikjg	FALSE
odckkjkcieofgiai	FALSE
odcljnkelldihomp	FALSE
onelpeiihgmglbeb	FALSE
onfdaihjjnbgoolg	FALSE
pgimdcabagdgnmif	FALSE
pgkfdajlmchhobge	FALSE
aabbbnncmnjjiabab	TRUE
aabdnddbaifcoabab	TRUE
ajnmjmmfejoocabab	TRUE
ajnnkffdamkihabab	TRUE
bedohjimnblmbabab	TRUE
beemdelkcbihgabab	TRUE
bojiklcpneimbabab	TRUE
bokkjipchjaemabab	TRUE
cikbpacepogmiabab	TRUE
cilmedjdemhfnabab	TRUE
dckchaombembaabab	TRUE
dckhpiiljbnbababf	TRUE
dmolnmcpjkjjfabab	TRUE
dnakacfpoloeiabab	TRUE
eifcagldfgmemabab	TRUE
eigeagojeglffabab	TRUE
fcgdnbdhajpblabab	TRUE
fcgimkebkijjhabab	TRUE
flnpngkooiiinabab	TRUE
flogjfbgconcnabab	TRUE
ggfaggaoldbceabab	TRUE
gggcgegagdnababpj	TRUE
hankllldmekgbabab	TRUE
haohhjbkebeffabab	TRUE
hlalaihfffpcnabab	TRUE
hlameekdaipeeabab	TRUE
iemblfgokmdamabab	TRUE
iemokhmgkghgnabab	TRUE
ioldbkhgfbohgabab	TRUE
iolildgkmgbppabab	TRUE
jilbdagepeaaoabab	TRUE
jilncofeipnapabab	TRUE
kciepknhaggchabab	TRUE
kcjhidbkloeooabab	TRUE
kndonnjdjgekbabab	TRUE
knebifhcnflflabab	TRUE
liepcafejdoadabab	TRUE
lifbacomippngabab	TRUE
mdbbipinkpcfkabab	TRUE
mddghdglnbighabab	TRUE
mnahkijednokkabab	TRUE
mnanicclblhlcabab	TRUE
nhccbodndkhljabab	TRUE
nhdnekbeckmbeabab	TRUE
obnmbgbjedglmabab	TRUE
oboilbekmgcllabab	TRUE
omimfhodbfmanabab	TRUE
omkddlkihipdmabab	TRUE
pgileioagmdblabab	TRUE
pgjokamehidmiabab	TRUE
aaakkkiglihhbbcac	FALSE
aabplobhhlbcdknab	FALSE
ajmlabgmpnmhiceae	FALSE
ajnnnakngjniipanj	FALSE
bdkedpnipdfgfjdbi	FALSE
bdkkocjecoafggfbm	FALSE
bodnldemhegkhhchj	FALSE
bodphhdahpeggdacg	FALSE
cjmppnalifejefela	FALSE
cjnjpodfgfpiknncn	FALSE
ddlhbjhpkckficfhl	FALSE
ddnfedhmmonhaheba	FALSE
dohfeonobllkllmmk	FALSE
dohhlhgipgibfhibj	FALSE
ehodicplogfecejed	FALSE
ehonpebonpakchijg	FALSE
fbeedffefmgfpfkfi	FALSE
fbgkbagmepdahhbag	FALSE
fmjbnjhdfafbooebo	FALSE
fmkmgllncmbkdcgje	FALSE
ggajmfblldhnnfmhd	FALSE
ggbddncmdbokcjfgk	FALSE
gpelgdpippkhgclnk	FALSE
gpemlhkaddfmnhhja	FALSE
hjnbplhobmaialgpa	FALSE
hjnhgfglelejdelag	FALSE
idebljhglnfaolmon	FALSE
idebndeocjolohnhf	FALSE
ininglpjkdmakoghj	FALSE
inipjndlhaeoipgjj	FALSE
jieljnnjdnblgjppk	FALSE
jifbgcglplpnfiojl	FALSE
kcmlfjplkaeclbcbb	FALSE
kcnapiiomhbbdpjbf	FALSE
kmocdnepnajaejmmi	FALSE
kmokaahepajpgchac	FALSE
lhebhbhakdelepmld	FALSE
lhekfefoikmnbakaf	FALSE
makpckcobdidenmee	FALSE
malonfohedldpadnd	FALSE
mkhikcfbeibgkhhbm	FALSE
mkhklpdjmbankcfio	FALSE
neojncochpippglcd	FALSE
neolgeldklmgflcco	FALSE
npiojfplponhjlnmk	FALSE
npkmmpmaibgmoddej	FALSE
okccbceaofajlmpjk	FALSE
okcgfnmkffbegibcn	FALSE
pfefemckcnjmiembo	FALSE
pffchkdkjnfamnonj	FALSE
aaakkkiglihhbbabab	TRUE
aabcacplobhhlbabab	TRUE
ajnflnkfeooabfabab	TRUE
ajnjgancodhclmabab	TRUE
bebdpfpdnnefmdabab	TRUE
bebilbillgcehfabab	TRUE
bojlaafhfmmahmabab	TRUE
bokdfmpdpoaebdabab	TRUE
ciolengggneedmabab	TRUE
cipcnakgjdogedabab	TRUE
debimkfahcaghbabab	TRUE
decbchnenahpinabab	TRUE
dnpmcklikkomheabab	TRUE
dobbgnpeoapmcgabab	TRUE
ehkhdbdjnbggldabab	TRUE
ehlalknlihhfapabab	TRUE
fbgpademoehfnfabab	TRUE
fbhelkcllplbghabab	TRUE
fmbagajobkphjababc	TRUE
fmbcbdbhpkaajlabab	TRUE
ggadcogmmabcohabab	TRUE
ggchaolhelhhjfabab	TRUE
gpfmgllncmbkdcabab	TRUE
gpfogjelhkgnanabab	TRUE
hjlohmpbaalbbeabab	TRUE
hjmddmefignnlgabab	TRUE
idnajfmlojaejiabab	TRUE
idnfohfnbjkoldabab	TRUE
iobogmmmgeanmpabab	TRUE
iocaidgbjapngkabab	TRUE
jifjjkahjbdogpabab	TRUE
jihmfgjoalmpnpabab	TRUE
kcopofomggaedoabab	TRUE
kcppfjlmmmgjoiabab	TRUE
kmemdngpcafejiabab	TRUE
kmhjkjnapihneeabab	TRUE
lgibjipkolcaloabab	TRUE
lgjfnkcoelgkgmabab	TRUE
manlmmadfoocbnabab	TRUE
maoncohcaaokekabab	TRUE
mkhampphlkippnabab	TRUE
mkhfijefklphdkabab	TRUE
nekmcmijghceakabab	TRUE
nencnlfdhhphfhabab	TRUE
npkcdfdpoddkphabab	TRUE
npkfdhbmenfemdabab	TRUE
okagakejhemfaababk	TRUE
okajpdpfceffcjabab	TRUE
pgdhlnibghabgiabab	TRUE
pgelfehokmppkpabab	TRUE
aaaaholcpgahilpjhm	FALSE
aaabkebmfamnfkpanm	FALSE
akdfdnkaeaoedkaapf	FALSE
akdfeghdcfimaeecgb	FALSE
bdgnaffhndheijdpoe	FALSE
bdihkfdlhnfflkgnij	FALSE
bnmloepoicignfhgfp	FALSE
bnnancnhbdebaindei	FALSE
chpemkjinedpgmdipl	FALSE
ciamedfjggphgohljc	FALSE
dblnpaidjgpjekffoi	FALSE
dbmbceclbehemmoadj	FALSE
dmeldiafmldnajfhia	FALSE
dmgoehgnbgolihbgcc	FALSE
eghbooekokkapdfnni	FALSE
eghpnkclpamkdallhm	FALSE
eppnggknjmcdlkibhd	FALSE
eppojflpiifmoogidg	FALSE
fiphcemgianmilggoe	FALSE
fipkopfgimnonfhdeb	FALSE
gbnkmjhnncdbmdfdgm	FALSE
gbocaokgcdckhklhbf	FALSE
gmhdjafbjgnfljannf	FALSE
gmhifdhlndgikicpff	FALSE
hgcpehjnohmoopnaop	FALSE
hgdifghggidngpkdjp	FALSE
ibkglbbkoglmjcbbdm	FALSE
ibkobndmgjffnllndk	FALSE
inciaebnlpkmndpmlo	FALSE
indempacfenigkcnll	FALSE
jihncndfpkjdfolhop	FALSE
jijebolchlihpcgbci	FALSE
kddpppknehbpmkfnme	FALSE
kdedbbfpohkdhmhonk	FALSE
kodgbncngmnpinnpjh	FALSE
kodgnpiekeffmboioo	FALSE
ljfgnebdpeplhlhjof	FALSE
ljfhojebkjhdcchmdm	FALSE
mdmoenddapppdbfmnd	FALSE
mdoibjbgaabmeijcgn	FALSE
monkememmgpjfogahb	FALSE
mooabefpmmedodjcme	FALSE
nihkmhmnncdnlahkbg	FALSE
nijihpnefcfbdaeccn	FALSE
odbfgbmephodndcbfj	FALSE
oddmcckndkelmfdecc	FALSE
oncpckndaicgahldha	FALSE
ondlelfacomadgceme	FALSE
pgkphjmpdakkifcbef	FALSE
pgncaoblchgahoeaki	FALSE
aaagcblkldnmkicabab	TRUE
aaajjdabknelfelabab	TRUE
akjmfkbmgopecinabab	TRUE
akkdeeobjhihbnhabab	TRUE
bembcaadagokmmdabab	TRUE
bemgdgnmmjabkkjabab	TRUE
cacgmfooeofjoefabab	TRUE
cacpomjfjainjohabab	TRUE
cjncfnkjideojoeabab	TRUE
cjocklcjkgcklbeabab	TRUE
ddhicdknellbmkbabab	TRUE
ddhnbcnephbblcmabab	TRUE
dmhlhglfgociaagabab	TRUE
dmidnbkenhjpieababa	TRUE
egalobkhiacnbhmabab	TRUE
egapafllbgpafacabab	TRUE
ephbomgpokfmnlnabab	TRUE
epighcmhepenjngabab	TRUE
fjgpkfogaaobcokabab	TRUE
fjhmnifaaebjpcfabab	TRUE
gddjcpbfehbkhccabab	TRUE
gdebenbnloleibcabab	TRUE
gnhphlfkmfapiehabab	TRUE
gnipalhiodokcgnabab	TRUE
hhlgmnaiimcgfknabab	TRUE
hhlhodngigojgaeabab	TRUE
ibflmfamadmnnebabab	TRUE
ibhdchemeadbknababh	TRUE
imdfjiibcjcjofmabab	TRUE
imedfepbchihhdcabab	TRUE
jfmmdlpbdfpjpknabab	TRUE
jfmppkeajhlljcbabab	TRUE
johhdfmbcgdkocnabab	TRUE
johnfpofppgfpdgabab	TRUE
kkhmplgklfchngfabab	TRUE
kkjieipmpecodljabab	TRUE
lekcfddeohepmghabab	TRUE
lekmfpjmkeedidmabab	TRUE
mafeackcknkpnehabab	TRUE
mafhhpnfkjbjebbabab	TRUE
mkpjjlagkekciaaabab	TRUE
mlaknkgapdfpbalabab	TRUE
nghgidiikikofcababl	TRUE
ngikcmlechbdickabab	TRUE
obaofakhdihaleeabab	TRUE
obbniecjidcmhpaabab	TRUE
olnkbhaahkcbfngabab	TRUE
olnmcfhcgibaellabab	TRUE
pfmcccgljaojpnbabab	TRUE
pfmlmblgfaeoedkabab	TRUE
aaaclnfmefhhapkenfj	FALSE
aabclhapaogapfmmkmi	FALSE
akmdhogfdhkcdifpagg	FALSE
aknjcnkbbabpkgabbkg	FALSE
bedieggalndmifpcpdl	FALSE
bedjighjjaggfdmkcdo	FALSE
bpncjmclpoijallpabk	FALSE
bpoicfgjljdeieofbjb	FALSE
cjlfpcikfnfmeondlgk	FALSE
cjljnhofioimigcdgec	FALSE
ddlecnpeaohidcddghd	FALSE
ddmjaidkeleopnkpnmo	FALSE
dnfiedhjggknhjicelc	FALSE
dnfjbcoccncjbfefegg	FALSE
ehnneahlknknjknlfgk	FALSE
ehocelgdpfjjamfphml	FALSE
fccdapnpddlicckjopd	FALSE
fccfhafnbpoedklgkgp	FALSE
fmmaikldakehigbkkaa	FALSE
fmmgnjfndbijfmlkdpd	FALSE
ghgjbpkbdjpfiikmlff	FALSE
ghheamlcigebghpdeof	FALSE
hailejbjmlmabpflhfa	FALSE
hajchmelopjnjljgmhb	FALSE
hkandhghafijcgegjco	FALSE
hkcahacinoaeegfmpcf	FALSE
iedbiejbikgonafednd	FALSE
iedocjdfbbjedbnklcm	FALSE
inhbmbfnciecajpdbio	FALSE
inhlajpmhlmkihonmll	FALSE
jiklnpojnjnknlbbagk	FALSE
jimllnegodjnggpklme	FALSE
kefcmpnialjgikakaam	FALSE
kefdhpkaakacihdifpo	FALSE
kohhlalkjpclnabfinn	FALSE
koicfdjcfoehbkbbobc	FALSE
ljmncogccjmdckgaoja	FALSE
ljnhebkaadkegoaimke	FALSE
mdnoacdbbnmndagfhje	FALSE
mdopafoljhgkldgapom	FALSE
mofdghckegijbiigaja	FALSE
mofpkmmdgohepgjohik	FALSE
nimllcjgedhmloalnoh	FALSE
ninhbhgejcaklmbpkia	FALSE
odgniafecbpnnikkfck	FALSE
odgpfmepgbkenhpgbcn	FALSE
omlbnblflboggicjdka	FALSE
omlkbdepipemdbpjebh	FALSE
pfgleafinfmclnnlldj	FALSE
pfhlfdmkminaoofpenb	FALSE
