aabpghdigo	TRUE
aachbfojab	TRUE
akbajkiiab	TRUE
akbfbdcmab	TRUE
beincakjab	TRUE
bejcnkmnab	TRUE
bpkljimjab	TRUE
bplkibomab	TRUE
ckgkogdlab	TRUE
ckickbflab	TRUE
deepalppab	TRUE
dehengdoab	TRUE
dpbbnnlhab	TRUE
dpbdocofab	TRUE
eilojbkmab	TRUE
einiljifab	TRUE
fceefknhab	TRUE
fcejdhblab	TRUE
flnhgljlab	TRUE
fmbhccmfab	TRUE
gfnemlbcab	TRUE
gfpbolkdab	TRUE
hacbabihja	TRUE
haclkmikab	TRUE
hlddildhab	TRUE
hldeojapab	TRUE
ifdbbmoaab	TRUE
ifegccddab	TRUE
ioobpdcjab	TRUE
iophijhmab	TRUE
jihnilnjab	TRUE
jijilbpkab	TRUE
kdhocdhpab	TRUE
kdlglpghab	TRUE
kndmodegab	TRUE
kneakbmcab	TRUE
licnfdbcab	TRUE
liecdccpab	TRUE
mbockjebab	TRUE
mbohnionab	TRUE
mlghhmcmab	TRUE
mljapcbmab	TRUE
ngaahkjbab	TRUE
ngdeigjfab	TRUE
npignhonab	TRUE
npikjlnpab	TRUE
ojhklgpjab	TRUE
ojieolmlab	TRUE
pejmdlkpab	TRUE
pemoeaieab	TRUE
aacckfeoko	FALSE
aachahpphk	FALSE
akhoccaiho	FALSE
akickpgjem	FALSE
bfihdfiehh	FALSE
bfjkdfkahp	FALSE
bphfoilokj	FALSE
bpifdibhfp	FALSE
ckgbiodlhd	FALSE
ckglpdleke	FALSE
dffcahochl	FALSE
dffonnlmbd	FALSE
dpfbadepcm	FALSE
dpgggemndl	FALSE
eijhldkmpn	FALSE
eikhhhdbfp	FALSE
fcoagchhag	FALSE
fcoejebpde	FALSE
flpmddfgkl	FALSE
fmakijfmpk	FALSE
ggigockfjl	FALSE
ggikdgpkjc	FALSE
hajgglpbgj	FALSE
hajigfhgpd	FALSE
hkpkoeejkp	FALSE
hlconinike	FALSE
ifhanljkmm	FALSE
ifhdpkmnfd	FALSE
iodebnoofo	FALSE
iodknndjfe	FALSE
jjhllkpadk	FALSE
jjiomgmfcj	FALSE
kdfihjkcng	FALSE
kdgcpkciak	FALSE
knfhecbfld	FALSE
knfmnmbdbk	FALSE
lhedhhfiie	FALSE
lhepnkpgam	FALSE
mcbfgdebee	FALSE
mcbgnfbojh	FALSE
mlfjkebfhh	FALSE
mlgdacljjn	FALSE
ngbgeahmpo	FALSE
ngcbfkckmd	FALSE
nphhljlkon	FALSE
nphlkopgpa	FALSE
okiooghldp	FALSE
okjjkokddp	FALSE
pgaeiklinp	FALSE
pgcnhjmemp	FALSE
aabpghdigoh	TRUE
aacbfojpbab	TRUE
akcoffngbab	TRUE
akdaoiabice	TRUE
bfbejmffmab	TRUE
bfcicmopcab	TRUE
bpfioohemab	TRUE
bpighhiieab	TRUE
ckeifmhnlab	TRUE
ckfghjdeoab	TRUE
dfekkanicab	TRUE
dffebpggpab	TRUE
dplhaihjdab	TRUE
dpmpcgacbab	TRUE
eipjibciabm	TRUE
ejagjbahnab	TRUE
fcbcffoppab	TRUE
fcbobgahaab	TRUE
fligebpdeab	TRUE
fljaegclfab	TRUE
ggkhgijnhab	TRUE
ggllpljpgab	TRUE
hadglgdehab	TRUE
hadgnekmgab	TRUE
hkmiibaegab	TRUE
hkninffhiab	TRUE
ieohcaomlab	TRUE
ieojedaagab	TRUE
iojfgnkgabg	TRUE
iojmeneafab	TRUE
jilbkmfgjab	TRUE
jilcajmicab	TRUE
kebhledobab	TRUE
kebkmgngcab	TRUE
knfcgogggab	TRUE
kngcaaakbab	TRUE
lhbcelcmhab	TRUE
lhcilcfgjab	TRUE
mcbmeiadgab	TRUE
mcddcadafab	TRUE
mlllggbliab	TRUE
mlmnoggndab	TRUE
nfekffiilab	TRUE
nfiapdcabom	TRUE
npeophnpoab	TRUE
npimknpenab	TRUE
okjichiapab	TRUE
okkcgcldbab	TRUE
pennjakhfab	TRUE
peobjkdjmab	TRUE
aaalodjknjo	FALSE
aaclpehbmad	FALSE
akglofgdjhg	FALSE
akgnidedkdi	FALSE
bdjfinmcfcd	FALSE
bdjibcdoiae	FALSE
bmpelhdmjmm	FALSE
bmppaleipln	FALSE
cgadoiaefcg	FALSE
cgbanlhecmp	FALSE
daakcfdmakn	FALSE
dackacmlooo	FALSE
djhdennhebo	FALSE
djldodlegak	FALSE
eeblgifbgbh	FALSE
eebpdeclgnc	FALSE
eoaapgkmcki	FALSE
eoanpacoggd	FALSE
fihdplpjgfg	FALSE
fihfffpcdcn	FALSE
gcgcnbfjbpj	FALSE
gchoehoalpl	FALSE
gmldnckcgdo	FALSE
gmminmebimc	FALSE
hhcafdcmjam	FALSE
hhdiaicdkmc	FALSE
ibiopkmdpng	FALSE
ibjombnoebk	FALSE
imedgpjkodb	FALSE
imfccnledjc	FALSE
jfmgaelldmc	FALSE
jfobcenombh	FALSE
jppnjfghcjd	FALSE
kaaomfijjpg	FALSE
kjpnnakjnij	FALSE
kkahhlfgbeg	FALSE
lepbiaejoll	FALSE
lfbaegbmgbg	FALSE
lpfgimhkklg	FALSE
lpgbpjecako	FALSE
mlmicddkmpd	FALSE
mlmjlbflphi	FALSE
ngdcajblkia	FALSE
ngdjjlkcocn	FALSE
npgmlfjgpfk	FALSE
npgmmdjdmic	FALSE
okhdpoiiani	FALSE
okhebbkodkl	FALSE
pfcekclbckd	FALSE
pfdapnffime	FALSE
aabmkkgghkph	TRUE
aacfmcfabihh	TRUE
akfnaoaiaiab	TRUE
akgalnghbbab	TRUE
bedjgdmpdnab	TRUE
befcfldcfgab	TRUE
bncdmhmbmaab	TRUE
bnchkiblglab	TRUE
cgnadkcdggab	TRUE
cgnimjhflnab	TRUE
dabkhkbanljo	TRUE
dabpkebffnpd	TRUE
djpeooalpbab	TRUE
djpjiaailkab	TRUE
edocbjbjcoab	TRUE
edojkogjloab	TRUE
eogamganjoab	TRUE
eoghddealjab	TRUE
fijmdogphgab	TRUE
fijpicfkooab	TRUE
gcilpcgnemab	TRUE
gcimbmappcab	TRUE
glpdhkoammab	TRUE
gmaokfbkhcab	TRUE
hhfdlcnapiab	TRUE
hhgfghhnklab	TRUE
ibbckakgfoab	TRUE
ibdniecmilab	TRUE
imcbnepanmab	TRUE
imddpdkjgbab	TRUE
jgkjhcldpoab	TRUE
jglphmifmjab	TRUE
jppnlmdccaab	TRUE
kaaeebbipbab	TRUE
kkilcfefkiab	TRUE
kkjpnipbkgab	TRUE
lfimjklaehab	TRUE
lfjbmkbmenab	TRUE
lpchdnhdgabc	TRUE
lpdpmmlpcjab	TRUE
mknmglklmnab	TRUE
mkoijlahjmab	TRUE
nfnjinnfmaab	TRUE
nfohmjbempab	TRUE
npjalhbcgabl	TRUE
npjghbicieab	TRUE
okgbaonhonab	TRUE
okgbognjplab	TRUE
pfgiodmalmab	TRUE
pfgkfnfjohab	TRUE
aaagohdedije	FALSE
aadaiggfkmom	FALSE
alghcgefngkb	FALSE
alghniobmpod	FALSE
bggeelmnmhpg	FALSE
bghjjoeebcmm	FALSE
cbbigajlnacf	FALSE
cbcijhaheopc	FALSE
ckmbikieggac	FALSE
cknhjeikioik	FALSE
dfagelmjdegi	FALSE
dfagjkpaooln	FALSE
dnmihncdcohi	FALSE
dnmmcpkcjgjb	FALSE
einkdfdechgg	FALSE
eiphomfaflid	FALSE
fceemgoebpci	FALSE
fcegnjopgjdf	FALSE
fmljmlhamkbj	FALSE
fmmieggapkna	FALSE
ghamknepihjn	FALSE
ghbchifjbhaj	FALSE
gphmdjeajcem	FALSE
gpihcaonjfmi	FALSE
hjfnbnihcnmj	FALSE
hjglacfapadh	FALSE
idmiclngepcc	FALSE
idmimhcmkogo	FALSE
inoleeoaioba	FALSE
iobgcjmjhalk	FALSE
jikobmbdefja	FALSE
jilbddhghoid	FALSE
kdanlobljind	FALSE
kdbhleamanib	FALSE
knebfaiapheo	FALSE
knfdlongohhn	FALSE
lglkhlcamadd	FALSE
lgmbfigmfibm	FALSE
maehnaglcodn	FALSE
mafgknbmkkoc	FALSE
mkkhobgekcpe	FALSE
mkkkhhihgglo	FALSE
nepmcgjikffk	FALSE
nepocjcecccj	FALSE
npgpppilijca	FALSE
nphnahejgeal	FALSE
okalenbamjho	FALSE
okbbjoidkfdi	FALSE
pegcceonfeop	FALSE
peghdhpnaehj	FALSE
aaacjjpgifdab	TRUE
aaboejccepapg	TRUE
alblbcnmebhab	TRUE
albnjahknloab	TRUE
bggfiklnlmoab	TRUE
bggmkmbfheiab	TRUE
cbdjblchogcab	TRUE
cbdjpeofdcjab	TRUE
cliahlhdhmiab	TRUE
clifcfcmkfiab	TRUE
dejjeildefhab	TRUE
dekeaklpbjfab	TRUE
doiifbcblehab	TRUE
doinlfcideabd	TRUE
eicipghnglgab	TRUE
eidmkbfpkkeab	TRUE
fcenfbeajbmab	TRUE
fcepojbfgceab	TRUE
fmnbnpnkafmab	TRUE
fmnkojiccaaab	TRUE
gglhccbghjkab	TRUE
ggljaibnlncab	TRUE
gpknmcooapkab	TRUE
gpmakomojeiab	TRUE
hkaobckjamlab	TRUE
hkbjpfpodplab	TRUE
idmbdinjbgoab	TRUE
idohgcipejgab	TRUE
iobdmckihamab	TRUE
iobglnkooooab	TRUE
jjgbelglabnac	TRUE
jjgfihdpddgab	TRUE
kdfdckkhhhpab	TRUE
kdfjmbfmdibab	TRUE
kngjbojidooab	TRUE
knicdbfgddcab	TRUE
lhighdliljhab	TRUE
lhjappbdphhab	TRUE
mabliepakidli	TRUE
mabonfcipllhc	TRUE
mkemkeiofgkab	TRUE
mkfifelomedab	TRUE
nfcamjgpdggab	TRUE
nfcinkcegjgab	TRUE
npkoagaopedab	TRUE
nplcfjijlmoab	TRUE
ojhkpbaihefab	TRUE
ojihoinkdlhab	TRUE
pefnjimnbpgab	TRUE
pehcoaippfnab	TRUE
aacdinppkpfjj	FALSE
aacldfpaafmaa	FALSE
alcbcjancggji	FALSE
alckfalkpgjjh	FALSE
bfjgbbgcfklnl	FALSE
bfkdijcolokha	FALSE
bpebhmfcloldh	FALSE
bpgpdhmlkbing	FALSE
cjdjkodgkjakn	FALSE
cjfamdieejjlm	FALSE
ddihkcpolppmi	FALSE
ddjchkpnpfadf	FALSE
dnllenebopbmg	FALSE
dnmnagogojpce	FALSE
ehneadfmkfeap	FALSE
ehpalobbhmldo	FALSE
faplhpbmlhjjj	FALSE
fbbccadmdjlan	FALSE
fllfonjlolebd	FALSE
flloidhghagac	FALSE
gfpgfmchmnfoa	FALSE
gfpkcbmkolknh	FALSE
gpoelgjhjhpbm	FALSE
gpognepepdlag	FALSE
hkieaiafbgbbn	FALSE
hkignjgnedfej	FALSE
idpefmkfpkjao	FALSE
iebhfedacnbgm	FALSE
ipnihplnoclaf	FALSE
ipnkagljaoiep	FALSE
jkakphpjcckfg	FALSE
jkbanihkcdkjo	FALSE
kcpmpggldmalf	FALSE
kdbpnlcgilboi	FALSE
knlcdcolpfmkf	FALSE
knmodhdblncmm	FALSE
lhbppicfbkbnh	FALSE
lhcbnnjhcebjc	FALSE
mcbokaepinfhn	FALSE
mcbpogjmnpobp	FALSE
mnfjkdhojapgf	FALSE
mngifoncoamdn	FALSE
nhglpdcfdakce	FALSE
nhmmhbckcgmcn	FALSE
obdlkfjefjhil	FALSE
obdnpjljmdmbb	FALSE
okmahglfeeajo	FALSE
okmihelelfnce	FALSE
pfkeonklikeoc	FALSE
pfklkbiankhcc	FALSE
aacdbfpkjbpmab	TRUE
aacgokibfemmab	TRUE
alafeabedmdbgf	TRUE
alajmnddncmjab	TRUE
begkppiicmngab	TRUE
behcninandhnab	TRUE
boohkabmcdnaee	TRUE
bpbbcnhnnpjeab	TRUE
cjmfkldhlmgdab	TRUE
cjmjdhdkacncab	TRUE
ddoeccocigffab	TRUE
ddokhlfdgfiiab	TRUE
dniilgajngkhab	TRUE
dninbbeabakmoc	TRUE
ehkjjceebmpjab	TRUE
ehlgojgkpklkab	TRUE
faoikmebpdkdab	TRUE
faokmhjcbickab	TRUE
fmbcleagfflfab	TRUE
fmbmbfmkkgmdab	TRUE
gfpelfojllkmab	TRUE
ggacmcaonbkdab	TRUE
gpnlfdflpadkab	TRUE
gpodjcfeflcfab	TRUE
hjnppfcepogjab	TRUE
hjohciipldlgab	TRUE
ieegmnfmbelcab	TRUE
iehcahbeajdhab	TRUE
ipmecelfdhdgab	TRUE
ipnhellcpchlab	TRUE
jkcdkdjjajdfab	TRUE
jkcedlegpdheab	TRUE
kdbnhmmcaojpab	TRUE
kdcakfkhlkgaab	TRUE
knaahnalnmpaab	TRUE
knaccljkgfoabi	TRUE
liejobkhjipoab	TRUE
lifecgblfklgab	TRUE
mcjejejnimppab	TRUE
mclnnkdfcoagab	TRUE
mmpoalidoebaab	TRUE
mncjhbldfkamab	TRUE
nholoabneffabf	TRUE
nhopafpfdlahab	TRUE
obeeooonhnflab	TRUE
obeolnilkbcjab	TRUE
olgplamdbedgab	TRUE
ollfamgjljkiab	TRUE
pfgkmfinhfaoab	TRUE
pfhedkfgemfcab	TRUE
aaaaenbbldjkfg	FALSE
aaafndhnffleii	FALSE
akfjnbhchjlmce	FALSE
akgcmmgaaaeelf	FALSE
bepmdaeibkfiki	FALSE
bfamekdniedgnl	FALSE
bplchjblgkflci	FALSE
bpndpiadgknbba	FALSE
clbomlaamldegf	FALSE
clcegmdfakfcoo	FALSE
dfmhloakhakakm	FALSE
dfnbekofmbdidg	FALSE
eamnlbhnojiiag	FALSE
eampgdhbgboopl	FALSE
ekngbhjdgdnaca	FALSE
eknokjiadkikcd	FALSE
ffhohaaflhdpni	FALSE
ffimnjoglglpjd	FALSE
gagjhnkldcpaal	FALSE
gajgpnokmjagph	FALSE
gklhghgebelihf	FALSE
gkndcpkolicljl	FALSE
hfcgmdledjbojh	FALSE
hfcmddfjjbpbck	FALSE
hpbainlfapmkbp	FALSE
hpbcfakhmammdb	FALSE
iijopfndpdjebj	FALSE
iikcpbdookfijk	FALSE
jdhmhccafhmlak	FALSE
jdhncjmbgjodah	FALSE
jmikicoolpckbd	FALSE
jmjgfcomfkbjpe	FALSE
kglmfpobhboobe	FALSE
kgnkfgocpggnoo	FALSE
laimmjffdnoedh	FALSE
lajgjipgiioapa	FALSE
llcdbmahcmacap	FALSE
llcioilcljejfo	FALSE
mfhiphcgjiffaa	FALSE
mfijpmbcelaijj	FALSE
mofmljlicbnolg	FALSE
mofmoaoeblgodf	FALSE
ninmmnhnalekfe	FALSE
niomojhfkelfpc	FALSE
ocfpckadiilafb	FALSE
ochekejgahbind	FALSE
omhidgkibbblgp	FALSE
omiiceakolmihk	FALSE
pfkmjcmlaacmgh	FALSE
pfknopkmfegikc	FALSE
aaalldoiiadipab	TRUE
aaambkjfecgcdab	TRUE
akafamncmiemoab	TRUE
akapchlappaofab	TRUE
beljnghfgacoeab	TRUE
bencnnejljkneab	TRUE
bpmdengjajjeaab	TRUE
bpnahijaphilpab	TRUE
ckpihljdibdndab	TRUE
clajpoidmjgegab	TRUE
dflcpdkpchkfgab	TRUE
dfmoaadfhdcbabe	TRUE
eapfdkjllakgabe	TRUE
ebbaodjphkjgdab	TRUE
ekhlaccmikipdab	TRUE
ekhnncbkgcpkfab	TRUE
fenaljlijnlilab	TRUE
fenjpkeaedncoab	TRUE
gacmmlbbbcbeeab	TRUE
gacnipofaecfpab	TRUE
gkjkkakdeekiabj	TRUE
gkkbifjmnpomiab	TRUE
hfcakjojkhokjab	TRUE
hfcmadpabngifid	TRUE
hokehdabcdiapai	TRUE
holppllbpiegabm	TRUE
ijaglkpkfflfkab	TRUE
ijbggoiccionmab	TRUE
jcnnebnckalgabh	TRUE
jcojhdceapllaab	TRUE
jmkjiajpmbhppab	TRUE
jmlklijbmnnogab	TRUE
kgbnldenikhnbab	TRUE
kgecopegjkbliab	TRUE
lahdffhookcbdab	TRUE
laideffomlfppab	TRUE
lknlcnnaidkphab	TRUE
lkpfkjgejijidab	TRUE
mffhhamgoggboab	TRUE
mffjohlnkfgfhab	TRUE
mombcbhepjmpabj	TRUE
momllijcecdcaab	TRUE
niijbghabglnkhe	TRUE
niiomfageegfnab	TRUE
ocggihlkppjbeab	TRUE
ocilhjeannlmiab	TRUE
omiblolcifjedab	TRUE
omjjbokgddnhfab	TRUE
pfogildbnfjljab	TRUE
pfoiclgfanidpab	TRUE
aacdiigpaofekpg	FALSE
aaclmjijmgnfded	FALSE
aklfnpebkecbfem	FALSE
aklgnimlgpkalhn	FALSE
bdppdnajhjejdnf	FALSE
bechoeedpdgopfd	FALSE
bobbljoohkjicdg	FALSE
bobjpomneaklgjg	FALSE
ciagehefgiofhln	FALSE
cibeodplmijnjho	FALSE
dcoghnmnblnkphc	FALSE
dcpeomcjjnncfom	FALSE
dnfnoanghdihacn	FALSE
dngbjaenbjgoakc	FALSE
egkmjlikblcepfg	FALSE
eglhfeejelipebp	FALSE
epkkhdnjkapjcoc	FALSE
epkkiglcpjpmaij	FALSE
fjenleggodpapld	FALSE
fjfmalkhjfbllep	FALSE
genjjhkikdhjomh	FALSE
genkafdogdbmfeh	FALSE
gplkccnbopgmccl	FALSE
gpmcpnplliamgon	FALSE
hkjapfgijieagbk	FALSE
hkjcgmichinfimk	FALSE
ieklhgjbiecjbib	FALSE
ieljmligdmdffdc	FALSE
iomhpaepoolajcp	FALSE
iomkpdmajjjhimm	FALSE
jighlpjggeheghp	FALSE
jigighkigmjmfog	FALSE
kcockbddaiiopdb	FALSE
kdadpolbconppkh	FALSE
knpeamplkkofemk	FALSE
knpfjckchkfbnma	FALSE
libkjolmmckhbeo	FALSE
licckhngbhcndba	FALSE
mchlajajaillpjg	FALSE
mcigdfeknilhbcg	FALSE
mmhgpfgobjijfig	FALSE
mmhkjakanefcfpg	FALSE
ngnalmflcjlaend	FALSE
ngondfmnfmppamd	FALSE
oakiiaibmdimiij	FALSE
oakooeacnejmfnj	FALSE
ojpgcedjinjmapp	FALSE
ojpobhlpoifobdm	FALSE
pfhjnmeeahaldao	FALSE
pfideoeomekohho	FALSE
aabkpkbfhpnmninp	TRUE
aacbfefpoochmeab	TRUE
akjjndnecnddenab	TRUE
akkglocdjolflgab	TRUE
bednejolfcehgeab	TRUE
beekcjnhmcngafab	TRUE
boenckbpcffihjab	TRUE
bofbgchabofoakml	TRUE
cijkeknamdieabnf	TRUE
cimmccffplkmlnab	TRUE
dcalebniligmcjab	TRUE
dcbeepjodaiegmab	TRUE
dmpmhalifnmneaab	TRUE
dnablgblkmapgfbh	TRUE
eghcjmadompdpaab	TRUE
egieggghnpaccjab	TRUE
epbkikflpncbmiab	TRUE
epcflldhbjhoobab	TRUE
fjjmojnbdlkmecab	TRUE
fjkbgbhgddfcceab	TRUE
geiifimpajdmkbab	TRUE
geinphmlkhbjagab	TRUE
gpjlgmddhdpkjoab	TRUE
gpjnchelanlhmdab	TRUE
hjpjgjlognliimab	TRUE
hkanffeilgnjhjab	TRUE
ieegfaapigbncbab	TRUE
ieeoclkhfhlnpkab	TRUE
iofeifhdcmmnbgab	TRUE
iogbmgcliiaiafab	TRUE
jiclkpgejniopdab	TRUE
jidgdfogfhmmccab	TRUE
kddmofengapomiab	TRUE
kdedjepbcpekbdab	TRUE
koaidaodjhkmagab	TRUE
kobdjebaophnaeab	TRUE
lhhijlgmmedbegab	TRUE
lhhjahkjbcamoiab	TRUE
mblgaboapdgpjgdb	TRUE
mblpmcjfdkbpooab	TRUE
mlkaiogdojhjjmab	TRUE
mlkdijmnjgfhmfab	TRUE
nfidfcjheapehdab	TRUE
nfjpedmomdgfhdab	TRUE
oaphedhkijopmdab	TRUE
oapikgdlnnkbbeab	TRUE
oledmjanniiikoab	TRUE
olfkdhbabembopon	TRUE
pepncldcgkmbfpab	TRUE
pfadiiohkbmikaab	TRUE
aaainggibpgopklj	FALSE
aaanheinaohnnbaf	FALSE
ajdanmjccndfbffh	FALSE
ajemhgpckjgemlli	FALSE
bcfbbccjkpgbjjpf	FALSE
bcfpekhbmahnllfe	FALSE
bnipleinlefpchdd	FALSE
bniponcfjhijdmmj	FALSE
cjdlbnlnfhgbfmfl	FALSE
cjemfnomgpieocnb	FALSE
dcgloolodplfoijp	FALSE
dcgpmfinceknffep	FALSE
dncklpekplededgd	FALSE
dndkmpilmjjoljfc	FALSE
eipaencgbfajjhpc	FALSE
eipffihobpapomdp	FALSE
fdamjnmdonbibkdc	FALSE
fdcdioffgojcdmof	FALSE
fnlbpbeoebobneal	FALSE
fnljfelhpbdbgaog	FALSE
giiknelddnbmaogk	FALSE
giipeahkmpaefglp	FALSE
hchoehedhibfgled	FALSE
hcjclhdgpdoggkcb	FALSE
hlnccfjfeahifole	FALSE
hlniclncdincgjim	FALSE
ielpepnbbaccnjbe	FALSE
iemghamffipbbafb	FALSE
iocebogpcmaekhdb	FALSE
iofkmmbblfoegfah	FALSE
jiinbekfndgplege	FALSE
jijgpnlechjehiom	FALSE
kcncbakmmfnlonjl	FALSE
kcniommlikipkdjg	FALSE
knhimbajppagjfgo	FALSE
knhoaephljhhhdfa	FALSE
liaibdhhmilfjpbk	FALSE
lialinpmglogmkfh	FALSE
mchfihjocoainhcj	FALSE
mchghgciekhfdgef	FALSE
mmfhkhpcobihlehk	FALSE
mmfkgofljmeckdkl	FALSE
ngcdobbcopegoihj	FALSE
ngdepnlnckgjngjd	FALSE
obafijobhebnpaka	FALSE
obaglblnjginmgcg	FALSE
okojifhkmalokdmh	FALSE
okolfhphekkbkekp	FALSE
pfdblalfafnonehg	FALSE
pfdpblgcbfdoegpg	FALSE
aaahoommidlhnplab	TRUE
aabdbmjlnkkfgcjlf	TRUE
ajfandcbnpadfihab	TRUE
ajfjglpkcdmonclab	TRUE
beaikbhmhbomjahab	TRUE
beanlhaggjjbcniab	TRUE
bopohicajecijonab	TRUE
bpbpojpfkpbocdoab	TRUE
ckbjhnfcddmffanab	TRUE
ckcbbhgckkkejpjab	TRUE
ddicpkkhjnlfjinab	TRUE
ddiddhpbcfgmlljab	TRUE
dndpaoapcnlobglab	TRUE
dnekjgdpajimdibab	TRUE
eijgjjopcmcakbpab	TRUE
eikljafkacdceegab	TRUE
fcinaeookaaefamab	TRUE
fcjhlmkddnomdbiab	TRUE
fnaanfdfibjknchab	TRUE
fnacoeiepijfjcoab	TRUE
ghlhhmbcmmfllnnab	TRUE
ghmcbfochmialopab	TRUE
hanhcigbfobifgkab	TRUE
hanmbchgbnikachab	TRUE
hjifhkgdgabhhcjca	TRUE
hjipkmlpfbmmgclab	TRUE
icnebnkpakbgpjoab	TRUE
icoijjjapjnkkbcab	TRUE
infacpdajadimedab	TRUE
infmnhikhceflnaab	TRUE
jhjiflegfphbeoabl	TRUE
jhkigpbbbkdfmkkab	TRUE
kcdonaceecjekglab	TRUE
kcdpehhgpmnpnagab	TRUE
kmndejlecjchbfoab	TRUE
kmneacckpjlhmmfab	TRUE
lfpdpgmlookbmgbab	TRUE
lgckaphmmccjckcab	TRUE
makgcamgocchdibab	TRUE
mamaiinipachhokab	TRUE
mkocnbfjomgbnkmab	TRUE
mkofmpahmiecibdab	TRUE
ndolihfbkfcffdfab	TRUE
ndpfadbooaniogdab	TRUE
noebfbcehfnlkncab	TRUE
noebknakdidnjjoab	TRUE
okocjakpnfcfnbfab	TRUE
okooclhjbohiobjab	TRUE
pejinmpglkoggdjab	TRUE
pejlebckloajegoab	TRUE
aaclfajlepefoojfo	FALSE
aadmlfndjcmaklehe	FALSE
ajnkidmaailigefjp	FALSE
ajoedohimdciibbhp	FALSE
bejondnbapcmpcjhe	FALSE
beknbfgnkdojekkkl	FALSE
bpapeokhdhbbnaghc	FALSE
bpbdfcknopbjpjkog	FALSE
cjngfhnonhdfjibhb	FALSE
cjnnfedpeellcdipg	FALSE
ddjeknlmegaoopobi	FALSE
ddjjjdfmamogemani	FALSE
dnppoljijihkfmaol	FALSE
doakbenejljheiffk	FALSE
eibgccnhdbahegldk	FALSE
eibploooknibjhmoe	FALSE
fcjaeehccccnnjgmh	FALSE
fcjbmiifeoodddllo	FALSE
fneoegllemhbfnamk	FALSE
fnfbbbjnlkhdmaeap	FALSE
ghbgkmcaklhpbnhjl	FALSE
ghbmhgkpgggafmjgm	FALSE
halikjbcflgndnfma	FALSE
haojghhemkmnbnmfi	FALSE
hkdhdepdjapolpolh	FALSE
hkdkegljpkangeanc	FALSE
idemellmkcjociphh	FALSE
idfagpcmknjcnoajp	FALSE
indplegojcbkkehjk	FALSE
ineclkgignhjioapb	FALSE
jhhjlhmmfdcfpgjbh	FALSE
jhiclnonegoefhiak	FALSE
kcbmjehfakifpobho	FALSE
kccpokcecamdnhmje	FALSE
kmmplfniggkmbegek	FALSE
kmnihdkbbkhpcejlp	FALSE
lgfklkjmaaelfahnm	FALSE
lggciekcmjomcehnk	FALSE
magccdgaldaipnkcm	FALSE
magcoanhdpkpccoai	FALSE
mknakfjadhldicnbo	FALSE
mknbdniejgfpnadoc	FALSE
nefifokemgklicgfb	FALSE
nehlicjgamnechdhb	FALSE
nobibmdajheaahaof	FALSE
nofhiffeidlnjjdon	FALSE
ojlmagodbpajcmgmb	FALSE
ojlndpmddeoiinnmn	FALSE
pfdgaggfkmclgleci	FALSE
pfdhnahlcfkjadiof	FALSE
aackmfjbadncdlhoab	TRUE
aaegjedhbnkfjnmhab	TRUE
akihookedhliliffab	TRUE
akjncjabkmgcohomgi	TRUE
beplkfilipnjokboab	TRUE
bfagcionnhfdhajpab	TRUE
bojoefbbdcomhjmjab	TRUE
bokokkkmighnjmlcab	TRUE
ckfipenppbcpjjklab	TRUE
ckfkofkogngggfjeab	TRUE
ddgmeddnjebglnkkab	TRUE
ddgpphlniicdpkceab	TRUE
dmnjbmjapgkenmfeab	TRUE
dmnonfldfjebabiiim	TRUE
ehkanfhppnlmklgnab	TRUE
ehkhbkfniehipdbcab	TRUE
fddbkdhmaelheahoab	TRUE
fdebjibedoldfcdhab	TRUE
fomhjnfpjeabpagfee	TRUE
fookhjlhchoidnfdab	TRUE
gjehmgcbikdfmncnab	TRUE
gjggfdboelklhaehab	TRUE
hdianfakelccfhinab	TRUE
hdihihdmkcjlodngab	TRUE
hokjbebicjjgdncoab	TRUE
hokmdeibgnmbjemlab	TRUE
iickgnphmalnmedhab	TRUE
iicnfbldoalofmaoab	TRUE
jclbfnlklnmlgkegab	TRUE
jclbjhkddidahppgab	TRUE
jlmjkalclocfcakgab	TRUE
jlnacfdmldalfbbkab	TRUE
kfliclgnbmlkmmadab	TRUE
kflodfhafcgepcpiab	TRUE
kpnojnhibjchbkgoab	TRUE
kppimepbcmkdpiinab	TRUE
lifdbkoiodacllcbab	TRUE
liggbfmbgbdmjgiiab	TRUE
mcmhliegcnfhajfcab	TRUE
mcmiaicddafoajpeab	TRUE
mmpegngpfbidnfgfab	TRUE
mnaklpipjaofljpbab	TRUE
nhdifoomkfklmjhaab	TRUE
nhjbdjibknfohbalab	TRUE
objoaobolelcfjkhab	TRUE
oblbcbgepbdhmmppab	TRUE
olcchaeddpmcpkffab	TRUE
oldibehdkmgkdijfab	TRUE
pfiojkppiohajfioab	TRUE
pfjccaohhmijgakiab	TRUE
aaaiifkikidoaanicg	FALSE
aaceoeogmkgkljbkeg	FALSE
akefpiilebcilhkpjk	FALSE
akeggochomdhheland	FALSE
bejgjbghjoapmpbbme	FALSE
bekiehmmofpjhgalpg	FALSE
bojknokhijijecocll	FALSE
bojlkcdlnjfmjldokn	FALSE
cimifmcnkoebigpdoa	FALSE
cingjeemmhmicpeebd	FALSE
ddoeialclcicbdccke	FALSE
ddofgeinbfnpgfpdko	FALSE
dnojfeengnkokcmngg	FALSE
dnojgnpfjhjofkodnk	FALSE
ehkonoegeoeceifemb	FALSE
ehlokeihnniohcgkja	FALSE
fcdppplchijkgcjgjg	FALSE
fceagmkehjajgdjhlg	FALSE
fkkkmopalipcedlcmk	FALSE
fkkoocogffbigplnnl	FALSE
geojophnnfmeggcgjl	FALSE
gfakbfofekoppjgpld	FALSE
gpemgefdpnjifiobpp	FALSE
gpfegfadamkkckjolg	FALSE
hjelonncidlcpipapg	FALSE
hjfejgdolckkndahoh	FALSE
idhkmghhhcohkbeodm	FALSE
idhphgmpphmakgigha	FALSE
incmghoimhkpfaijhk	FALSE
indjjokmimmaebghec	FALSE
jgpajbohiamiommanf	FALSE
jhbohdpgocfgpleaol	FALSE
jppbocafihlcemjkgd	FALSE
jppfdkljcofggjjnim	FALSE
kknghfjecglemmpbpi	FALSE
kkniacjnadgmkjaiam	FALSE
legopojifjkhkpppij	FALSE
lehkekndnokmngccld	FALSE
lnkkgjppokajnfhddc	FALSE
lnlapfagaamnohamno	FALSE
miicjcmohmbkojkblj	FALSE
miihaadpblgagojdia	FALSE
ndophonbpmfcfdemhe	FALSE
ndpojgkgibnpgcbbib	FALSE
npfeaocheefljgoemm	FALSE
npfpfcaagcpopjcopc	FALSE
ojnfnlnfphacpeodko	FALSE
ojnkcoiopaklnellfc	FALSE
pfglgdfagpnjemocmj	FALSE
pfhphljkkmapgnmmeb	FALSE
aaakapefiodfmmlncab	TRUE
aabehmebfnobkbfphnj	TRUE
aldmfgmogmlinlloeab	TRUE
alfeooopnfcgldlnnab	TRUE
bfladfbbflofjichoab	TRUE
bfljbdlhomceddhffab	TRUE
caancpfnbeneonjfdab	TRUE
caaoceolpefmaoajgab	TRUE
ckcojkflbajebbkncab	TRUE
ckcopkfgjnepmblliab	TRUE
deajbdlkigfknemhjab	TRUE
decmlbfpnohlbhffcab	TRUE
domlngohpkbdoggdpab	TRUE
dongaeljonhmkbabodg	TRUE
ekehnpgiddodfaahiab	TRUE
ekejeemmimlopohpbab	TRUE
fdipnbnbnpafhdmdfab	TRUE
fdjknahlmfegllepmab	TRUE
fogelacneefanpkihab	TRUE
fogncekmbpnhjbckoab	TRUE
gifmfbjbeckeffffbab	TRUE
gignapjmbgnfbonfdab	TRUE
hbgafloodemhkhkfjab	TRUE
hbgjapeejjimcocfpab	TRUE
hljkbkjeojnochjlcab	TRUE
hllbaeghhdfdhmfegab	TRUE
ifchncilbboofoenpab	TRUE
ifebleknahaadjjibab	TRUE
iooolpeljjldbfpnpab	TRUE
iooonhljjjjodfkmhab	TRUE
jjdoehgmhmbfffpanab	TRUE
jjdpfhffbgjbkjphkab	TRUE
kcoookdlmdincbphcab	TRUE
kdbcaofjadbgmpiblab	TRUE
knjmjmgeicnidigchab	TRUE
knkdjllpblinhkhjjab	TRUE
lhgpemfpjjenjpmlabk	TRUE
lhkboabjleheaoehgdl	TRUE
mceapapiokaogphfhab	TRUE
mcegcdejhnlhflflgab	TRUE
mmngppdkdfjailiehab	TRUE
mmnkeelafkffppkljab	TRUE
nhofddmjcbhdajcjkab	TRUE
nholfeicllchchbkjab	TRUE
obhbcfmgadkidkchbab	TRUE
obhhpjinddbncjngoab	TRUE
olbddjhdhngknfeanab	TRUE
olcndhmeplhbhhpebab	TRUE
penbdoockfddplbeeab	TRUE
penhmpilmdbflddeeab	TRUE
aachjhggjkdnialcjfp	FALSE
aacnjhkfdenpaibkmhj	FALSE
alekjeipfkenpkokbnk	FALSE
alffncelakjphfbfake	FALSE
bganmpfiadfjkenojna	FALSE
bgbhfeefpbhilbhimei	FALSE
caadindhhfjiocnjkjl	FALSE
caafefcoimhfhpijeoa	FALSE
ckdfofmdbokononcfdm	FALSE
ckfgjiebdghpacdhcog	FALSE
deelpdpanflacaiklen	FALSE
degkglfkgpjghkmafkk	FALSE
dooeboopcnpicpnlmeo	FALSE
dpadnggjoafkkifepae	FALSE
ejijggddbblpgjfmplf	FALSE
ejjhlnlfffjcfifbflf	FALSE
fehlihgdgcbapkkoeea	FALSE
fehmgeddnjilngdiike	FALSE
foohncdmkclfggihalc	FALSE
fpaegphpdddndkjfnen	FALSE
giaogaoockkncpmkbfi	FALSE
giaojehdkmhlhbcjcig	FALSE
hbfcjdmdcfjnelmjepc	FALSE
hbfdnkcnfhomaokpfpd	FALSE
hljdebmlfbpaokfdnkl	FALSE
hljgiodcclodpibpooi	FALSE
igelfmanioopfemhaoe	FALSE
iggkjkgdbeahfkaapgp	FALSE
iondbemplngkedhegjo	FALSE
ionkiapipgdnijdnhja	FALSE
jigogociflophhfijfh	FALSE
jihfmjkpaoaoegfpckf	FALSE
kdckhnbiohhjokedmnk	FALSE
kddeaijeoecnndjoipm	FALSE
koblkcjfoaolfncjaeh	FALSE
kocdadehmnmmejgkkih	FALSE
lieacacieomegpmonap	FALSE
lielojjcgicebgdjakk	FALSE
mbnekjogcfnbmlicbnp	FALSE
mboljgnjeekehjnfafk	FALSE
mlfbbnbkkhjdgojjmpi	FALSE
mlgfhgbpbdcmiagebfh	FALSE
nhbomeiicnlfgjbdjgf	FALSE
nhcmhdjglenlhojahjb	FALSE
obnkfjlgkbfjjgbogik	FALSE
oboihhkobhnblagclin	FALSE
okmmepadcpcpcondlgn	FALSE
oknflpghhpjikaacinj	FALSE
pfbflpflnfjflldbnok	FALSE
pfbgnmdadiomhhfldjb	FALSE
