aaakgpcdcd	TRUE
aacgngaaaa	TRUE
ajcohfabcd	TRUE
ajgaanbbaa	TRUE
bfgpdjcdcd	TRUE
bfhcdcaaaa	TRUE
caepfgcdcd	TRUE
cafanncdcd	TRUE
ckecboaaaa	TRUE
ckegcdbbaa	TRUE
ddhbfebbaa	TRUE
ddhfficdcd	TRUE
dmmidgcdcd	TRUE
dmmkfcdcdo	TRUE
ehbjobcdcd	TRUE
ehboamcdcd	TRUE
faadbbbaak	TRUE
fabajlbbbb	TRUE
finaadabab	TRUE
finpgdabab	TRUE
gdnbpgcdcd	TRUE
gdpeclbbaa	TRUE
goofogbbbb	TRUE
gopfmkcdcd	TRUE
hjibppbbaa	TRUE
hjicpgabcd	TRUE
idfhafcdcd	TRUE
idgcflabcd	TRUE
inamebcdcd	TRUE
inbdhmcdcd	TRUE
jgmkppaaaa	TRUE
jgndgaaaad	TRUE
kbbcodbbaa	TRUE
kbcbdpcdcd	TRUE
knedieabab	TRUE
knfkajcdcd	TRUE
lichhbcdcd	TRUE
licjhfcdcd	TRUE
mceanjabcd	TRUE
mcgaklbbaa	TRUE
mnpphdbbbb	TRUE
moacopaaaa	TRUE
nhimedaaaa	TRUE
nhjblfcdcd	TRUE
occogkcdcd	TRUE
ocdcecabcd	TRUE
onbgbaabcd	TRUE
ondidabbaa	TRUE
phabkgabcd	TRUE
phagnncdcd	TRUE
aaalgpgpgn	FALSE
aacacdmnpm	FALSE
ajcaefnpdk	FALSE
ajceodbcmg	FALSE
benpmmline	FALSE
beodondnjj	FALSE
caciemcfci	FALSE
cacmgpiohi	FALSE
ckpofbbfjb	FALSE
clakajciol	FALSE
degmkmcdjn	FALSE
dehadcefjl	FALSE
dmnimfmngm	FALSE
dmodghlpdh	FALSE
egbmnhkjad	FALSE
egcfjoghel	FALSE
faaepmefdh	FALSE
faahkndfad	FALSE
fjmohghcmb	FALSE
fjnhhinchi	FALSE
gdiacfpnoo	FALSE
gdidhdpccb	FALSE
gpdpbijikf	FALSE
gpfejnclmi	FALSE
hioeoicdfn	FALSE
hipmdnjaed	FALSE
icnhmkmpbd	FALSE
icnjlghble	FALSE
infkbpjkpb	FALSE
inhkofjmko	FALSE
jhgmbmpffo	FALSE
jhinenddod	FALSE
kbeekincko	FALSE
kbelifbfij	FALSE
knnbbfncgn	FALSE
knodmacoen	FALSE
likdlbcfep	FALSE
likllenjln	FALSE
mcnjpnaljo	FALSE
mcnphaaaok	FALSE
mnnhoinbpa	FALSE
mnodcnmdfn	FALSE
ngjcjipdoc	FALSE
ngjoedahlg	FALSE
ocbejgbeid	FALSE
ocbngbjeak	FALSE
onbjelhega	FALSE
onbjmheaci	FALSE
pgohnpodnc	FALSE
pgojojnfli	FALSE
aabapelaaaa	TRUE
aabgkgkcdcd	TRUE
ajpoolgcdcd	TRUE
ajpopjncdcd	TRUE
bfofjhgabab	TRUE
bfpfoebbbbn	TRUE
bpnjkhmbbbb	TRUE
bpnkjgkbbbb	TRUE
clajihpbbaa	TRUE
clalbdnaaaa	TRUE
dfacleibbaa	TRUE
dfamilfabab	TRUE
dpnhkibbbba	TRUE
eaalancabcd	TRUE
ejmmcancdcd	TRUE
ejpaehaabab	TRUE
fcopmkoaaaa	TRUE
fcpahkocdcd	TRUE
fnmfmoobbaa	TRUE
fnmlckfcdcd	TRUE
gibmmlgaaaa	TRUE
gicbbpmbbaa	TRUE
hdmocnlabab	TRUE
hdnjphecdcd	TRUE
hoeieijcdcd	TRUE
hogeoehabab	TRUE
ihncgdjcdcd	TRUE
ihndhmkbbbb	TRUE
jaohanpaaaa	TRUE
jaohddibbaa	TRUE
jklokpdcdcd	TRUE
jknbljabbaa	TRUE
kfnbfobbaaa	TRUE
kfnekifbbaa	TRUE
lagjiokcdcd	TRUE
lajohecbbaa	TRUE
ljiifllabab	TRUE
ljlgbklaaaa	TRUE
mcmjmmnbbaa	TRUE
mcndnieaaaa	TRUE
mnjalebcdcd	TRUE
mnkhlmgabcd	TRUE
nhicdoaaaan	TRUE
nhiealnabcd	TRUE
obkndjcabcd	TRUE
obljpdjcdcd	TRUE
okmccgaabcd	TRUE
okmedkabcda	TRUE
pfhlcpnabab	TRUE
pfjbbnoabcd	TRUE
aabaflmakgk	FALSE
aabgcidpaim	FALSE
ajnbpkokipi	FALSE
ajnlhcaeldn	FALSE
befpanaidci	FALSE
begbbnccepe	FALSE
bpkbokpoccm	FALSE
bpmklcakbme	FALSE
cklmmmadklg	FALSE
ckloggeckek	FALSE
dfcafiofnlj	FALSE
dfcmbmdimli	FALSE
dpofinoigke	FALSE
eaapmmcohfm	FALSE
ejgjmineigo	FALSE
ejhflehlgon	FALSE
fddfpbnglcc	FALSE
fdeaieahgpe	FALSE
fmoafilollh	FALSE
fmoegpmenfa	FALSE
gijchhegbal	FALSE
gikjhmppopp	FALSE
hdhpcfepndm	FALSE
hdigjbmnjel	FALSE
hojmecmjekn	FALSE
hokagfpccmh	FALSE
iidhccndcmb	FALSE
iidjgpldikf	FALSE
japonhlolof	FALSE
jbaecjaaihb	FALSE
jlkpjdlcggn	FALSE
jllacfcegpa	FALSE
kflhbcbhckl	FALSE
kfmncmehpcc	FALSE
lainonpchea	FALSE
lajfkkhhmjn	FALSE
ljimebaboji	FALSE
ljjihabdfgc	FALSE
mcjmhkfglcc	FALSE
mckiogdplno	FALSE
mmpmndkmhjc	FALSE
mnbacdlbmmo	FALSE
nhihgehhnnj	FALSE
nhkagkjlaco	FALSE
obimgdgkkbc	FALSE
obkddljgjaj	FALSE
olegppbpaip	FALSE
olekkcigdhh	FALSE
pfgblogjlfb	FALSE
pfgigoggmnc	FALSE
aacefnkhcdcd	TRUE
aacfbebebbaa	TRUE
akobklfnabcd	TRUE
akonlpleabab	TRUE
belnkekpbbbb	TRUE
bemfkbofabcd	TRUE
bomlkackaaaa	TRUE
bonbamjjcdcd	TRUE
cjfbeikeaaaa	TRUE
cjgcopmobbaa	TRUE
dclgnlppabcd	TRUE
dcmbiimacdcd	TRUE
dmjjoineabab	TRUE
dmlcigjlabcd	TRUE
ehbpmafcaaaa	TRUE
ehfioihnaaaa	TRUE
fbgiabgjbbaa	TRUE
fbhcoginabab	TRUE
fldjnhhfbbbb	TRUE
flfobodlbbbb	TRUE
geohepjmcdcd	TRUE
geoilbbhbbbb	TRUE
gpbchbfeabcd	TRUE
gpbfemccbbbb	TRUE
himlhkbjbbaa	TRUE
himnhoaccdcd	TRUE
idjmclclcdcd	TRUE
idkdfcdebbaa	TRUE
inckleifcdcd	TRUE
indchnbmabcd	TRUE
jhjcokbfaaaa	TRUE
jhjnflpicdcd	TRUE
kcimnghbbbaa	TRUE
kcipakefaaaa	TRUE
kmmnildfcdcd	TRUE
kmpplgcccdcd	TRUE
lhmclhcgcdcd	TRUE
lhobeigpcdcd	TRUE
mcfhjimaabcd	TRUE
mcfnnjjlcdcd	TRUE
mlpillhaaaak	TRUE
mlpockgibbbb	TRUE
ngkjgbdfaaaa	TRUE
nglmecjkcdcd	TRUE
oajkkmblabab	TRUE
oakbdnnabbaa	TRUE
oldelmoibbaa	TRUE
oldimeikaaaa	TRUE
pgbkpnglcdcd	TRUE
pgblfglebbbb	TRUE
aacefnkhobeb	FALSE
aacfebapbfgf	FALSE
akmjpdghiknk	FALSE
aknmpcbdojni	FALSE
beaneafigfma	FALSE
beaoicgmmekp	FALSE
bohcpbbjbfbl	FALSE
bohmmjpdbldn	FALSE
ciknbmkdgmaa	FALSE
ciladlhcgnbk	FALSE
dcogcieblfam	FALSE
ddaehnfojmel	FALSE
dngajlknhllf	FALSE
dngbdpdnjobm	FALSE
ehakdmfdghim	FALSE
ehbhoffhcmpm	FALSE
fbelhlilialg	FALSE
fbfeacmdeamd	FALSE
flemoickkoak	FALSE
flfkkggbmhhp	FALSE
ggamkabmecao	FALSE
gganlaakjlda	FALSE
gpdicfoaobfe	FALSE
gpfkpafnmgbd	FALSE
hjlfojehckcg	FALSE
hjlhonhfadpa	FALSE
idbdikbeokal	FALSE
idbfkaemockf	FALSE
imgglfgeefbi	FALSE
imhmjglggagi	FALSE
jihcnimndndl	FALSE
jiheemhfkfpj	FALSE
kcnmjjiddloo	FALSE
kcojopmohbla	FALSE
kmlcpekahjon	FALSE
kmmaejkogplg	FALSE
lhhmheahkdlj	FALSE
lhjdbifeknna	FALSE
mccgnneimgag	FALSE
mccneladofom	FALSE
mmfmfankjcci	FALSE
mmfpbpkcjjon	FALSE
ngaokbcfkchl	FALSE
ngbaiiodlfpj	FALSE
obbijgiibiia	FALSE
obchoogjgoba	FALSE
okpmahidgoep	FALSE
okpmiiabgnlp	FALSE
pflhmjaojjci	FALSE
pflijcnoicdc	FALSE
aacefnkhobbaa	TRUE
aacfbebapbbbb	TRUE
akpaaepnlcdcd	TRUE
akpadaghcbbbb	TRUE
behgafocdaaaa	TRUE
behjbgekgaaaa	TRUE
bohgbaamcaaaa	TRUE
bohgpeaolaaaa	TRUE
cimjgfhkicdcd	TRUE
cimlimnkncdcd	TRUE
dckfgcpogaaaa	TRUE
dckkcejmbbbaa	TRUE
dmkkejbfaaaaj	TRUE
dmklgnilmbbbb	TRUE
ehmmnkbfiaaaa	TRUE
ehndcccnkaaaa	TRUE
fbcdahjnjabab	TRUE
fbcdblijgbbbb	TRUE
fldocbkocbbaa	TRUE
flibfifpebbaa	TRUE
gfbpkedgecdcd	TRUE
gfcdbpigdcdcd	TRUE
gpifaaajhcdcd	TRUE
gpjieigjnaaaa	TRUE
hjebpoelmcdcd	TRUE
hjegeghclabcd	TRUE
idelfmnlmbbbb	TRUE
idelongfobbaa	TRUE
inhnihbclabcd	TRUE
iniehbmjmbbbb	TRUE
jhddncnadabab	TRUE
jhdjmbkjobbaa	TRUE
kcjfplbcnbbbb	TRUE
kcjhjoiikcdcd	TRUE
kmfgkaieoabab	TRUE
kmfllmfjbaaaa	TRUE
libpgaocmaaaa	TRUE
libpolaogcdcd	TRUE
mcbahaiflaaaa	TRUE
mcbbafllacdcd	TRUE
mlfhpddfccdcd	TRUE
mlgiipmcobbbb	TRUE
nggmbfcghbbbb	TRUE
nggmbfgdkbbbb	TRUE
oalpmdcpbabcd	TRUE
oanaofgkdabcd	TRUE
oliglkfkjbbaa	TRUE
oljmmidjccdcd	TRUE
pgefefnlhbbbb	TRUE
pgelgkmflbbaa	TRUE
aaabiommldhbi	FALSE
aaakobbilcobf	FALSE
alhpbcfcebopg	FALSE
aligapojjnggo	FALSE
bfbblhllnmgkk	FALSE
bfbdlfhofpnbd	FALSE
bopfflelfiamk	FALSE
bpbmbfoacdkhi	FALSE
ckacoengabkmi	FALSE
ckadnljnbgoji	FALSE
deidboelinocl	FALSE
deidlkdpcnkol	FALSE
domacgacgjegf	FALSE
domcgnecifmmk	FALSE
eioddihngbppe	FALSE
eioegnnebkdge	FALSE
fdanbkmdhfine	FALSE
fdanomlecnfib	FALSE
foliadkhikmln	FALSE
fonpaoflfmphj	FALSE
gihioebelihij	FALSE
giibllokjcefo	FALSE
hcanaemdfgbno	FALSE
hcbdijjebimpk	FALSE
hmddlajlngjfm	FALSE
hmehlgejldecc	FALSE
ifhhfalegnndf	FALSE
ifiecdpblooop	FALSE
jahinmhabdogn	FALSE
jaholnhhcjcmi	FALSE
jkihfldkffaeh	FALSE
jkimhimimlbfo	FALSE
kenjacbpnmdki	FALSE
keoaploilkfda	FALSE
laleaagbdplkj	FALSE
lamengifdijbh	FALSE
lkgeaigpefdhm	FALSE
lkgpmdljfpigl	FALSE
medhoobibjene	FALSE
meedheckhhbio	FALSE
mnijpmiaiiija	FALSE
mnkeenpemejne	FALSE
ngoalikabeoma	FALSE
ngoofpfcmmpoh	FALSE
obhoidkoecjff	FALSE
obidifecdacln	FALSE
oljepphgjonhb	FALSE
oljfklfclgiom	FALSE
pfdjbdjpbicpb	FALSE
pfedlpdepbhba	FALSE
aaaaiommldhbio	TRUE
aaajbbilcobbbb	TRUE
alhkammnibabcd	TRUE
alicmnhaedcdcd	TRUE
beekcikifgaaaa	TRUE
befmnlfciababo	TRUE
bpepaikijocdcd	TRUE
bpfdfffhhnbbaa	TRUE
cjmjnhoopgabab	TRUE
cjncilcbaebbbb	TRUE
demffecphncdcd	TRUE
dengggpgphabab	TRUE
domiilljeeaaaa	TRUE
dopbndkmkkbbbb	TRUE
eilkpcienibbbb	TRUE
eilldkcghccdcd	TRUE
fcniooakbgbbbb	TRUE
fcobdlahjjcdcd	TRUE
fpdfnaigiaabab	TRUE
fpdjilenelbbaa	TRUE
gioeolkfmhabab	TRUE
giojfflifjabab	TRUE
hbiogdjgkcbbbb	TRUE
hbkfajjpdbaaaa	TRUE
hllffcnbckcdcd	TRUE
hlomnhnmjjcdcd	TRUE
igaeejlhhlaaaa	TRUE
igbcnfadnocdcd	TRUE
jakkmnmfclabab	TRUE
jaldddjechcdcd	TRUE
jlfkanejccbbaa	TRUE
jlgemplofdcdcd	TRUE
kfhiecgpeocdcd	TRUE
kfhnmgebicdcde	TRUE
lafamipjiibbaa	TRUE
lafdbpmdimabcd	TRUE
lkhkkkolhibbaa	TRUE
lkicakjakpabcd	TRUE
mdnbdgogckcdcd	TRUE
mdnhjkeoodaaaa	TRUE
mnhdbnekbgbbbb	TRUE
mnhejinbllcdcd	TRUE
nhfmkfepacbbaa	TRUE
nhgfdklaemaaaa	TRUE
obkojmmmohbbaa	TRUE
oblmcklakobbbb	TRUE
olaioljjakabab	TRUE
olamaegfjfbbaa	TRUE
pgeifalcikabcd	TRUE
pgemknfpanbbaa	TRUE
aaaiepbdgnffmh	FALSE
aabccpkmikcbga	FALSE
ajbggcicdnhajb	FALSE
ajbnoceecpjool	FALSE
bciklnhhnbnpld	FALSE
bcjnhegnlbbnba	FALSE
bmjklpajeaajna	FALSE
bmkaeloanmldnc	FALSE
cgcbkihmcmhijg	FALSE
cgciackmodihgn	FALSE
dccpbhhdpnocea	FALSE
dcdecjmicfaoif	FALSE
donomlanpehkko	FALSE
doolplmjkcaoii	FALSE
ejlcjagjkkgkgb	FALSE
ejlmfemopgcoib	FALSE
fedeaeffclbnkj	FALSE
feecnpophgliio	FALSE
fooljlelfbogmk	FALSE
fopcgnfhjeffck	FALSE
gjchenckoigebl	FALSE
gjdnfeghmmaobc	FALSE
hcddkfcfggnanm	FALSE
hcdecpiiafkdla	FALSE
hmdacjdagfimka	FALSE
hmdgaagnmhngpg	FALSE
igiohjanknhjof	FALSE
igioijahjmahjl	FALSE
iphfcamjdnbbep	FALSE
ipjgfbnlhhcfbn	FALSE
jjlidibgehmimm	FALSE
jjlmkhbifcdlng	FALSE
kchnlhlgokhbnd	FALSE
kcihcecojennid	FALSE
kngfhbgdghpphn	FALSE
knjggekgkcjgjl	FALSE
lhoopjonpkjffk	FALSE
lhpbapgmfkjjca	FALSE
mcpakjpeblafmk	FALSE
mcpjglabhnaack	FALSE
mmhepbeblapplp	FALSE
mmhjebmecokdpa	FALSE
nhemcafboigdkh	FALSE
nhfdpaejbiofnf	FALSE
obagmmffhfipeh	FALSE
obakfhbdbhmajk	FALSE
olncnjhbmmkkbn	FALSE
olnhlklhiglemo	FALSE
pgiagkcgabjjnp	FALSE
pgicnjgbkoicmi	FALSE
aaahepbdgnfbbaa	TRUE
aabcgcpkmikcdcd	TRUE
ajdcdpeebkhcdcd	TRUE
ajdkplndiloabab	TRUE
bcmdpkceichbbbb	TRUE
bcmfhlndidfcdcd	TRUE
bmjebjpdpkdcdcd	TRUE
bmjoilfmpmgbbaa	TRUE
cgmocmkelddbbaa	TRUE
cgojbccaoccabab	TRUE
dcnpnilkaakcdcd	TRUE
ddakcbhmdahabcd	TRUE
dopdlkfeiphcdcd	TRUE
dopdmjdcfafaaaa	TRUE
ejhcemfhoelcdcd	TRUE
ejhlimgenecbbbb	TRUE
feadalcheipcdcd	TRUE
feaimcldcanbbaa	TRUE
fpainjjphcocdcd	TRUE
fpbfhadgenjaaaa	TRUE
giljgoalopacdcd	TRUE
gimbohecnbbabab	TRUE
hcjihcikefhcdcd	TRUE
hclaaaemdelaaaa	TRUE
hmkajcfdehbcdcd	TRUE
hmkiipceoamcdcd	TRUE
igkcgffaibbabcd	TRUE
igkodbcebgkbbaa	TRUE
ipihfnhiageabcd	TRUE
ipiocnjigofbbbb	TRUE
jjfelmnkkmlbbaa	TRUE
jjgdbnemaakbbaa	TRUE
kdcdknlclifbbaa	TRUE
kdchmmncckibbaa	TRUE
kngadmfakfgcdcd	TRUE
knhapmponmbbaae	TRUE
lhddjlncagababb	TRUE
lhdglblpmlpbbbb	TRUE
mcklbohofgcaaaa	TRUE
mcklilbpfjbcdcd	TRUE
mnajhhmkchdbbaa	TRUE
mnbffjlepkbcdcd	TRUE
ngddggeljfiaaaa	TRUE
ngdflkoalfababp	TRUE
obimblbjngpcdcd	TRUE
objdiaagceabcdl	TRUE
omhledbjpblbbbb	TRUE
omickidgciababj	TRUE
pgdomihbiimbbbb	TRUE
pgffkabjncbbaaa	TRUE
aacbiibomioiikm	FALSE
aacekjlfknfaheb	FALSE
ajjhilnimjjkfdk	FALSE
ajlbibbkgofojgn	FALSE
bfcfmadpohenfko	FALSE
bfdlbhbjdnbhoah	FALSE
bpnhfmgefgmjeff	FALSE
bpnmkpcnkekooog	FALSE
cjfhdegkdmgcjjo	FALSE
cjhopngoboadlmb	FALSE
ddlbgjljhbcahon	FALSE
ddmfpjcicpjekjm	FALSE
dnlgeknkhpenaha	FALSE
dnmpedclhagmfof	FALSE
eiojahiebljfpoe	FALSE
ejajcakakfnnbfh	FALSE
fdjlfhhfdbillam	FALSE
fdkjickbfnlnikm	FALSE
focdalcaledlddd	FALSE
focfmekankiikmc	FALSE
gimhdhblhoncnmb	FALSE
gimomenbipmpcej	FALSE
hcmabhobgjjiieg	FALSE
hcmeblmgjpdifoa	FALSE
hnbdcjgememckoa	FALSE
hnbmpifbabmdfgk	FALSE
ihcpoannahaelif	FALSE
ihdapmppcifnnah	FALSE
jbmkbandogfodni	FALSE
jbmpnddolffnicp	FALSE
jlimldaaecageie	FALSE
jljhhdjcepdemmm	FALSE
kgahaligenmhefj	FALSE
kgakednkkmkhhod	FALSE
lakhlhpegcfgbfe	FALSE
lalfimkafnnjbae	FALSE
ljmnbddnmcdconp	FALSE
ljofnpbbmmailpc	FALSE
meicifbmjedoolo	FALSE
mejihmmppjpclpk	FALSE
mocamdbfhhhokdg	FALSE
modagpbkocjnkjm	FALSE
nhmknmniahkcioi	FALSE
nhnomokalfbbgbi	FALSE
obohkkgkjlkchfi	FALSE
ocaondlblkanllc	FALSE
ollmebfmlkjldni	FALSE
olmncdjlbpnkbkk	FALSE
pgedingmodkobbd	FALSE
pgepbdjeilnjgce	FALSE
aabimfkcekkcaaaa	TRUE
aacffimjkjdfbbaa	TRUE
ajlejafipifpcdcd	TRUE
ajlkaelnpdiecdcd	TRUE
bdnegmmininiaaaa	TRUE
bdofofgegbkpbbbb	TRUE
bpcddikpahjabcdb	TRUE
bpcmhabbhljgbbbb	TRUE
cjenmmmlcmiaabab	TRUE
cjfcfimdmnjoabcd	TRUE
ddjcahdamfemcdcd	TRUE
ddljjjfgldhcabcd	TRUE
dnlknnplkkclbbbb	TRUE
dnnbhighilodbbbb	TRUE
eiiopfbfdhllbbbb	TRUE
eijodokeklclcdcd	TRUE
fbmppdmabcfebbbb	TRUE
fbniicoondhcabcd	TRUE
flhmhjojhgngcdcd	TRUE
flijpcmhpdifbbaa	TRUE
gejappdphihjabab	TRUE
gejjnbcllapcbbbb	TRUE
gojmmflfjfpbaaaa	TRUE
gokjcamkdkgmcdcd	TRUE
hificlkbfhgebbbb	TRUE
hifnjnkcpkfkaaaa	TRUE
icfffpglggolabcd	TRUE
icffgbknefhdcdcd	TRUE
immjjalojcgocdcd	TRUE
immjocfmajbocdcd	TRUE
jiiacplaflkkbbbb	TRUE
jiiaejhdepkeabab	TRUE
kcifhhpbhgjiaaaa	TRUE
kciflijeidfhabcd	TRUE
knfhlbpbgkabaaaa	TRUE
knheemamkcpaaaab	TRUE
lhbhpbnideomaaaa	TRUE
lhbihikadipjaaaa	TRUE
mbpahnecadocbbbb	TRUE
mbpclbdalanhbbaa	TRUE
mmaidbonpdeacdcd	TRUE
mmcdbcihldmibbbb	TRUE
ngadhkijbhflbbaa	TRUE
ngakhamflnkgabab	TRUE
oaenncfkgdooaaaa	TRUE
oafmfkejjhopcdcd	TRUE
oklnhnmgijndabcd	TRUE
okmbfdgpjemfbbaa	TRUE
pfojbkifpmedbbbb	TRUE
pfpaokjpjhjfaaaa	TRUE
aabimfkcekkcakff	FALSE
aacimjkjdfjahlnm	FALSE
ajjbpnmajkcncdfl	FALSE
ajjicldplakjoikl	FALSE
bdjnbfemkjkdaaaj	FALSE
bdkamncohflnlbfk	FALSE
bpgjojigkbkpcona	FALSE
bphicceeacooggji	FALSE
cjajppehnigofbjn	FALSE
cjbilbonhpmknjaf	FALSE
ddeilohadcfmnaid	FALSE
ddfbmlpekalefknj	FALSE
dofdlgjiofdkidbc	FALSE
dogbnmfmclgcpmmb	FALSE
eibbdogpgkkgbnca	FALSE
eibjncennfgboogo	FALSE
fbgonloohledghdj	FALSE
fbhcampjlmcfcakc	FALSE
flhmpafhmdnpapli	FALSE
flhnhgmblnmkjadd	FALSE
gekloepaecploekc	FALSE
gekmkpbgelhdhnmb	FALSE
golgildaganodmfe	FALSE
golmpoocbpgibjli	FALSE
hjacaiiijgjajiec	FALSE
hjainjbpefijaeoe	FALSE
icnhlhhhgkddblfb	FALSE
icnogjjnknaohmio	FALSE
imogflgdcolbnekh	FALSE
inankbblnmnimagh	FALSE
jhhebdkgcpnhmpmb	FALSE
jhiahdbpbnbmicop	FALSE
kdajekllhepmobph	FALSE
kdbahblfljeodajp	FALSE
knhgefcnehmeaajn	FALSE
knhjjbnkmkcobace	FALSE
ljbiejfjelkigeba	FALSE
ljbldacogkcpcbmi	FALSE
mbpebhccmilbdiif	FALSE
mbpigmflfdgdffpb	FALSE
mmjdhmfkfcifdmkp	FALSE
mmjifmjcacpbdkoe	FALSE
nfmkdaopimmoljap	FALSE
nfncmmniincncdlm	FALSE
oadahfenhnbfkmig	FALSE
oaeleggoaegkjpdo	FALSE
okcmiojpohddpeom	FALSE
okfgiaeojobhcpln	FALSE
pfoihnnpjkkioaog	FALSE
pfonlpeakbialjaj	FALSE
aaaaagieaghiehhid	TRUE
aaaakigehneodblcg	TRUE
ajdholjgnknjiaaaa	TRUE
ajfkogbngonmbcdcd	TRUE
bdheomogkjjpmaaaa	TRUE
bdicgncdkialccdcd	TRUE
bnjbjcdacfaccdcdj	TRUE
bnkihommjldhgabab	TRUE
ciieellfelpdccdcd	TRUE
cijdbedjkcllacdcd	TRUE
dcbakhnkpjcnnaaaa	TRUE
dcbhooalooefbcdcd	TRUE
dmkpmoniiemjfbbbb	TRUE
dmlenlilopcppcdcd	TRUE
ehchpkflcoifbbbbd	TRUE
ehcjbfnnjnfhhbbaa	TRUE
fboehobpnblibcdcd	TRUE
fboemokffodbkcdcd	TRUE
flaekljdeeiiccdcd	TRUE
flaidcoegfnpkcdcd	TRUE
gfgjklhgceihbbbbf	TRUE
gfibhbdhemhicbbaa	TRUE
gpfgcpokgnkiebbbb	TRUE
gpgiiehjgbheoaaaa	TRUE
hjljblcgnekleabcd	TRUE
hjmjbololcojiabab	TRUE
iehmefdcplcfdbbaa	TRUE
ieijbgfjgcmbfcdcd	TRUE
iokopooihlmmdaaaa	TRUE
ioloodelpdphfbbaa	TRUE
jjiipjnenlpeicdcd	TRUE
jjlolmkacnkmhabcd	TRUE
kdfakgdhdkmkocdcd	TRUE
kdgdeehnhfpofbbaa	TRUE
kmjidmklibnbbcdcd	TRUE
kmjiokcgihdbobbbb	TRUE
lgcjifgiblpfbcdcd	TRUE
lgdphielckadababd	TRUE
mamnainhfdfopcdcd	TRUE
manonebehhdblbbaa	TRUE
mlgajhiabpgahaaaa	TRUE
mlhgmnjgbdehmcdcd	TRUE
nfofhmnigicldcdcd	TRUE
nfohmfonopenhabcd	TRUE
oabnepepjfjffabcd	TRUE
oacnbbleoeldgcdcd	TRUE
okocebhcjbgafbbbb	TRUE
okpjpmeemapeacdcd	TRUE
pgaefenghghibabab	TRUE
pgcgfahknbcddbbaa	TRUE
aabgnldkicpmmlncn	FALSE
aabhpcbolfehmcdka	FALSE
alclhbpoiggihmcne	FALSE
alcppokndieanldjh	FALSE
bejdhekkndhimjbmg	FALSE
bejheanfhballlcog	FALSE
bnkkpcpbgmcmppnbj	FALSE
bnknokobbglibfgmg	FALSE
chmohdbllacemnecb	FALSE
chmppkifmehidiiim	FALSE
dbmklpmkahkceboep	FALSE
dbnhhhieekimdnglc	FALSE
dlidhepelmgjfbpdk	FALSE
dlijipebkflheooca	FALSE
efdnhkllpbbnegmaa	FALSE
effeekdibiffgklfi	FALSE
epfjlglkcfbaigcak	FALSE
epfpjnebmogcgijde	FALSE
fkjilkppmogpehdoc	FALSE
fkjkiklllifacbagd	FALSE
geohjaiknfidgdlco	FALSE
geplkkkpkkkjdmggg	FALSE
gphbpaiggbalcolem	FALSE
gphcbicoobijmbplk	FALSE
hjgffkifklkiackfn	FALSE
hjjdpfmdecnjmhibp	FALSE
idoaaoknleppeifdp	FALSE
idoglnpfgnajojkaa	FALSE
inlacahgkfeoogeio	FALSE
inlejdeolkcdlfhfn	FALSE
jhkhiohlkfldjcdam	FALSE
jhkndfnliaafclalo	FALSE
kceckofilgagpijpn	FALSE
kceenkkiglfhagdpd	FALSE
kmhpffoaghmhkfbnh	FALSE
kmigeblinegbmnlpp	FALSE
lfolhphfelmnijddf	FALSE
lfphghefnnmgpjinf	FALSE
mbanpcbhkioddbopl	FALSE
mbcbakaimojhilenk	FALSE
mkkfehcnahinkhlbc	FALSE
mklbnhfkjanpcibmj	FALSE
nghoilgniojnobgmo	FALSE
ngjbdcaehlpgljgad	FALSE
oaglbgdpniijlckho	FALSE
oahceilojegkdjhef	FALSE
okcpjipmncecfigbm	FALSE
okdpgmiegakdmfame	FALSE
pfjnhemildcjpejil	FALSE
pfkejmbllkkcipfbk	FALSE
aaajohaabijclmbbbb	TRUE
aabpeedaboeiiicdcd	TRUE
akckhcdpclohnocdcd	TRUE
akdjidofjbjfkkbbaa	TRUE
bdgoopopmnklfkbbbb	TRUE
bdhiglkpakbaolbbbb	TRUE
boiapikoccjpmbbbbb	TRUE
boipfgniikhegjabab	TRUE
cijggckddmiojjbbaa	TRUE
cikmlgnhalgohdcdcd	TRUE
dckdpklionkpkecdcd	TRUE
dcldihgjkpdibjaaaa	TRUE
dndoedeolbplkdcdcd	TRUE
dnglcmoeaiigoibbbb	TRUE
eigcjmdfhdmcmmcdcd	TRUE
eihgbdmfoacaicaaaa	TRUE
fcfhfogdlhlmgncdcd	TRUE
fcggdaemahljdcaaaa	TRUE
flalciaopnfdpdbbbb	TRUE
flaliiafdllljeaaaa	TRUE
gfdiaeplnkkgjfcdcd	TRUE
gfecfngkhpglifbbbb	TRUE
gplgnhcjoibpjkabcd	TRUE
gploclgbokeokmbbbb	TRUE
hjijpfjgkjikodcdcd	TRUE
hjkjekomalgffhabcd	TRUE
iehffbcfpodahjabcd	TRUE
iehnaimmoaeeoiabcd	TRUE
iobpimdonaohccbbaa	TRUE
iocblfbnghdkfbbbaa	TRUE
jicphobmnnkcpbaaaa	TRUE
jifekfookkpbeecdcd	TRUE
kcnoefmcbjkifjbbbb	TRUE
kcpfhflnpbpgeicdcd	TRUE
kmaogihlhgfpcgcdcd	TRUE
kmcbicccomcheocdcd	TRUE
lhdefplkedmbifbbbb	TRUE
lhdhkknlakfnnocdcd	TRUE
mbonhhinndejcncdcd	TRUE
mcadkhjbihghogbbbb	TRUE
mmafbpgdclhmnocdcd	TRUE
mmakoidppcllhjaaaa	TRUE
ngmlpbemmefhnmbbbb	TRUE
ngnbndhfojcliiaaaa	TRUE
oahhigmicgkiccbbaa	TRUE
oaioelclepbheacdcd	TRUE
okfjjmejgohnjkbbbb	TRUE
okiboiaaodohmgabcd	TRUE
pfgckllokopdeocdcd	TRUE
pfgkfhnjgkdgnncdcd	TRUE
aaakohaabijclmfdpp	FALSE
aabeedaboeiiiocjpl	FALSE
akccohoaindnnhlnji	FALSE
akchmpdphfbclidhjc	FALSE
bebdjpdmjlaclpdmag	FALSE
beclglafjjefnmcjdf	FALSE
boceaelmjfijcdolgh	FALSE
boceakpjccagomjmda	FALSE
ciokomkcaininogidb	FALSE
cipglgkgkniobegjfe	FALSE
dcfpjlnokfbjfemcbp	FALSE
dchneljdmjbgnpiiae	FALSE
dnfpecekdbonpmokae	FALSE
dngebiibeocjknaejm	FALSE
ehgmkjefighbnfcpol	FALSE
ehhbgnpjghhmhikelg	FALSE
fbmnkfolbmplppelkk	FALSE
fbnhlocmakolbnahio	FALSE
flidifnfbenfpbgolm	FALSE
flihmgmcnhndaejgbn	FALSE
gfdinnadnmelgblhem	FALSE
gfeggmgnpbcmjlgohj	FALSE
gpioioilbkhfkclnno	FALSE
gpjfbjobppnkfkiccl	FALSE
hjnpdcgneonjoddgol	FALSE
hjomdbpchkengjpahg	FALSE
ieilbmkgfbpmndceia	FALSE
iejbclpgogchakkacn	FALSE
inphbklblmcjkdmgan	FALSE
inpndfknaandnbflag	FALSE
jimngmbeijbppmgifp	FALSE
jinfmpgmmncommgcld	FALSE
kcjcioiojjndhenooo	FALSE
kcjkajlhpadpjocnka	FALSE
kmpnfkfjknhkojnlfk	FALSE
knacbehnchabbfedgk	FALSE
lglnancocgcleamacf	FALSE
lgmbodclgjnifafjje	FALSE
mbmbckejnhoglionpo	FALSE
mbmfmilgpeppnfplno	FALSE
mmjmkhagngoefoeggi	FALSE
mmkagmbmjlcmiemlbh	FALSE
nggfnablejjnpmfbgn	FALSE
nghgehmfdojjmmfnne	FALSE
oaelmdoflobnopphpf	FALSE
oaemadbpjjegneeeib	FALSE
okjofokomeajhmdpak	FALSE
okkhddpcgfdalpbpke	FALSE
pfdhimpeojnhmbeaoj	FALSE
pfgobdjfpomkcckkif	FALSE
aaaebeijcmonpioabcd	TRUE
aaafffemibgcjnpcdcd	TRUE
ajnhlojhboiamlibbbb	TRUE
ajpicnbfllihnnmbbaa	TRUE
begnkajnifeokhfbbaa	TRUE
behafnddpajdliecdcd	TRUE
bpblobpcnppignhcdcd	TRUE
bpdimiljpfnhbicaaaa	TRUE
ckkhpmggfcgopmaabcd	TRUE
ckkpjopoomklmiicdcd	TRUE
deiogefeeleogmfcdcd	TRUE
dejabgbfkilgmbkcdcd	TRUE
dnligmppfamflaebbaa	TRUE
dnmgccaebbnflncbbbb	TRUE
ehcohaonampllpgbbaa	TRUE
ehembffloklidlmaaaa	TRUE
faomjciofmfnhemabab	TRUE
faopelmfboooeombbbb	TRUE
fldbbamjmkpjhfeabcd	TRUE
fldfogdflkcemjicdcd	TRUE
gflaiinmoefbdalcdcd	TRUE
gflhmoicagkbeipcdcd	TRUE
gpgbngjifemgijfbbbb	TRUE
gpgffjjklddfjglabab	TRUE
hjkjahhbkmkkhlpcdcd	TRUE
hjmojffgkoalfgjcdcd	TRUE
ieldbonblhaojeoaaaa	TRUE
iemfiidlmophcbicdcd	TRUE
ipffpcejfcokocicdcd	TRUE
iphldkmhkfnjmclaaaa	TRUE
jjnjfidnafmoddnbbaa	TRUE
jjoghlmmcbjoiobcdcd	TRUE
kenbpcimbhjlgjlbbaa	TRUE
kenbpgnadkpdiaobbbb	TRUE
kplgmgbbjgfdnnpbbaa	TRUE
kpllojkefidknbiabab	TRUE
lkbblneffkocelmaaaa	TRUE
lkbgmfkdpdffiajcdcd	TRUE
mdnjehnhfmobnemaaaa	TRUE
mdpfgjaemobejejabcd	TRUE
mpglcgkgooekcpkcdcd	TRUE
mphnceakfmbkfonbbaa	TRUE
njiohdihkojhfogabcd	TRUE
njjfgjkbhgjengncdcd	TRUE
odgbocijahbfnlecdcd	TRUE
odhjmhlgndcndlgaaaa	TRUE
omfdhakedcecgcobbbb	TRUE
omfefhamlipbinpcdcd	TRUE
pggehebjgfficnbcdcd	TRUE
pgimningbgjmlehbbbb	TRUE
aaaldilfcjoijbpijok	FALSE
aaamijbadbohbmfalnk	FALSE
akmlikfgbjleoihgimp	FALSE
aknghopbocfefckdpbg	FALSE
bdpfgkljojnlibbegkc	FALSE
bdpockoinnmmmhdppga	FALSE
bnkljkibomjgpelgajo	FALSE
bnlnbeghfncbjopgkcj	FALSE
chpffmajieobnbbejdl	FALSE
chpgabehjaaninhlibk	FALSE
dcfnkjfcafiegpilodh	FALSE
dchabebmadenodkdjdb	FALSE
dnaepdfefdchobjiphe	FALSE
dnaoohleenmoikmbjnl	FALSE
egogokbngepfjdldikf	FALSE
egpijjlgpfkblaipenk	FALSE
fbogkdgjidgcifbfhai	FALSE
fboooapdejfjibdgmbm	FALSE
fmbopmjllencanbjiob	FALSE
fmcbaljdnhppfdiffag	FALSE
gepidkebgbdnpccaakm	FALSE
gfabjohjhgjbjhminij	FALSE
haaeijihecclknjclkm	FALSE
habpgjpdnhcijgadnni	FALSE
hjppmpbinhdbhlngiao	FALSE
hkbmjacpbmkofhlgnnh	FALSE
iekpccnmkjofplbombb	FALSE
iekpdknkcgcdohefbce	FALSE
ipgkcmohgehffbkkiam	FALSE
iphihohehihnaapaono	FALSE
jkjmbcckkfmhkldcjlf	FALSE
jkkkkkfcdgmmcodfbjj	FALSE
kfeepkggjmmajhobmjp	FALSE
kffblkpmjkadbgodkhc	FALSE
kpblfjllmmpmlbonhbn	FALSE
kpcemifpnbhebccbpmg	FALSE
ljkjecainokehgjkgea	FALSE
ljlpiaomokfgeihdcbd	FALSE
mdnjmcjejjfkploihgi	FALSE
mdoccjdoffnfioggodh	FALSE
mnhknbihhedccciakcm	FALSE
mnihkdaekfodnlcgeec	FALSE
nhndcafdjeligffflnp	FALSE
nhohjinidjniafbmpef	FALSE
ocmeaobpmiepomgdcfh	FALSE
ocpibicgfmgohgklbgj	FALSE
omajaoeogibddnepjjg	FALSE
ombnngacgknegnmjghl	FALSE
pfmomocnbdoccpegcih	FALSE
pfpfimkfpojgnccpnej	FALSE
