aaaiihpcgh	TRUE
aabddmecge	TRUE
ajkafcpoaa	TRUE
ajnepnbfaa	TRUE
bdojjokhaa	TRUE
bdomnmeeaa	TRUE
bogbljfgaa	TRUE
bogdjomfaa	TRUE
cifgioppaa	TRUE
cifibldbaa	TRUE
ddemiainaa	TRUE
ddfaeecjaa	TRUE
dnbcbjncaa	TRUE
dnbcnaeeaa	TRUE
ehjkihdoaa	TRUE
ehkpjifoaa	TRUE
fbpegcgjaa	TRUE
fcaapafgad	TRUE
fmlfphfgaa	TRUE
fmmpnkkiaa	TRUE
ghbmjohlaa	TRUE
ghbpnidlaa	TRUE
haejdgcoaa	TRUE
hafekjflaa	TRUE
hjjaceofaa	TRUE
hjkghkdpaa	TRUE
ifdjgclhaa	TRUE
ifdlbhfjaa	TRUE
ipaccappaa	TRUE
ipbibkpmaa	TRUE
jiaehjmhaa	TRUE
jibeaigpaa	TRUE
kcakkplpaa	TRUE
kcbaeigiaa	TRUE
klnbehmcaa	TRUE
klnebjecaa	TRUE
lfojpkchaa	TRUE
lfpfboenaa	TRUE
lpincpkkaa	TRUE
lpjginoeaa	TRUE
mjabjpniaa	TRUE
mjaeicjfaa	TRUE
nebdlbogaa	TRUE
nebhmhkpaa	TRUE
nolajadpaa	TRUE
nomifjikaa	TRUE
ojdggbibaa	TRUE
ojdmckmgaa	TRUE
pfdlimfaab	TRUE
pfeoebmhaa	TRUE
abcedlfanj	FALSE
abcflcnfog	FALSE
akeldjdejo	FALSE
akfbgpbkml	FALSE
bdmbhphmcl	FALSE
bdmehdfilk	FALSE
boifdpcpkl	FALSE
boioiiefdl	FALSE
cidoogdckj	FALSE
cieiajnafe	FALSE
dckgmgakin	FALSE
dckingdjfh	FALSE
dndeaopekn	FALSE
dndejijcmn	FALSE
ehneailimp	FALSE
ehnghpoagh	FALSE
fcaggjagmb	FALSE
fcbfbebaik	FALSE
fmkgmeomah	FALSE
fmkkfbndma	FALSE
ggmphjeicd	FALSE
ggnmbhehfk	FALSE
hahcbpimno	FALSE
hahfpakdnb	FALSE
hjdkajgnmf	FALSE
hjdnjnmcgl	FALSE
iedalfgadc	FALSE
iednpffili	FALSE
ipdblfkaln	FALSE
ipdfcpnndh	FALSE
jinafoejci	FALSE
jinlmmgbcl	FALSE
kbnibjjmgh	FALSE
kbnkjdlple	FALSE
kmbngigapp	FALSE
kmfafmngnc	FALSE
lfnodijmib	FALSE
lfojdlgfhn	FALSE
lpfimdlmem	FALSE
lphlpeepad	FALSE
mjfjhblhlb	FALSE
mjfkdjfejg	FALSE
nefcflhipb	FALSE
nefeknmogm	FALSE
nomjlahpfj	FALSE
nomlmllkhi	FALSE
okggohibjg	FALSE
okgldpblaf	FALSE
pfafokjikk	FALSE
pfamhgncjp	FALSE
aaaiihpcghd	TRUE
aabdmecgeed	TRUE
ajklfgeoeaa	TRUE
ajlmdjldiaa	TRUE
bdhnikpepaa	TRUE
bdkcgcjgpaa	TRUE
bobehlifmaa	TRUE
bodcflapnaa	TRUE
cipnjkeneaa	TRUE
cjadpmmncaa	TRUE
ddcolfgipaa	TRUE
dddelpeeaaj	TRUE
dmnmobgccaa	TRUE
dmpegjpbiaa	TRUE
ehjglmoigaa	TRUE
ehjmhgpdbaa	TRUE
fbgmjkcfiaa	TRUE
fbhpddoopaa	TRUE
fmjinhkgfaa	TRUE
fmkdjbonlaa	TRUE
ggpcpgiipaa	TRUE
ghamckolcaa	TRUE
hajijhhofaa	TRUE
hakhklljpaa	TRUE
hkkcchejpaa	TRUE
hkkphlhkhaa	TRUE
iepfggndbaa	TRUE
ifaagoclffc	TRUE
ipdcfigmfaa	TRUE
ipdggbodnaa	TRUE
jihgpokaalk	TRUE
jihjhbeheaa	TRUE
kblplianeaa	TRUE
kbnjmpknjaa	TRUE
kmalhpmomaa	TRUE
kmamdbhglaa	TRUE
lfnibbopiaa	TRUE
lfnpdhoomaa	TRUE
lpkmdgbinaa	TRUE
lpljdgbhoaa	TRUE
mjbngkbhoaa	TRUE
mjclippdkaa	TRUE
ndmokhecoaa	TRUE
ndobfcfeoaa	TRUE
noiilnoeeaa	TRUE
noilciadfaa	TRUE
okcljloggaa	TRUE
okemjmnepaa	TRUE
pehaikjbkaa	TRUE
peicbjiakaa	TRUE
abaeodaenlc	FALSE
abbacjfldon	FALSE
ajnenhkgjnd	FALSE
ajnganbpdae	FALSE
befhjaeffbb	FALSE
befjbhkfdhk	FALSE
bognlgkpajk	FALSE
bogpilljamp	FALSE
cjfddepfbnj	FALSE
cjfgcoegghe	FALSE
ddjdokdmbfk	FALSE
ddjepokeodb	FALSE
domcjfjhlnj	FALSE
domhkogobff	FALSE
eioncdohlbj	FALSE
ejagcgfonid	FALSE
fcadkhoccjg	FALSE
fcaogpckdch	FALSE
fnfphjhhmdi	FALSE
fngmkbnbgmb	FALSE
gimdmijfgff	FALSE
gimeiglchpo	FALSE
hchjgfjagkf	FALSE
hchpffopmne	FALSE
hmjnhebldif	FALSE
hmkhahmaicl	FALSE
ifnnlpjcdoe	FALSE
ifoccgfchof	FALSE
jbfbgfogifc	FALSE
jbhigadjjib	FALSE
jmbldhejfpo	FALSE
jmdmijjjjod	FALSE
kfgokididim	FALSE
kfilljcamnm	FALSE
lanmlbhmnge	FALSE
laodjlmldee	FALSE
llhogoiiknh	FALSE
llificbcjog	FALSE
memkmmdcidb	FALSE
meobkkohhie	FALSE
mpeandnhgee	FALSE
mpehllgkbnm	FALSE
njceflddcal	FALSE
njcglfhjppa	FALSE
odgaikddghi	FALSE
odhoecfokbf	FALSE
ompjkfbcdfp	FALSE
onaedkogdhb	FALSE
pfplpdefedb	FALSE
pgcmpedgbin	FALSE
aabaefbocepi	TRUE
aabblebdodad	TRUE
ajgbndbdmhaa	TRUE
ajggndapiiaa	TRUE
becaagiplpfo	TRUE
becamghnfiaa	TRUE
boopehehkgaa	TRUE
bophlcheigaa	TRUE
cjbinpcmioaa	TRUE
cjclipepilaa	TRUE
deconmdcaeaa	TRUE
dedmdaihbhaa	TRUE
dohcclgpnoaa	TRUE
dohhlndaedaa	TRUE
eilaobdfbdaa	TRUE
eimgmednniaa	TRUE
fblljnbpfdaa	TRUE
fblmgjeicdaa	TRUE
fnfigabdpcaa	TRUE
fnidjpljjmaa	TRUE
gickpbonkoaa	TRUE
giclfbfppoaa	TRUE
hcfnpgikdkaa	TRUE
hchibicdhpaa	TRUE
hlnkjlbinbaa	TRUE
hlnpedaaldmj	TRUE
igeambjonmaa	TRUE
igejkmcmhfaa	TRUE
janhfeoafeaa	TRUE
japekmpcaaec	TRUE
jmbahflolkaa	TRUE
jmbeankcikaa	TRUE
khciejipdmaa	TRUE
khclmdeonaad	TRUE
lamkkkclmcaa	TRUE
laoajbchbdaa	TRUE
lkbeejmiioaa	TRUE
lkbidllflbaa	TRUE
mfinmofplkaa	TRUE
mfjafdhegoaa	TRUE
mpdkbmmhkgaa	TRUE
mpdojldaoiaa	TRUE
njjjpjaacfid	TRUE
njjmbiffgbaa	TRUE
odeeakmlpgaa	TRUE
odefoinfmhaa	TRUE
omijbjkohfaa	TRUE
omilbccmjgaa	TRUE
pghhhjmfjpaa	TRUE
pgicieiihbaa	TRUE
abahodobaedb	FALSE
abajddemnijj	FALSE
ajdpihikongi	FALSE
ajepeibpjcle	FALSE
bdklljacbjef	FALSE
bdlajcfakkdi	FALSE
bnanhoaphajg	FALSE
bncfiacokbnh	FALSE
cicpbldcifep	FALSE
cifjcoldkodb	FALSE
dbhkgjllnlji	FALSE
dbibleleglje	FALSE
dmkapcnfcoib	FALSE
dmkmjhjdmdjj	FALSE
eglimngpgcjc	FALSE
egmdedpnafge	FALSE
epnhnnolmjfb	FALSE
epocdocahhmc	FALSE
fldbbmklbedi	FALSE
fldjghkjcjmg	FALSE
gficegkadpln	FALSE
gfjcajhdbdpe	FALSE
gpgeklhpocce	FALSE
gpgocoaonbkd	FALSE
hijffkgkjbil	FALSE
hilghipidpdo	FALSE
ienfjllgkpof	FALSE
ieodmcklbagk	FALSE
jacgpmgfabfm	FALSE
jackfgejpnpp	FALSE
jjcmjpkaejep	FALSE
jjcoibhoknmj	FALSE
keffcakjkfjp	FALSE
kefhfcakhlpo	FALSE
kofmobfjmeae	FALSE
kojebjjohcdd	FALSE
ljbgmgcfomcl	FALSE
ljcefmpgheeb	FALSE
mcijjeanpifa	FALSE
mcjbkceojpnf	FALSE
mmbmadoeegdl	FALSE
mmekjpofcagk	FALSE
nffjihhgaofp	FALSE
nffpckgjcopl	FALSE
obbihcknojgl	FALSE
obcdnilfgopm	FALSE
okpmpffmgjpj	FALSE
olagfpljdijk	FALSE
pfhnkgggoimk	FALSE
pfigmbphdhfi	FALSE
aaaeeabopfhgl	TRUE
aaaohpfdgiodo	TRUE
aildkonblgaag	TRUE
aimdpadlccaac	TRUE
bcneobnklehaa	TRUE
bcnepggllciaa	TRUE
bnbmkmjnjooaa	TRUE
bnbpjebmhpjaa	TRUE
chooefpajpfaa	TRUE
chppadpfimdaa	TRUE
dbkafjifbahaa	TRUE
dbkclcpooljaa	TRUE
dmckjpkckneaa	TRUE
dmcmnmjakbkaa	TRUE
eghbedlobaaki	TRUE
egjbhlopgpnaa	TRUE
epnlepneadmaa	TRUE
epnpgeemminaa	TRUE
fllagbdgjpdaa	TRUE
fllbojecjdgaa	TRUE
gfannmjgkkhaa	TRUE
gfbphhhcmlaao	TRUE
gpamcikoddlaa	TRUE
gpcnkimamldaa	TRUE
hjlknfgebcaao	TRUE
hjmngfpighfaa	TRUE
iegibpfjahdaa	TRUE
iehbalodekoaa	TRUE
jaaiebhigingj	TRUE
jabclpolmagaa	TRUE
jkdohhnedfhaa	TRUE
jkenlecchlnaa	TRUE
kfdfmahbkbgaa	TRUE
kfdjcoamedmaa	TRUE
kolkdmpglieaa	TRUE
koncjdlchncaa	TRUE
limpoippjabaa	TRUE
linpcpebnlkaa	TRUE
mcpbjegjkbeaa	TRUE
mdahgppjgfpaa	TRUE
mmmdikggaddaa	TRUE
mmmfefhebffaa	TRUE
ngeckimnghnaa	TRUE
ngejfiflkfhaa	TRUE
oalildegfkfaa	TRUE
oamfblomoecaa	TRUE
okpafmljbgdaa	TRUE
okpanlbbhcgaa	TRUE
pffddhpfkklaa	TRUE
pfgaolbjgkcaa	TRUE
abaefopdmdion	FALSE
abafehljipejd	FALSE
ajmfeddlajdhj	FALSE
ajmjcnnogonif	FALSE
beppgoclepdae	FALSE
beppmdbccanfa	FALSE
camolhflnnkbm	FALSE
cbbhfaomlaefa	FALSE
clfjndlimoapm	FALSE
clfloeomjbjkn	FALSE
dfcdgdcbjfbhj	FALSE
dfdgaihcnbmgf	FALSE
dpbibhihmbejj	FALSE
dpcchkadlnkin	FALSE
ekdkgkakhgghg	FALSE
ekhicaofdphmj	FALSE
fekghgfegapbl	FALSE
fekkjkfcpacho	FALSE
fnpkoafmjlgel	FALSE
fochigkecbknk	FALSE
ghfimgibggkpd	FALSE
ghfllejdogkbh	FALSE
hbkhjboalgfdp	FALSE
hbkhlmdohgogn	FALSE
hmaldkfhkgpdc	FALSE
hmalljfdjeoid	FALSE
ifkpeapbaecij	FALSE
ifladdjnocjek	FALSE
ipkdkfhkkchkh	FALSE
ipkhdacgghmle	FALSE
jigeeokmghglb	FALSE
jijabmagknphp	FALSE
kdklfnnbflagn	FALSE
kdkpnhoamlomj	FALSE
kpecaillanjae	FALSE
kpemafmoldoci	FALSE
liiphmcicggpj	FALSE
liipoblphgalg	FALSE
mcaegimfhpice	FALSE
mcbbagaopkfja	FALSE
mmogdpfjmdbab	FALSE
mmohiknnbeebk	FALSE
niagkgjhkaijh	FALSE
nialmahdlbgfb	FALSE
obkbcihebcajn	FALSE
obkfdadeoiaip	FALSE
olhgngaelcmjc	FALSE
olholbjihfgod	FALSE
pfjdbgldbcgnm	FALSE
pfjofniemoihk	FALSE
aadmlnoaaeipdb	TRUE
aaeaigbambiekd	TRUE
ajnfnfjfdooeaa	TRUE
ajockoodicgdaa	TRUE
bfaojfkkagkbaa	TRUE
bfddnfdhbeamaa	TRUE
cahiekeibaalge	TRUE
cakdeddpgpicaa	TRUE
cldkaapiepdbmm	TRUE
clekekhgolpmaa	TRUE
dfeffjhiabcjaa	TRUE
dfepaehaafnncm	TRUE
donfmnblhaekaa	TRUE
dongjjpghgfiaa	TRUE
ejognahifiggaa	TRUE
ekcdldjkfeleaa	TRUE
fejllmkhpmlpaa	TRUE
felaamhecdjboh	TRUE
fodfaghbgonoaa	TRUE
foedmegpnhdaan	TRUE
gifjlaaibmcpeo	TRUE
gigbdcemfhjjaa	TRUE
hbhabgmcpghaao	TRUE
hbhldgjknokaak	TRUE
hlhifdpmdohgaa	TRUE
hliognpfpgikaa	TRUE
igghghlbfkpoaa	TRUE
ighbgdmboklmaa	TRUE
ipmaoccmhlmaaa	TRUE
ipmdofphmcgbaa	TRUE
jjgmngogohoaak	TRUE
jjhcnljfdoiiaa	TRUE
kedgobkbbhmiaa	TRUE
keenkgdeaicoaa	TRUE
kpeghfjhfllpaa	TRUE
kpgaplpckphgaa	TRUE
lhmhlamfgbllaa	TRUE
lhmnnkgjbidpaa	TRUE
mbgimoicmhndaa	TRUE
mbgjggfmpjokaa	TRUE
mmgocfdedlihaa	TRUE
mmhjphejejhpaa	TRUE
ngijgnflkfheaa	TRUE
ngimgeemobeoaa	TRUE
obkdpklihdgbaa	TRUE
obkfkmmndcpgaa	TRUE
oknifdmdbecdaa	TRUE
okoalanaefegaa	TRUE
pfijfkclgickaa	TRUE
pfjlihmhhlfbaa	TRUE
ababofljgopdce	FALSE
abbbpdmcoakohh	FALSE
akjjkmjoabimbj	FALSE
akkipgembmdmld	FALSE
behgddcajfffcb	FALSE
beikcacjfbachj	FALSE
bogknfhkljmmbc	FALSE
bohbjdocjfbgmj	FALSE
cifafhlofiblgl	FALSE
cifekcokjecebl	FALSE
dcpgjafidlphcb	FALSE
dcpglpaoflnclm	FALSE
dmifehbjeabcff	FALSE
dminpipoihbkog	FALSE
egjakgffobmopd	FALSE
egkienfliomebj	FALSE
faofdgnclfnlen	FALSE
faojkfooljmaee	FALSE
flhkknnhpgaicg	FALSE
fljpmfecladohb	FALSE
gfjmlfniomella	FALSE
gflgiclmkigknh	FALSE
goicjncaehjeho	FALSE
gojcjfmjidpokl	FALSE
hifkbkanmdafbk	FALSE
higkekiapglppf	FALSE
idmiinoblgnmaf	FALSE
idmnpjpomdbidd	FALSE
ipgaboelgjgakb	FALSE
ipgcjglahpddja	FALSE
jkdmccmgbidnko	FALSE
jkfmecoalfgfnn	FALSE
kfjdjlgpfigndf	FALSE
kfkeljijcomnca	FALSE
kopmhoaifhlalm	FALSE
kpakaibekahjfb	FALSE
ljoocmgbolhahc	FALSE
ljpdmjeoghogpe	FALSE
mdfkibffohcjma	FALSE
mdfnjghkkjfipi	FALSE
mnholbneieapph	FALSE
mnigboodeanele	FALSE
nibpcefkfnnbpa	FALSE
nicoejebcpeblk	FALSE
obljocbeadinkh	FALSE
obmhcfjfbagndm	FALSE
omookfjhflmfdl	FALSE
ompjoajeejacph	FALSE
pghcddameljlfg	FALSE
pgialjbdkjgejm	FALSE
aaaclfmkhlgmehe	TRUE
aaajmbblbmcaeee	TRUE
akikolfagjianaa	TRUE
akkacdalleonhaa	TRUE
bedkejgbcidbaaa	TRUE
beeiaedjpfhjjaa	TRUE
bodoojingmebnaa	TRUE
boeekpbnombhfaa	TRUE
cinblkehhfidmaa	TRUE
cipfijkmagcgbaa	TRUE
dcfpompkdefklaa	TRUE
dcgcnjedhjemiaa	TRUE
dlmhmpbccebemaa	TRUE
dlmolkkfibecmaa	TRUE
egnldigfbhmmgaa	TRUE
egophcmojjnboaa	TRUE
fannbnioheoceaa	TRUE
faoalljhifbdeaa	TRUE
flaaafombjffbjh	TRUE
flaeckelpeclmaa	TRUE
geojmhflcdpllaa	TRUE
geokocendfojoaa	TRUE
gpdjeobileaffaa	TRUE
gpdphicfghobbaa	TRUE
hjebadgobdkmaan	TRUE
hjeefemobjigfaa	TRUE
idldldgodcddmaa	TRUE
idpapngbkmoamaa	TRUE
ipfjmmhhnfolmaa	TRUE
ipgeciklhpfffaa	TRUE
jlbmkdhmeklcnaa	TRUE
jlckikdakefcgaa	TRUE
kfloeneoddjkiaa	TRUE
kfmoiikaholafaa	TRUE
konfkpoijapmoaa	TRUE
konngipcmfofhaa	TRUE
ljjompjedjhjoaa	TRUE
ljlgpkfcifchbaa	TRUE
mdpbffpcmejjoaa	TRUE
meaaecpffeolefn	TRUE
mnjjphcbgffgpaa	TRUE
mnlggnfbollieaa	TRUE
nigmedpeoohpgaa	TRUE
nihcbjchgihhaaf	TRUE
obpfjcimlmmegaa	TRUE
obpfpnkjkmnhmaa	TRUE
omlgdapeabdnbaa	TRUE
omlliloahbjfiaa	TRUE
phbgnoejfibobaa	TRUE
phbmehcnlbacoaa	TRUE
abajhkbnobkeill	FALSE
abalknjoefjpenb	FALSE
akaejamfldgfgpe	FALSE
akafemilfjpjfhe	FALSE
bcnlnacdpllldgc	FALSE
bcohobhcoganpob	FALSE
bnlpdhcbjgffpch	FALSE
bnnamdbhoncmegh	FALSE
cjbcoampldmfheo	FALSE
cjbhhdddgjnpipa	FALSE
ddejmkbjmkkejef	FALSE
ddfbjhdcclafjhc	FALSE
dnnmklocjikngda	FALSE
dnnoefjhlaiimdf	FALSE
eicjomcaklcccgl	FALSE
eidaepncbfnpihh	FALSE
falcbpjbbofdcgh	FALSE
famampdcdffcaob	FALSE
fjhjgmbplijmgig	FALSE
fjhoanpihinlhph	FALSE
gdcdiaiailafmmm	FALSE
gdcfccoegmilkoe	FALSE
gpkbmfbjcnennmf	FALSE
gpklldkmccjpmkl	FALSE
hjcjkaffiniajoa	FALSE
hjdgllhiambnhfa	FALSE
idcjmbjhiekpgbi	FALSE
idddflpckjkomfi	FALSE
infmpalakabmcjl	FALSE
ingfflbgjmlhmjo	FALSE
jhonjgkdikpfnmo	FALSE
jibcpfdcbhmdnme	FALSE
kclaclhggacimbo	FALSE
kcljihneiflgaki	FALSE
knlebajfconhinf	FALSE
knlpndkpcklmmik	FALSE
lhplbpjfojmfnnk	FALSE
libjmehhllhhkbf	FALSE
mdbefpacijogkhj	FALSE
mdbmldohfmecoee	FALSE
mndhpgphjjoacnd	FALSE
mndllkgnifajfdo	FALSE
ngkegonpfbblnao	FALSE
ngklhfpaoffcdec	FALSE
oapjfhggbbimmfh	FALSE
oapmcfnnappfhnn	FALSE
olalbhcigmcffbb	FALSE
olckbblaollbfik	FALSE
pgfinmeddbpgonp	FALSE
pgfkenlacfmlkna	FALSE
aaapggiajcodlapk	TRUE
aablfchgfjmagdfb	TRUE
ajfbboeedeidaiaa	TRUE
ajgbocdgejnigbaa	TRUE
bdhmkgefjmhlpbaa	TRUE
bdibohhlageialaa	TRUE
bnkcbhmcpgghejaa	TRUE
bnkkinakgegcnmaa	TRUE
cifidjkjbjmggaad	TRUE
cifpphddiioofmaa	TRUE
ddbdkcmabnegnnaa	TRUE
ddcgglkfcdhhogaa	TRUE
dnobaadongaaidcp	TRUE
dnobnecmlnohmiaa	TRUE
eicmoiekipabpjaa	TRUE
eiekameiddldebaa	TRUE
falbgbljekgcfaab	TRUE
fandecnklebpmbaa	TRUE
fjobefphgjjjecaa	TRUE
fjoednpjkfkhakaa	TRUE
geemabifadahhpaa	TRUE
geicjjfbnanfldaa	TRUE
gpgnmaihpclclaak	TRUE
gphjiefpkpflcaan	TRUE
hjmhikjkobmaebaa	TRUE
hjnjpplecjpfgbaa	TRUE
icmibdnealmafpaa	TRUE
icmkipbfflmffgaa	TRUE
inappapglmamejaa	TRUE
inbaaniehpgdnbjn	TRUE
jhenlpcobgapdgaa	TRUE
jheobgnkpplhdiaa	TRUE
kckanlgdoenlgmaa	TRUE
kckdeabmnmfdgkaa	TRUE
kndpdngfejlilfaa	TRUE
knfmanjebcmoplaa	TRUE
lhodiepcpiaifbaa	TRUE
lhopfcoddeekhiaa	TRUE
mcagnilkimajcfaa	TRUE
mcakgfnhkfogchaa	TRUE
mmpbonkcmllbaeaa	TRUE
mnaefeoikaohlhaa	TRUE
nhfkddbofdkklmaa	TRUE
nhgbnomfjgpeghaa	TRUE
obgjccdcgmhjocaa	TRUE
obgjihgjfppgdeaa	TRUE
oknhbjhheakiieaa	TRUE
okoomgnegbalnbaa	TRUE
pfkkfkmgaioenaaa	TRUE
pfkkjnacfgmmdaad	TRUE
abakcbmghbdbfcll	FALSE
abcjbmeifaepnjgm	FALSE
ajjpglodchdhllbi	FALSE
ajkkhlahplhbjomo	FALSE
bcjcccaogcfgeadf	FALSE
bclapnlaghkebbfp	FALSE
boafnndejanjafkj	FALSE
boampokkblfchlla	FALSE
cjdhheacdlpmbdmo	FALSE
cjepfkdooohkfnhc	FALSE
defhhaeeilgejbif	FALSE
dehdocihaoonfbfk	FALSE
dnnkjlomcjlnjokm	FALSE
dnnoojnmofmgehho	FALSE
ejlkhioodgdobnlg	FALSE
ejmfffeegnbagndp	FALSE
febcpokijncmakni	FALSE
febiaiijfjfinknf	FALSE
fpdddcmlaiinlmch	FALSE
fpdfjnbmdnndllmm	FALSE
giojomlgimmmaoil	FALSE
gipcbiinodiamimj	FALSE
hdchgjdifmjloijl	FALSE
hddocblbbkabblph	FALSE
hnnmmoagiiafpaci	FALSE
hnofbadehkgapgca	FALSE
ihljidimoepiiibk	FALSE
ihlojpblpkjemdik	FALSE
jbnholkkhgjkjlbl	FALSE
jbplfciboghhkiha	FALSE
jljjeoghbealecdf	FALSE
jlmdddmlcfmeghfc	FALSE
kgfficldbndmlgbe	FALSE
kgffkllnfdhckaon	FALSE
kplodlhiakkbmgom	FALSE
kpmidenoimmjfaoi	FALSE
ljmdlhkankmicece	FALSE
ljmfjdhdbjaojkog	FALSE
mefaoeogjfpnijnd	FALSE
mefmmbhapclngkoh	FALSE
moipdhgkpnjijaeo	FALSE
mokeijifllbheccd	FALSE
nimlnjfcplpnpbml	FALSE
ninpknopoionhnpj	FALSE
odjefenfphjgmbof	FALSE
odledgcgnepfcepc	FALSE
onjndjaigpkmefgc	FALSE
onjnlmckojhfehca	FALSE
pgjcbohgjgggniec	FALSE
pgjidheakgbcnkfp	FALSE
aaabhipafkknjohhj	TRUE
aaaflpkajgimgaejc	TRUE
akiecmlmhfgmnccaa	TRUE
akjoaohflokngedaa	TRUE
befpddjkfamigdlaa	TRUE
begccbbklgcicfaap	TRUE
bpabijpcbklnlhdaa	TRUE
bpadkalohafikmdaa	TRUE
cilbfcpofdjifhoaa	TRUE
cilplogogbfcbkmaa	TRUE
dckafpkpnjhcifnaa	TRUE
dclldbehlpafgafaa	TRUE
dnkgagcbjjkdnifaa	TRUE
dnlanlidhkgkfgdaa	TRUE
ehihlnblafhjdamaa	TRUE
ehjiidjddmajnefaa	TRUE
fcgbpmcchhadmooaa	TRUE
fcggehhkeohnojcaa	TRUE
flhfjmenjboflccaa	TRUE
fligmbkkdffaelmaa	TRUE
gfbolfofhepmcdfaa	TRUE
gfcdpnddbcdlmpgaa	TRUE
gpogbafkedbjameaa	TRUE
gpokkhfpapiihepaa	TRUE
hkklbhlheebacglaa	TRUE
hkkpfiapbmphjhpaa	TRUE
iepbjblpadoaibcaa	TRUE
iephjeamgbcddbpaa	TRUE
ipdapcpdlkkkekaah	TRUE
ipdfblcbemgekakaa	TRUE
jibnenlppflijpdaa	TRUE
jiceephdlengkonaa	TRUE
kbgepigibmedefoaa	TRUE
kbinhiodgcdkplnaa	TRUE
kngcbjcmfdggakeaa	TRUE
kngocfnahaebnokaa	TRUE
licgnogfmiepgofaa	TRUE
lieeldipmfbbiggaa	TRUE
mdaokmikfjimoneaa	TRUE
mdbmmiboekabpkkaa	TRUE
mngacnefogoobkaag	TRUE
mngfjamibipnfniaa	TRUE
ngpdcipbilkjpgpaa	TRUE
ngpgochncfopkfmaa	TRUE
oblincdldhhbejpaa	TRUE
obmocelhodmbhjnaa	TRUE
olnfnfgojafphdcaa	TRUE
olnmllidlolokjlaa	TRUE
pgbgfnkbgaibddhaa	TRUE
pgckmnbigoeiecnaa	TRUE
ababjcogpfhjihopd	FALSE
abafcpklniadkgloa	FALSE
akjdiccibkokmfmah	FALSE
akmgndkfmodnedkeo	FALSE
begelkpplpcoiigin	FALSE
behnnimgajbhamccj	FALSE
bomlgaeopfknkpmjo	FALSE
booacmelaldjemkdg	FALSE
cilaflgphiijiemak	FALSE
cilpnhggpkacehegl	FALSE
dcmliohemfhbppeme	FALSE
dcmmeikknmdedejfb	FALSE
dnnbkmmdjfianeamm	FALSE
dnofdpojfkdnbohbd	FALSE
eibbehjkollikhffb	FALSE
eihfkanenppgpkojl	FALSE
fboknnbpoapebplag	FALSE
fbolieakimcfpieom	FALSE
flobiflbfgonmkkla	FALSE
flojefcfammkfflki	FALSE
ggdnbkjopclceabjh	FALSE
ggecbjlfgacmmompd	FALSE
gpmikblbmcpfcdcpm	FALSE
gpncboojfocbhbhpc	FALSE
hjplkebdkmfcgeldb	FALSE
hjpondegpapeldfbi	FALSE
ifenanfengophadij	FALSE
ifephclfmcoacaibp	FALSE
ipemdfielinphnclg	FALSE
ipfgocdodadfdomcb	FALSE
jidoddoencgdmmngd	FALSE
jiedblngfaoeblinh	FALSE
kbhpenckmamepkcea	FALSE
kbjmdbaddonjfbgbi	FALSE
kmoafjmeabjgalpmm	FALSE
kmpbemgpmmjknijff	FALSE
lhpfgncmgkcmkjgji	FALSE
liajaelhlnbfnhfoi	FALSE
mdajdhjeecjimbbnb	FALSE
mdaoanbdhibooenah	FALSE
mneakajmhgepfjakl	FALSE
mneanabnjohajjgfm	FALSE
nhnmbapoifmgfengb	FALSE
nhphpebaglnkndmmj	FALSE
obldodccdhnnnpkmb	FALSE
obnnhmlmncffgoded	FALSE
olmnomhnjggfkpddi	FALSE
olnbfjciapallojoa	FALSE
pfomfilehgicdnjnf	FALSE
pgcmacfljloefpkob	FALSE
aacdhpiicehahidjia	TRUE
aacghmmcpbleipgmhn	TRUE
akobfdfmooobbhlcaa	TRUE
akogjiigoiinfinbaa	TRUE
bfckjbbmjikofbclaa	TRUE
bfecjmkoghekgnbgaa	TRUE
bpfmiaiinlioadhcaa	TRUE
bpgankeccnegpkjhaa	TRUE
cifljklffjfnbbcjaa	TRUE
cihbadojnnchlkehaa	TRUE
dcnaoidpolgkblpaap	TRUE
dcnappmfhdhkoideaa	TRUE
dmpmmbcohgcfkdhcaa	TRUE
dnajbionkpjkbhcgaa	TRUE
egfkjibhhpedimpgaa	TRUE
eggjiidiejhpkfbiaa	TRUE
famnmopmjhakcbdiaa	TRUE
fanomnolijccigkjaa	TRUE
fkihghkoiglddkmfaa	TRUE
fkjoahhgbiglemmgaa	TRUE
gdmfneiimcmgcoanaa	TRUE
gdndimjehoihkeoeaa	TRUE
gnodkkhndmcaanaffa	TRUE
gnogckhaehhehmkoaa	TRUE
hioobdnmlcemchkhaa	TRUE
hipjgkcekhedgnhhaa	TRUE
iegckmnonhamnjmlaa	TRUE
ieicpfaibbopionfaa	TRUE
ipgihjpdejbjkjigaa	TRUE
iphdnkcdmmmkalknaa	TRUE
jilhelbajogomgeoaa	TRUE
jilimbnomhfajcmgaa	TRUE
kbpjnopbfgohndfoaa	TRUE
kcbbgddlmdgcpmhnaa	TRUE
klkcgknieijgooafaa	TRUE
kllblieadednfiflaa	TRUE
lgmnooihlabcflhdaa	TRUE
lgncpebenboeklafaa	TRUE
mamnnlghhgpgenfpaa	TRUE
manffnkphcnoldigaa	TRUE
mmdnbemblenjdigcaa	TRUE
mmdobkfbpeipmhipaa	TRUE
nfdejiggeddmcikgaa	TRUE
nfdldbnjibmdlbobaa	TRUE
nogffiljmbpkgpkhaa	TRUE
nohdihdmpmhegcknaa	TRUE
okaapmaijpogjmnhmf	TRUE
okadjolaapplakcfla	TRUE
pfakfibbelkdicfmaa	TRUE
pfcpdngnmnldkdfpaa	TRUE
abbjameanibnbjldcd	FALSE
abcgbkkpfhhpfgfbcd	FALSE
alnhfdmefaeaeoghhm	FALSE
alnocbponjaheoiooa	FALSE
bgooncmdgibmglaoeo	FALSE
bgpoioojdocendgamc	FALSE
calckcfjkpnmlfengo	FALSE
camdnhbnoolihobggj	FALSE
cldnphhphidipjkapc	FALSE
cleaifdigjcpnldpgi	FALSE
dfblgnjnnhkfpjfihk	FALSE
dfcbipjniiblgmobgm	FALSE
dpdniaonkbopnfboko	FALSE
dpebepgdcdimphlocb	FALSE
ejdcnbfnpcfmgahkdf	FALSE
ejddblckkhkedbbpfd	FALSE
fdpemnfdpiingboefi	FALSE
fdpmlmpdpihfjgflnj	FALSE
fohbblfnapdeninkhg	FALSE
fohphclcjbiboiiamj	FALSE
gijfakakmkgmkcjbbn	FALSE
gijhpooimblkdafcjk	FALSE
hbmfpneiahchpboagh	FALSE
hbmikehlhiedanpkeh	FALSE
hldigklnaoedeebfpn	FALSE
hlebiakplcakiklgfa	FALSE
ifhchdjcdnojlcbblj	FALSE
ifjofofphjccocenlm	FALSE
jaddhcemmddgafjngp	FALSE
jafffkhkifnclabimf	FALSE
jjncmbdaneolncnind	FALSE
jjoeobifieipfdehfg	FALSE
kdjkkjcleeghgdfcgo	FALSE
kdkiajbgabfbiebcpo	FALSE
knpbdigecjgejhdoik	FALSE
knpjhibhjjlmgmeoii	FALSE
lidkgpbijionaikopn	FALSE
liecdbeclbakcbdapo	FALSE
mdcmmgenjkjeicckkm	FALSE
mddgjmdcfacpdfhpen	FALSE
mnpiheonkgklkgmkak	FALSE
moaoopmneabcjeilpk	FALSE
nioffoddigfelngbfo	FALSE
njafepgflojahmlopi	FALSE
ockolmgoecapfjalfk	FALSE
ocnefchbofdbjcbgek	FALSE
omnlmimimnecmgadmd	FALSE
omnpkhpjomkhocadki	FALSE
pgekdkmkkmoicgjcha	FALSE
pgepbeheenddpdlcpk	FALSE
aaabiddcfigapeockmi	TRUE
aaabigfcopmleeenmee	TRUE
ajplpapdmpgdapiemaa	TRUE
akadnbhmmcknfbpjgaa	TRUE
beijpgedlgadpbbfaap	TRUE
beinhjippejcclgamaa	TRUE
bnnhpbmhbkflhpfajaa	TRUE
bnoaddiikoodhgogpaa	TRUE
chgdjfhjbijgbpnpaak	TRUE
chggpdjdihelfbdleaa	TRUE
dblengdojkgkdmmmbaa	TRUE
dbmmlhoeippgoflclaa	TRUE
dklpjcndonbdpbkfoaa	TRUE
dkmdagjdonlphkfmcaa	TRUE
efclacfhjdmnddpmjaa	TRUE
efclfafpnpbmepenoaa	TRUE
facfdacadobkbiblpaa	TRUE
facnghbnoiibfidniaa	TRUE
fkhiopffkdjojjihiaa	TRUE
fkiapjkagaencamdoaa	TRUE
gfmhdmgekhgpkbmohaa	TRUE
gfmnglficjgeabiaeaa	TRUE
hagphekacccahfckbaa	TRUE
hahoajnijopdeljlnaa	TRUE
hkjnjojojfcgfomlpaa	TRUE
hkmhlbheblkamifoaan	TRUE
ieiellldamedolmpgaa	TRUE
iejjmpekdmgjjmgidaa	TRUE
iogpihnjdhffmemllaa	TRUE
iohdlljagejdienpaai	TRUE
jhdeckmkgiiekgojhaa	TRUE
jhdheepjmglmainjjaa	TRUE
kanmimijbibipdpkiaa	TRUE
kanpffikeloamphbfaa	TRUE
klaenhghmnfhgnkodaa	TRUE
klahpenjclpkidpgeaa	TRUE
lgdgdjkbbinjcigbdaa	TRUE
lgenjpnakfplolfclaa	TRUE
mbaigdliagdimdkmhaa	TRUE
mbddpldflpojoakfaaa	TRUE
mlnefpbffoogchgneaa	TRUE
mlnhghaljjiafbcipaa	TRUE
ngmhnhpcloimlaghcaa	TRUE
ngmkmpkhgjdoeblenaa	TRUE
ocbfiaicfkhgmeofbaa	TRUE
occfpiagkphhffdgdaa	TRUE
omemijiedgdodgfndaa	TRUE
omgcnafmjbcfnbmbkaa	TRUE
pghbddgpbdokgoejeaa	TRUE
pgicciidlmmgfhejmaa	TRUE
abafeenmeeomiehliba	FALSE
abbmpkjigegahigioak	FALSE
akajfnpbbjbgndbbfeo	FALSE
akcgcpcejdljdokbemi	FALSE
bejpgffcogkjoifmpbe	FALSE
bekfmjblbfhampgcfip	FALSE
bodjodpmadhhcpijlfd	FALSE
bodlnefjngldmhkbngf	FALSE
chjeanebhhcpmpihobk	FALSE
chjfanlddldjnhpogbm	FALSE
dbkndalhlkphjdibpcm	FALSE
dblglobejkeaokpiebb	FALSE
dlgcghdcliblaiiecld	FALSE
dlienlfpedcjjgfeedk	FALSE
eflaieaekmemifioacf	FALSE
efmeckjjmmfaeloflnm	FALSE
fabhpjkahafncandoio	FALSE
fabkjgkgigacgbgimfk	FALSE
fkingpebnjianoajlmk	FALSE
fkjcpcdedgocnhojdnn	FALSE
gfmfcecgnbocmefelal	FALSE
gfnoilmggehampadfin	FALSE
hagnjndkafmjehhcmke	FALSE
hahhbiddmjelgbbfccb	FALSE
hldeahckombkhekfkpp	FALSE
hldpmfoeaigjegbooge	FALSE
idnkebcbmhanifdpfjf	FALSE
idnnogafipaodjhiclm	FALSE
innmopddbdcjnmcflhh	FALSE
ioakehgdjdpcjmbdfeb	FALSE
jifjiakhhdpkgcomajb	FALSE
jigfbflanibgchjafgi	FALSE
kbajmmgdnfhaffjcnpe	FALSE
kbalfcoogplibhacppc	FALSE
klakbaonippdbfnblkp	FALSE
klbpebhlgllkknfjeki	FALSE
lfofifamkmjpglcpbim	FALSE
lfonipppmolcdpjcnop	FALSE
mbccfaeepjbclobhkbf	FALSE
mbcoobhbjgnlafgngco	FALSE
mmihffphmcfjgcgkihb	FALSE
mmjcgpapjjofemfpgol	FALSE
nhhpjppchjmihknmifo	FALSE
nhidpeecpjdbehhkkdo	FALSE
obdcgbianeipnefoplm	FALSE
obdpjghhddhhoalfkfm	FALSE
olhgmocbjddnjagfeic	FALSE
olhimenepgenpbacgfj	FALSE
pgadngdgjganhjggalg	FALSE
pgafhgpbejlppjpihji	FALSE
