aaadpmohmb	TRUE
aabeoahjnd	TRUE
ajhbffidpi	TRUE
ajknfgejhc	TRUE
bghclcaccm	TRUE
bghjpdacoa	TRUE
cagaooikjp	TRUE
cahbgmilee	TRUE
cjfdfepeaa	TRUE
cjfedbccac	TRUE
dfcpeibgab	TRUE
dfdjcamnob	TRUE
dopadpnbkp	TRUE
dopghfaahc	TRUE
ejkkhoaffb	TRUE
ejlkfnfpaa	TRUE
fdgcogpaia	TRUE
fdhblkapjc	TRUE
fndopgamoa	TRUE
fnecmgmoab	TRUE
ghaplejjfb	TRUE
ghcpdiljab	TRUE
hblkgcgdaa	TRUE
hblpcimaib	TRUE
hkgghlhiab	TRUE
hkhaeleghb	TRUE
ieibggkdac	TRUE
ieigdccanc	TRUE
ioodmaflga	TRUE
ioolomeeaa	TRUE
jijpngcgac	TRUE
jikdiaddlc	TRUE
kdajgiimic	TRUE
kdajipboje	TRUE
kmcobcbnab	TRUE
kmcpgiipaa	TRUE
lgfinnfanc	TRUE
lgfncjhoab	TRUE
mbhmlgmlab	TRUE
mbhngcbeac	TRUE
mlhkggobac	TRUE
mlhnofbmaa	TRUE
nghkibnjaa	TRUE
nghmmbccab	TRUE
obbjnndoab	TRUE
obbngngagb	TRUE
olkgkpbjaa	TRUE
olklhmnoaa	TRUE
pfhdhpinaa	TRUE
pfidcagnob	TRUE
addimhihlh	FALSE
addnddnngi	FALSE
alfjgfohfi	FALSE
alflenhnjk	FALSE
bdmmnaljhg	FALSE
bdpamjffpi	FALSE
bpiekeolol	FALSE
bpikggilbp	FALSE
cjgcdggjai	FALSE
cjgniaooep	FALSE
dbnghkogmo	FALSE
dbpbagjklk	FALSE
dmiiplclpc	FALSE
dmjedcjgpd	FALSE
eggjddhpbj	FALSE
eggllhhell	FALSE
fbbkognein	FALSE
fbblfckcfo	FALSE
fmamdnljkl	FALSE
fmandjnjlj	FALSE
gfgaeiihlj	FALSE
gfgfbadhdh	FALSE
gooodegfid	FALSE
gopekijlfm	FALSE
hjpgfljoad	FALSE
hkaejnlpkn	FALSE
iekfikdjio	FALSE
ielojibkcc	FALSE
ipdbbcbmbg	FALSE
iphgplljbe	FALSE
jjhmmpkmai	FALSE
jjiainmeni	FALSE
kcjngbpjhd	FALSE
kcjpcgmdio	FALSE
kmlmgfebgb	FALSE
kmoinmhpmk	FALSE
lhhglfhkbd	FALSE
lhicmnkmmf	FALSE
maoophfoeh	FALSE
mapioikojl	FALSE
mlppiadpko	FALSE
mmbfmakilk	FALSE
ngonkihnan	FALSE
nhamigokkn	FALSE
objbcjobpp	FALSE
objnojnafg	FALSE
ombegdcgnm	FALSE
omcgeffbic	FALSE
pgmkjgiahi	FALSE
pgmlagmlkp	FALSE
aaaekaiepjc	TRUE
aabpaoncmdg	TRUE
ajojgmbnpah	TRUE
akapekblphi	TRUE
bdalepiphlc	TRUE
bdbiplnbiab	TRUE
bpdpbkacenp	TRUE
bpdpepdoahb	TRUE
cimfoahhnna	TRUE
cimjpifldac	TRUE
dcdlopibnaa	TRUE
dcdpbhglfab	TRUE
dmkmfmgcbaa	TRUE
dmlocaaokdm	TRUE
effimojlmaa	TRUE
effnegkbnac	TRUE
fbafimladmn	TRUE
fballnbabhp	TRUE
flnadnijpbo	TRUE
flnbmbijlac	TRUE
gfmciibcoab	TRUE
gfmegpgfdaa	TRUE
goohchhdeac	TRUE
gopfidelkaa	TRUE
hjpdpmbdpab	TRUE
hjpjbcjbhac	TRUE
idopgfffjaa	TRUE
iecddngjpac	TRUE
ipcddnabnpc	TRUE
ipchfihbjaa	TRUE
jilppnpkmaa	TRUE
jimadcfelhm	TRUE
kdfahlfdpia	TRUE
kdhdioldaec	TRUE
kmohbnpleac	TRUE
knahofehjah	TRUE
lgpnddjgeac	TRUE
lhbllgnoaia	TRUE
mapjljoflnc	TRUE
mapkoncbkij	TRUE
mmifnflbeaa	TRUE
mmmohiccdaa	TRUE
nhlljfofhaa	TRUE
nhlmhjdlfaa	TRUE
ocbebheggab	TRUE
ocbgfiohgac	TRUE
omklefijpac	TRUE
omlanimdpga	TRUE
pgghllbikac	TRUE
pghpgknbhac	TRUE
addimhihlhd	FALSE
addndnngiki	FALSE
alghnmmjopn	FALSE
algpehhpngk	FALSE
bdfpplclkli	FALSE
bdgalkkdgne	FALSE
bpalompdlgd	FALSE
bpanlojdpjm	FALSE
cimcebmjoah	FALSE
cionembmdhd	FALSE
dcidiemaedf	FALSE
dcieahpdmml	FALSE
dmhnhpdinnc	FALSE
dmilnoakgkh	FALSE
egkckadkefl	FALSE
egkkdmgfaig	FALSE
fbjbjdmaiim	FALSE
fbjeahpdkof	FALSE
flphnaljkgg	FALSE
flpikcmjdoh	FALSE
gemhlgfmngp	FALSE
genadhpdome	FALSE
gpdcbjkdcjk	FALSE
gpdfkhhlhfa	FALSE
hkfggihemid	FALSE
hkfglepghkl	FALSE
ieplidfpbbf	FALSE
ifakimdongi	FALSE
ipebhhcbdcc	FALSE
ipgnifjlgpn	FALSE
jifplfgekec	FALSE
jigagmhmpgn	FALSE
kdnafiidgio	FALSE
kdnehdelemo	FALSE
knhkbolagim	FALSE
knigdjgjlhm	FALSE
lhbbjpedcne	FALSE
lhccbgkebpa	FALSE
manimpfpmnf	FALSE
manmepkpndl	FALSE
mmakioginje	FALSE
mmaphdgpgok	FALSE
nhfgakpgofk	FALSE
nhflbnhiolg	FALSE
obnkcdadfmh	FALSE
obohpmfopeb	FALSE
ompcpooakod	FALSE
onampfgfmik	FALSE
phahingmghp	FALSE
phbojoenikl	FALSE
aaanofolbipn	TRUE
aabkkcmpifoi	TRUE
albcgpncbmeg	TRUE
albehledaghm	TRUE
befojbcpnfac	TRUE
begagkaanlme	TRUE
cakpfgeihiea	TRUE
cangjknncjne	TRUE
clmcfmmghgac	TRUE
clmjjcbeeoac	TRUE
dfpoppapdbkk	TRUE
dgaggcninhhb	TRUE
dpibkljnnfaa	TRUE
dpinoekkdiaa	TRUE
eiochdhgigaa	TRUE
eioegnponiab	TRUE
fdajokmfdhda	TRUE
fdamckaacjgm	TRUE
foaoooeomdlc	TRUE
fobcpfblfbab	TRUE
gibkoamgpaad	TRUE
giccogbpjlaa	TRUE
hcjnbgmbnbaa	TRUE
hcjoaopklmfa	TRUE
hmpboebdfeac	TRUE
hmpkcjnjhlaa	TRUE
iglmkahmekpa	TRUE
igmfkfiecmaa	TRUE
jbhdpomnmoab	TRUE
jbibllemfbac	TRUE
jkhmfieiblac	TRUE
jkibdmioikab	TRUE
kediigejcpaa	TRUE
kedjfbdigmac	TRUE
koojbnopfcab	TRUE
koolcdfpdoaa	TRUE
ljbgjppmgoab	TRUE
ljchjimaalhh	TRUE
mekipfjlffac	TRUE
meljbpgfcmaa	TRUE
mpcldjncaiac	TRUE
mpegdcbhacdk	TRUE
njkglgbecpaa	TRUE
njkihjjlikac	TRUE
ocofnjnckeac	TRUE
ocpkaamkjjpk	TRUE
omnaeonjaapf	TRUE
omncpadbfmbc	TRUE
pgbddmaghjcp	TRUE
pgbeoocaooka	TRUE
addkhmnlfiff	FALSE
addnmfpnmjkf	FALSE
alnffgioffmf	FALSE
alnkpfdpfghp	FALSE
bfegpghbpjdo	FALSE
bfeiglcfpepf	FALSE
caikmgpiigko	FALSE
cajjjoddknng	FALSE
clognngdjibb	FALSE
clpgplefhkjm	FALSE
dfnkeamlfdmk	FALSE
dfnkmecomiio	FALSE
dpnidlncekeo	FALSE
dpnjigbbgkpm	FALSE
eidnjihgfpbk	FALSE
eiebbeikcomn	FALSE
fdfjoklhncop	FALSE
fdfnhkkiniog	FALSE
fnkhjnpcbbim	FALSE
fnljloadline	FALSE
giffhobikdfc	FALSE
gigiikfdgdfh	FALSE
hcjiimkjichd	FALSE
hckccljnigfh	FALSE
hmnfikdbnllk	FALSE
hmoiaogeofdf	FALSE
ihiocjjocpkg	FALSE
ihjhooojjodo	FALSE
jbibfcgafggl	FALSE
jbioakndhgkj	FALSE
jkmbjanlkldh	FALSE
jkpeddamkeim	FALSE
kepbghfbmmpi	FALSE
kepbmojkbpbi	FALSE
kpejcdhlknbe	FALSE
kpemagieighd	FALSE
ljobagnmklgn	FALSE
ljompfggokfe	FALSE
mebbndklkmhb	FALSE
mebmkhceoiib	FALSE
mpaningfgefk	FALSE
mpcmdodmjlho	FALSE
njendhfinagd	FALSE
njfeigdcbnad	FALSE
odfknajdimoj	FALSE
odgiinkbpjaf	FALSE
onfgopojibda	FALSE
onfjgloooimm	FALSE
pgkjfiilbhgk	FALSE
pgkpidmhhldk	FALSE
aacbdnkimadmc	TRUE
aacgcjajhcdkm	TRUE
akahabjmnjhki	TRUE
akambmlddgimp	TRUE
begmhjobkpmaa	TRUE
beighjipgfpab	TRUE
boiljdoompjaa	TRUE
boiplkkkdjhaa	TRUE
cilblcpgnkiac	TRUE
cilhejmgbfgac	TRUE
dcmmkdlpphcab	TRUE
dcmnkekfalhfc	TRUE
dndoebmpolgac	TRUE
dnfnohbgpdbac	TRUE
eiailcmickkpn	TRUE
eibeggbhmkdaa	TRUE
fbbchhknijfac	TRUE
fbblbdcaginnc	TRUE
flggbkhecifaa	TRUE
flgjflfioaoob	TRUE
gfdjobkchiiab	TRUE
gfdkgjffpndac	TRUE
gohfflblbpgac	TRUE
gohlbejioiiac	TRUE
hibfcjbmhfagc	TRUE
hicafjaibgdpf	TRUE
icpmhijadddbn	TRUE
idabmbkaeakgp	TRUE
iocffmedfbhac	TRUE
ioeimcohkooaa	TRUE
jhgoninoldpab	TRUE
jhiffgcjgdgaa	TRUE
kcfmpcjnehoac	TRUE
kcgkmnjdkpoaa	TRUE
kmnlmganfflec	TRUE
kmnobfkkaopoa	TRUE
lhlmiplnhmeaa	TRUE
lhmbgfkobifac	TRUE
mbmgjpodbhapb	TRUE
mbmibbneajmna	TRUE
mmoeckblfaloa	TRUE
mmogipgefnjac	TRUE
nghbfmpldgdab	TRUE
nghibocpopjaa	TRUE
obmifdbnnmoab	TRUE
obmjecelcmbac	TRUE
olgbhmfmmioac	TRUE
olgbllckekjaa	TRUE
pfbiokhdhhmaa	TRUE
pfbppmjpkfgab	TRUE
addhonokjlilh	FALSE
adfgijghnhege	FALSE
almhmplhknfpe	FALSE
almkhiiokfomg	FALSE
beicioccanpfo	FALSE
beiddbfadlohh	FALSE
bocbmijfcdanm	FALSE
bocccdhcgcodf	FALSE
cidpegjbajeni	FALSE
cieeedlohkikn	FALSE
dckiddklhepgo	FALSE
dckjdnngplajm	FALSE
dnbefpljogkae	FALSE
dndglpjefbmfa	FALSE
eibapnfopkihg	FALSE
eibeifhfippbm	FALSE
fbaophhfhmfil	FALSE
fbbbjcnppfkdd	FALSE
fkokjnjbicplm	FALSE
fkpnfleegaidh	FALSE
gelpdomdhhelo	FALSE
gepdhpcjdafkm	FALSE
golagpggghlgl	FALSE
golegpnbamnog	FALSE
hilkbkelgbfje	FALSE
hinnalhjhodln	FALSE
ideflnkdecmgi	FALSE
ideinkpcejkcb	FALSE
ioafhilnjfoil	FALSE
ioanomfoopflf	FALSE
jijnmkkdjpdon	FALSE
jilnealjgeeik	FALSE
kcjgcodbcckll	FALSE
kcjoefmbeilhh	FALSE
knbhoijnfheak	FALSE
knbnkdpdnofjb	FALSE
lhokmhkjgeckb	FALSE
lhplfaopljhim	FALSE
mbmnejcagofdi	FALSE
mbmnhkdpjclec	FALSE
mmikclligeejf	FALSE
mmjgnodgdmoip	FALSE
nhjckbilpomeh	FALSE
nhkdnmmmimmcb	FALSE
obpankkiipjkl	FALSE
obpdbdldnlojf	FALSE
olhaijfnmheml	FALSE
olhgkhalofhfl	FALSE
pfkojmbadnndd	FALSE
pfldcpibcljdk	FALSE
aaaoomdhhfghjj	TRUE
aacanflehmlgij	TRUE
allbeincacogab	TRUE
almmdecjjegaba	TRUE
bgldknohhpelaa	TRUE
bglegbinmodoaa	TRUE
cbbnileljlldaa	TRUE
cbccolmlcpecaa	TRUE
clkkghghppheaa	TRUE
clldigcjocmeac	TRUE
dflfdmefeeogab	TRUE
dflgmegnhmbkaa	TRUE
dpdccpeeohjnac	TRUE
dpekconphildaa	TRUE
ejhckdmgdpkeac	TRUE
ejilfblgchfmaa	TRUE
fdliljgdnmldac	TRUE
fdmfijppjjdfac	TRUE
fodinoomgdbjac	TRUE
fofgddagbfloen	TRUE
giljjohpflcbab	TRUE
gilmildaeopoec	TRUE
hcgbmmlpmhmdab	TRUE
hcinikkkhmeeac	TRUE
hnbbkcmbchaofc	TRUE
hnbidjmhijhpab	TRUE
iibfdeianleahi	TRUE
iichgojfjaedda	TRUE
jcbmfmmdcfhmac	TRUE
jcbmindmfabape	TRUE
jmolbllmaidflb	TRUE
jnaaklgaoklkcn	TRUE
khlacnahpafdan	TRUE
khmemhpcebciaa	TRUE
lcagbponkmcaii	TRUE
lccojmdeblbfab	TRUE
lmlekellmdfaha	TRUE
lmmgkcfadgjnch	TRUE
mgampcbbbmdcdj	TRUE
mgbfbmafibklib	TRUE
nabdgbpeenakld	TRUE
nacladogkpijgj	TRUE
njfpfndincfdab	TRUE
njhifjjmlochab	TRUE
odbophlcjdfkac	TRUE
odckejfjiecaja	TRUE
omfihpjhggfagc	TRUE
omhkmncampmmja	TRUE
phceegdlapacga	TRUE
phcogellbchcab	TRUE
addddingoiijkm	FALSE
addgelgjdpkmmf	FALSE
amgkeoegfepeop	FALSE
amgmhfmhhnolpl	FALSE
bganligooelmli	FALSE
bgcfpbldnnocmh	FALSE
canjhmfjhpdnji	FALSE
canonfgoifhdhg	FALSE
clheeefnbohnpo	FALSE
clhfbapegjldgm	FALSE
delpnfjgkhldmb	FALSE
dempijpljpjomf	FALSE
domkfgjnbnkefp	FALSE
doneibahpohdkg	FALSE
ejhgjlhblnfakp	FALSE
ejhiifoomgcene	FALSE
fdjhkgbmejcojf	FALSE
fdkeombhjoemie	FALSE
fohnolpfeinoba	FALSE
foieikebdmhoie	FALSE
gielljaojdiffp	FALSE
gigmfilpoffipk	FALSE
hdddiclhmcllpb	FALSE
hddplhockejdfd	FALSE
hnjgobnpkdecle	FALSE
hnkghceidlmiok	FALSE
ijamhmpolegold	FALSE
ijapinlkikjdkl	FALSE
jcfdhhbooahkpl	FALSE
jcgpajdjjmfkpf	FALSE
jmljihopklopkm	FALSE
jmniigcpcdincl	FALSE
kglfdkcinljoie	FALSE
kgmcheidjlfmhb	FALSE
lbpbognkfciomc	FALSE
lcbfcgphfmjckb	FALSE
lmlihjpfomlbde	FALSE
lmmnolnbhjghfl	FALSE
mgadmofgipghje	FALSE
mgahoifngmhnig	FALSE
nadjjeldhellpl	FALSE
naedkpeiohfnon	FALSE
njeoaddmploknk	FALSE
njhmdplbogokbb	FALSE
odamhgipgoefoo	FALSE
odbbdpddolodfh	FALSE
omfafoneehndnm	FALSE
omfalhnlkmmpgj	FALSE
pgflopcadnfflk	FALSE
pggdkaidgjemff	FALSE
aabjmpppahdopcl	TRUE
aaeoiphmeceegnh	TRUE
akcfjggncjflcon	TRUE
akcnllkacdebnga	TRUE
bekhgbkehjcgfaa	TRUE
belecniebdhbgac	TRUE
boelhefccifobab	TRUE
boepakifhaajbie	TRUE
cimgdlcjeffjagb	TRUE
cimjcicemoljiaa	TRUE
ddcjcdakpcddkbh	TRUE
ddcnpplffgajojc	TRUE
dmoejjmlhjdbcab	TRUE
dmofpacdcgknlkm	TRUE
ehijngnonbnfhab	TRUE
ehkndjheellcjaa	TRUE
fbpacbmmcnloncg	TRUE
fbpmlhldgnjdiaa	TRUE
fledmapbbjegoch	TRUE
flehjkklggmheaa	TRUE
gfpoejjkjcnegab	TRUE
ggadkcljkbkejcf	TRUE
haopmkeafbdhgam	TRUE
hbbacgmajicnnfm	TRUE
hlaonlocipodjna	TRUE
hlbaodbbpfdilgp	TRUE
iepkcopchdhiaic	TRUE
iepkggnfinbeiac	TRUE
ipadnofpjmkbnfd	TRUE
ipbmjddagliioic	TRUE
jibokapoefnlcmh	TRUE
jiccahicjclabnd	TRUE
kcgedkmiphlfmac	TRUE
kcigimibhjofnaa	TRUE
kngomggfiaamemd	TRUE
knhaibidkbmlhpg	TRUE
lijoogdhdmkankc	TRUE
likapaebbpnejmo	TRUE
mcidneikbhbjcac	TRUE
mckcdcgljedibab	TRUE
mmmmaonafjflgkk	TRUE
mmoalgomdgglneb	TRUE
nhchdejgfcjkbac	TRUE
nhcpgkmajnpcknk	TRUE
oaceneniginecmm	TRUE
oaecffmmljpejik	TRUE
olkicabonopimhn	TRUE
olnapnklcemijcj	TRUE
pflnodbgkbhghab	TRUE
pfmadhnkkicncel	TRUE
addeiemikfhdkgd	FALSE
addfipddpghjgig	FALSE
alhmoikkmeihefn	FALSE
alhoohegiippplp	FALSE
belmafpoileikil	FALSE
belpocenmmddjdl	FALSE
boalnmgngkpfpdh	FALSE
boapmeiekmnjoog	FALSE
ciohgiehjfiobhd	FALSE
ciojnghedlnnldo	FALSE
ddgjfhlekclegdn	FALSE
ddhighhbiobgngh	FALSE
dmnialklofikmhm	FALSE
dmnnammojhhdifm	FALSE
egjkkebpoaflomk	FALSE
egkopeeoagenpko	FALSE
fbehhokkncpmpgf	FALSE
fbgjchbfjhlljak	FALSE
flknlaooehmgnfo	FALSE
flmjkbkejcfhfci	FALSE
gflpkkoedhbfmpl	FALSE
gfmlbnkljcblmff	FALSE
haonikgpiekjifp	FALSE
hapgeomengmkpdg	FALSE
hldeajjhfpoghdg	FALSE
hldhejogdfkannh	FALSE
iekkdffblbndoia	FALSE
iemfgghkfcgomcd	FALSE
iopgpdljgjlbeko	FALSE
ipbgpbgfklmgfop	FALSE
jjbooicbmkedhag	FALSE
jjclimfbkkejgco	FALSE
kcocbdoheahdlid	FALSE
kcodienhmialnhn	FALSE
knljhechmpkcpod	FALSE
knmgfdklninlnbl	FALSE
liikcaffokkojfo	FALSE
likclejmahnhhip	FALSE
mdalffljhojigkg	FALSE
mdbnjakjmlemfff	FALSE
mnbpohcogeladlk	FALSE
mncccpgiheapfpk	FALSE
nghanlikifkdhjk	FALSE
nghcejfopcmlahd	FALSE
oaenlmfmknlknlo	FALSE
oafhdeegglpnkjg	FALSE
okomfafeegiopek	FALSE
olaninipmdmlokl	FALSE
pgafgegdmfimlph	FALSE
pgbfcklgmebjcci	FALSE
aaainkgjmcjnoape	TRUE
aabdebccofambpag	TRUE
akjhdenjbfolonmm	TRUE
akjheldondakihki	TRUE
bfiigghfdiajebip	TRUE
bfikkliekcmhmhac	TRUE
bpiinhhcpimdgaib	TRUE
bpijbdnoochnpana	TRUE
cjdpkplfnejaecln	TRUE
cjfafelkonohlekb	TRUE
dcgmgmjmkcbpdkaa	TRUE
dcgncdlecdeamefa	TRUE
dnafjkjpkekkebae	TRUE
dnaogimoididhcib	TRUE
ejenggjleokggoac	TRUE
ejhbbhejbdnlopaa	TRUE
fdfbngpmodbbfgac	TRUE
fdfofgbdghobaafg	TRUE
fomomocfmjpkailc	TRUE
fonihncdnedfhgaa	TRUE
gijfbelghedmkoac	TRUE
gildgebnfmkjnaoc	TRUE
hchahccdhcjbpjfl	TRUE
hchoebikjihnepac	TRUE
hmnoccgoocdnckac	TRUE
hnadabogphanopel	TRUE
igfpibklepjfjbaa	TRUE
iggfekfkckgikada	TRUE
jaolknddkcmpbmcd	TRUE
jaopcddoepgcciac	TRUE
jkgeplldgbmhlabg	TRUE
jkhkkgakkficdkki	TRUE
kfoobdaaanhnlfmb	TRUE
kfpooocplnppenab	TRUE
lacbegideifnhjep	TRUE
ladimohpnemknhjb	TRUE
ljmiknkoghjfcnac	TRUE
ljoeopedpedhijab	TRUE
mdnfeiohnjmbmdac	TRUE
mdoiakjmhkbddgpc	TRUE
mnkinjjfgjgomeaa	TRUE
mnlgcgmfmoikkbac	TRUE
niailbanegmbnnii	TRUE
nibceblgeoclepaa	TRUE
ocmabcigmfniejld	TRUE
ocnahhafcgkkkngf	TRUE
omeapkakncpeclfg	TRUE
omecegfijnoclfab	TRUE
pfmgglkkemldejaa	TRUE
pfoddlfgooaegmbi	TRUE
addjingpmikgmfjd	FALSE
addkknejifndmofi	FALSE
aleddppgpgomdfpi	FALSE
aleekjpjppefgkem	FALSE
bdlihijkhkcbhncm	FALSE
bdllkgfjjdjifghf	FALSE
bmpjeiojhoecemng	FALSE
bnahhijnhjejehlo	FALSE
cgmainmehemnohli	FALSE
cgmlpcpkcddngahh	FALSE
danllhhkleledfpk	FALSE
daofkpjkpglimeff	FALSE
dldgaeinkokgipej	FALSE
dlgmcgbpjimadgdh	FALSE
eelhjbndgjngmnka	FALSE
eemdkmckbddkcpag	FALSE
eoofmjlbofoknejk	FALSE
epaokmddemffnmkf	FALSE
fjkckfkecgfjofgh	FALSE
fjkmdkimimlfplon	FALSE
gdgbekpkopiooafp	FALSE
gdgcppbjahphohkk	FALSE
goahemdflpkgkggm	FALSE
goaklljhgijpgnkm	FALSE
hhldpbklcmljnegn	FALSE
hhljpojklifoldpf	FALSE
iccjkfknjkhejlaf	FALSE
icdajidkfldolndf	FALSE
imedibedndgeanih	FALSE
imflbikldofngcdf	FALSE
jhgcfnmighgobcmh	FALSE
jhhcdbjidlhdofjc	FALSE
kbpfeopibcmijgic	FALSE
kcbimbegfoghnahh	FALSE
kndgpklflmlcobmf	FALSE
knfdnojhjlicfblm	FALSE
lgpfdfmklbeggfdg	FALSE
lgphfbbohnoinjgi	FALSE
mbejjfaeilifkeno	FALSE
mbepjbniklamjdhd	FALSE
mloocfapmijpjpok	FALSE
mlpgoalkikmjghhd	FALSE
ngmbenbdhocelgjh	FALSE
ngmpjokcgigookmj	FALSE
oblkkpbgpciahoml	FALSE
obmipakoopmldlpn	FALSE
omfjfdcmifphjjpa	FALSE
omgeohpilfdkgcge	FALSE
pfpghahdfkipgfol	FALSE
pgajndlkppmiffom	FALSE
aaanllpobemgeneop	TRUE
aadeahdaecpkhpldb	TRUE
akamdpdhcaljdmmdo	TRUE
akbdjghogbnmhcokb	TRUE
bdnfecljcaeckmfni	TRUE
bdngmgpgilpccadak	TRUE
bndglbafjhmaodfhk	TRUE
bnechbhjlgfmfadoa	TRUE
chgkpfdokjnikkbab	TRUE
chgmpllpfeleacegi	TRUE
dbaocflkahokeoahe	TRUE
dbblghoeacfoloecb	TRUE
dkeliaobckhbilhie	TRUE
dkfgfjldfidjineab	TRUE
eeohlojaokieifofb	TRUE
eepkinkgdgjkdjlab	TRUE
epalnecjlmcahonlc	TRUE
epbcpikfdbnpgnfac	TRUE
fjmefhjkdnljihgab	TRUE
fjmmgbinhdlkkiiaa	TRUE
gdnabpnhobakapjph	TRUE
gdnifdjjojlfogfac	TRUE
gnoejkdfjggfffbab	TRUE
gnojgmbilljfhniab	TRUE
hhibfljfjggmhegab	TRUE
hhihmieilbimjicaa	TRUE
iceddmajlkiioilfa	TRUE
icegbgaoccbidpndg	TRUE
imglmgcgjjphlghac	TRUE
imgmkmannihpgojkb	TRUE
jhbddnmmmcghgjpac	TRUE
jhbekeegckmmdkkaa	TRUE
kbngkmpamhjffjofc	TRUE
kbnpoiendccjkhgac	TRUE
knenjaklogomhieoa	TRUE
knfclkmalgmnjgopc	TRUE
lgilmponjohdhngac	TRUE
lgjddbdknmlkgipaa	TRUE
mbbehhpbbaobiajli	TRUE
mbbiemdnlcadpklcl	TRUE
mmejppnapjkmjinkc	TRUE
mmfnopedlofmmdmaa	TRUE
nggmkipbbbagjgnja	TRUE
nghinbjjnpkekfbab	TRUE
obelbifghdghmonab	TRUE
obgdmecjoheddjiaa	TRUE
olhchaimodabgojcp	TRUE
olioephpkdbbfljac	TRUE
pgbplnpplhljdhmac	TRUE
pgjogbjmdjipjkhab	TRUE
addjgedgmpeijkgkn	FALSE
addopefgkfdodopnd	FALSE
alfmkdlkigdfpnjlk	FALSE
algghepojljedmjfk	FALSE
befneebnllbionlgk	FALSE
befpmldemmpmaigog	FALSE
boifndonihmgegjen	FALSE
bojagjjlkndlhndip	FALSE
cihaomlkdelmnnemh	FALSE
ciioeeljjamllginh	FALSE
dcnlhhaglfoojlihi	FALSE
dcoofjepecbkplipm	FALSE
doaigjfnkpdgpignj	FALSE
doaiilojddpkjdodj	FALSE
eipfagpmhnmindmpi	FALSE
ejafmoeddefoekodk	FALSE
fcccidmclalpkogfe	FALSE
fcedcllamjdgjiijh	FALSE
flnlgladkfhlllfod	FALSE
flnooikkdklbkfido	FALSE
gfmoefnmblnjmgbif	FALSE
gfnfjddocafmjioof	FALSE
gpgoemogflgmnifhn	FALSE
gpiebplddhelmhcom	FALSE
hjmdmgnalpolniknm	FALSE
hjmeicbbhgcgofaeg	FALSE
iechddaeegjflmpml	FALSE
iecjanpghndlmmlph	FALSE
indkpiphdnnnhapgm	FALSE
infnlmlfpgmdphhhl	FALSE
jifkpnpddbfhhmepa	FALSE
jigekknakinohipje	FALSE
kdemcjpbdbccpeaie	FALSE
kdfblaelngflilpil	FALSE
kocjffdlcbobhmiak	FALSE
kodimdbllngjiikfc	FALSE
liilnjibclnpifhol	FALSE
lijfcpldigfaomgfe	FALSE
mclglpplpecdahino	FALSE
mcmaeddklikpekiin	FALSE
mmjbmldfamniplolo	FALSE
mmjmndaeokpglegdi	FALSE
nhfbnjmdalkgmjhdn	FALSE
nhfcbhplliedhchhn	FALSE
obbjcclieekedinad	FALSE
obbjdmbjdifinnnpa	FALSE
onblcpjogggggfemm	FALSE
onfijdblaejindkhk	FALSE
pgejeebibanihefgm	FALSE
pgelccpljpmjnlpnc	FALSE
aaalgeddfonlcgaapk	TRUE
aabdhjmbhlgbanadbe	TRUE
ajfhcaheefciiheekf	TRUE
ajfkahicdpnffmdibj	TRUE
bcolbbcillomflampa	TRUE
bcpbpemidboalnffha	TRUE
bnlpdflnaoiiohikna	TRUE
bnnnephfihfdpkcbaa	TRUE
chbeiabpcocakaheao	TRUE
chbkjohkoedbmhliab	TRUE
dbajhfkpphdoeigpka	TRUE
dbbinabljajalmakmm	TRUE
dmbnobhhbocbkidhaa	TRUE
dmcbbdppeikoejpiab	TRUE
efmfeppdakgegkinlb	TRUE
efodcidclplodlfeac	TRUE
fbgdijpgibjinldnaa	TRUE
fbgdkmbdcfbgbfpjab	TRUE
fkmllcibckfopogmac	TRUE
fkmlojflkbhcmhiada	TRUE
gghmonfboafckbpodp	TRUE
ggicmjcgmilmffmiaa	TRUE
hamhgjbfkdpkcgbgmh	TRUE
hamminehfikbldkehi	TRUE
hlmiiipbbnekjljahc	TRUE
hlmmapjadaeplocolo	TRUE
igkohcnneenbnjkmac	TRUE
igmjahgkjpiplmocme	TRUE
jbckinndhnigmhabki	TRUE
jbclbejcdfnpgedgac	TRUE
jmaengpaccholmhemd	TRUE
jmagkonlpklnndpbeb	TRUE
khcibgegnkaohmondc	TRUE
khdonefobdecnakmga	TRUE
lamoegnlgacmjpldgo	TRUE
lankaklbcmibmapjdc	TRUE
lklkmieakfpkpdppdc	TRUE
lkmohlkmkolpfhnlab	TRUE
menkdkmkmiobbiglaa	TRUE
menpkfmaepjkbkcjke	TRUE
mookneaeilhnlfnlec	TRUE
moonblflggjfklhjac	TRUE
nipppcbmpbhdbkjmab	TRUE
njdcmipgimkofbpmab	TRUE
odoefopoaollldpmpb	TRUE
odppeejheedlbdepac	TRUE
ongmkfmclginknjhaa	TRUE
onhechbagbjfkgmoin	TRUE
pgggkmhlnpbbmhehaa	TRUE
pgghomdlihlhgnilab	TRUE
addenpjnkejlhfhkjo	FALSE
adeimlhmimnhlodoop	FALSE
akmnoimoojnookpnhg	FALSE
aknghgfnlmpkpdpegg	FALSE
bdgmmjngenbgfndmaj	FALSE
bdhhpnajkdjgkolook	FALSE
bndfpkgajenmkdneed	FALSE
bnecflolgddlapfnin	FALSE
cgoibhdboaimpmglgm	FALSE
cgomflemknceijoagh	FALSE
dbpdfedbgkobojonhe	FALSE
dbpdjdgcngojpokejk	FALSE
dlndpjipdkkpghgffl	FALSE
dlnkimkaljfjnljknf	FALSE
ehcjolndhjanmfgoli	FALSE
eheconlegoaigodnne	FALSE
fblpobgaoefonjdipi	FALSE
fbmcdmclhlnhnameke	FALSE
flkladfkjkmnopeoge	FALSE
flmedgbbdhfniahdom	FALSE
ggcaijkfeglpnnglfh	FALSE
ggcpehnndokjdigkla	FALSE
happfjeipfnimnfnml	FALSE
hbcagedfmgigmmefge	FALSE
hmcniafhkopgenkdke	FALSE
hmcnojepibijgmpicd	FALSE
igckafelmpokpfgoil	FALSE
igckmchligcedmhfbc	FALSE
jaohkmhnilkiogidmj	FALSE
jaokfokphfjdheploe	FALSE
jmbphkcianikklpmfo	FALSE
jmcddaoefgnpmldmgp	FALSE
kgnffdfjclgmmjnnlp	FALSE
kgoeliagpophnodjpp	FALSE
lapldeifhdmnohopll	FALSE
lbahpmgmpdfghfemfp	FALSE
lllbcdbjnhohbhmcdf	FALSE
lllodbfimdkganfflj	FALSE
mfbffegpeboaepkjpl	FALSE
mfbfpollhekfdhoeil	FALSE
mokplnlgimkdgmomdo	FALSE
momaipidfdjmomojei	FALSE
niofgghfehdoadfmin	FALSE
nipcediakfngdmjjnl	FALSE
odfelpnpoljajlfjmg	FALSE
odgipmahpofmdjmnof	FALSE
omnenfcofjdagfgeel	FALSE
omnjjnajolmdkefohf	FALSE
phdbinnigehndgifam	FALSE
phdbkckkmakdhklpng	FALSE
aaajifgchlplaodoolg	TRUE
aablnpcmgjlagocgenj	TRUE
ajjggclpaobhhdkfocn	TRUE
ajjmhlhgclljdajmoil	TRUE
bdnlkchfomjcehgieac	TRUE
bdopeedkkohejmmpmab	TRUE
bpjeoegoeailicejbgk	TRUE
bpkaojlfpaobndmhanm	TRUE
cinkljppebklncjpoaa	TRUE
cinnfngbbcgmjpokmac	TRUE
ddbmomgofmkbpcbagnb	TRUE
ddcofaoocpogjgehopl	TRUE
dniamlmhicpjeomblfb	TRUE
dnifblknfcfkdhcnhaa	TRUE
eibbhgkgbnckdomnjac	TRUE
eicbeccnhgffdhiahkb	TRUE
fdaeponofnjfpgalhbm	TRUE
fdafbooppggngedljen	TRUE
fnnopnboggdmadffcll	TRUE
fnpekockimdmippbhab	TRUE
ggibeeohodgfbekgnaa	TRUE
gglmomihbfonhlhndab	TRUE
hbglddcdnehfklmihab	TRUE
hbhmljecibfhokhoeac	TRUE
hlbfbnkmobkdakdaifp	TRUE
hlbgpippoecmdcemeaa	TRUE
ifiehgjjnancjgiibbg	TRUE
ifkoifpajimlflkfnpb	TRUE
jaakchlomlfjipkfdgl	TRUE
jaalonjlnkegoabhkdc	TRUE
jkcmacofpjdggdmoffi	TRUE
jkcnmcmphgnedbociaa	TRUE
kgbpjechdndndnpjkaa	TRUE
kgdkidpkamllpgliali	TRUE
kpkbdljjbdjcjhfopac	TRUE
kpkedinheoodflkfdac	TRUE
ljicjlkncmmnidinalc	TRUE
ljijdolgmhlapemlama	TRUE
mdkohlhkcchcmkioalc	TRUE
mdneahhoajijjoicocl	TRUE
mohfmokjjmgpkkdanhc	TRUE
mohkohgdhppnclmablj	TRUE
njciophinifldkhceac	TRUE
njcodgkpkmbngemmiac	TRUE
odgoafepgjanjonopah	TRUE
odhennaflijdfmlceih	TRUE
omgobmfjeajmmnieoia	TRUE
omhlhjhfieaechbfnof	TRUE
pggkdpakmjpdpkidcne	TRUE
pghpkhfcpjflnianbpo	TRUE
adddelgigpfmgleepgl	FALSE
addpeliodpipjfnfomg	FALSE
aljlgpdmjhihemeffpj	FALSE
aljmdonnnnonnmemeoj	FALSE
beipcedanflgphiidgh	FALSE
bejfljobgejoajhmefm	FALSE
boffokikmaodognnkdm	FALSE
bofpjjjgahfnplmdnpi	FALSE
ciahognhlnldimdhnnd	FALSE
ciaipenehiomfhjommm	FALSE
ddifcmmgleplgecpnhb	FALSE
ddijljbhafmimhjpdhp	FALSE
dobcpbalpknfmmedhhh	FALSE
dobfpcoanjehlennnlk	FALSE
ehjkdaidhdjmfkhggfi	FALSE
ehjobdcafimgfdndpgn	FALSE
fbjkpdjjghaghjmpgmm	FALSE
fbkecfmlapfjlkdiidd	FALSE
fmnbmkahkffomgdipgi	FALSE
fmobmppooblmkkjjegb	FALSE
ghfjaedkdndeidfjddp	FALSE
ghgdkckphkkfjmhhidk	FALSE
hbjibmmegpgfmcmgejo	FALSE
hbjmcgbpcoklednnkop	FALSE
hmcpifflhljkkkocdda	FALSE
hmcpnfjdpkpjpjjlfjp	FALSE
ihmefapjhpfhofdpphk	FALSE
ihmgneaiogoigfdgmfi	FALSE
jdaihoimgfogphngmkh	FALSE
jdandhfnopjjllmmdep	FALSE
jmpjdmjdmkpbmphakje	FALSE
jnaognglfjlndgmmngk	FALSE
kgakmjdldheoeihpoml	FALSE
kgapflllefijjeoehpi	FALSE
lahojlgkdoodolhpfeh	FALSE
laieflfnokjdpimgeme	FALSE
lkgccgchiphoccbpojj	FALSE
lkgjkggdmbdoiomdlbh	FALSE
mefgjlogdddfcmkgmdl	FALSE
mefiaifkegjkjjglnpk	FALSE
mocoohdiejgofkifind	FALSE
modilkjjkmoecbdpija	FALSE
njifdccbglblighglkp	FALSE
njjpfilhoilienpejnp	FALSE
oclglanfpljiphmngmf	FALSE
ocliedaidnjnpkkjflg	FALSE
omlnidgonplldcgadeg	FALSE
ommhilognnelanekfin	FALSE
pgjfdblodnhohmpfdkl	FALSE
pgnfcaijenidjghoenl	FALSE
