aacpepbncd	TRUE
aadfeffhaa	TRUE
ajlnkafana	TRUE
ajmglpbicd	TRUE
bemihmpbaa	TRUE
bepapipaaa	TRUE
bomlinnbaa	TRUE
bonddmobaa	TRUE
ciehbnkbaa	TRUE
ciepjcfdcd	TRUE
dcccldiocd	TRUE
dcdmempdcd	TRUE
dndpmobbbb	TRUE
dngefebbbb	TRUE
ehlofjcdcd	TRUE
ehnhgfbbbb	TRUE
fbinigibbb	TRUE
fbiopdibbb	TRUE
fklnfocdcd	TRUE
fklnhjabcd	TRUE
gfdnlbkbaa	TRUE
gfdpcndgcd	TRUE
gpoimibbbb	TRUE
gpphbkjbbb	TRUE
hlecpbidcd	TRUE
hledpagbcd	TRUE
ifolgkbbbb	TRUE
ifplglbbaa	TRUE
jadonmobab	TRUE
jagamfgfaa	TRUE
jjcgendpcd	TRUE
jjcnepedcd	TRUE
kcjbojodcd	TRUE
kcjolhldcd	TRUE
kllfocgdcd	TRUE
kllkmnabab	TRUE
lelppfcdcd	TRUE
lemiiibbbb	TRUE
mafedngbcd	TRUE
magghimaaa	TRUE
mlhlofbbbb	TRUE
mljbnohbbb	TRUE
ngkaggaeaa	TRUE
ngkblmjbbb	TRUE
oaplhelaaa	TRUE
obapbdigaa	TRUE
omgmpobbbb	TRUE
omgpdanbcd	TRUE
pfknhncdcd	TRUE
pfnoalfaaa	TRUE
aaahjomgbo	FALSE
aabnkkioll	FALSE
ajlnejafgp	FALSE
ajlokcimgm	FALSE
bebljmcidl	FALSE
beccjbeggg	FALSE
bogmgfcend	FALSE
bohiillebl	FALSE
ckobgdgmhi	FALSE
ckojehdjbf	FALSE
dfdjadkcbc	FALSE
dfdkaljion	FALSE
dobmlhbgjj	FALSE
dochdpgjlp	FALSE
eikapbaiea	FALSE
eikfikdnjp	FALSE
fcmeoljoke	FALSE
fcnijhhjjd	FALSE
fmcojhpbaa	FALSE
fmebfnmodm	FALSE
gfnaafgknb	FALSE
gfnfppjihe	FALSE
hamdelllih	FALSE
hamheomjpn	FALSE
hkhcpiidek	FALSE
hkiplddmoi	FALSE
ieeplmlahh	FALSE
iefadldehf	FALSE
ingdgbgbgg	FALSE
inhamnahkc	FALSE
jifpobojhd	FALSE
jigilljacg	FALSE
kcjiaaeheb	FALSE
kckpjnbppj	FALSE
kmeggacdcn	FALSE
kmfkaafpch	FALSE
lhflffjgpf	FALSE
lhgcfiagol	FALSE
mbjohkdjcg	FALSE
mbkcmhenag	FALSE
mlojaimoob	FALSE
mlonopecgl	FALSE
ngppalnkcd	FALSE
nhadicoimb	FALSE
obcmlpmflk	FALSE
obdblanehe	FALSE
oljjlffgdc	FALSE
oljmjfpbea	FALSE
pfnachgmal	FALSE
pfpfkfdibc	FALSE
aaaginlfpan	TRUE
aabnkkiolcd	TRUE
ajiboedpdab	TRUE
ajifnfmeaaa	TRUE
bejjdpofbaa	TRUE
bemjbecjibb	TRUE
bogpikhjbaa	TRUE
bohanehjbab	TRUE
ckkfanokdcd	TRUE
cklnkgagbab	TRUE
denfghjcdcd	TRUE
denjffdcdcd	TRUE
dokmnabagjb	TRUE
dolbgikbgaa	TRUE
eiaoghkgaaa	TRUE
eibepafapaa	TRUE
fckdpkafaaa	TRUE
fckplebodcd	TRUE
fliecjjndcd	TRUE
flklcfpldcd	TRUE
gfppeepabab	TRUE
ggahjabnoaa	TRUE
hakpcpokbab	TRUE
hammijopaaa	TRUE
hknfjnabeab	TRUE
hknmjdcndcd	TRUE
idomfmmcdcd	TRUE
idpbcgphdcd	TRUE
inehckcmdcd	TRUE
inflocggdcd	TRUE
jheblbabfcb	TRUE
jheckceidcd	TRUE
kcfbmaehaaa	TRUE
kcggffmbdcd	TRUE
knbojfoibaa	TRUE
knccccfgdcd	TRUE
lhmoolpbbbb	TRUE
liaffgbppab	TRUE
mbpplmhabcd	TRUE
mcadlbpbobb	TRUE
mlpdllecdcd	TRUE
mlpgledaaaa	TRUE
nghjphibbaa	TRUE
ngjbdmehbbb	TRUE
objnhdmibaa	TRUE
objoclindcd	TRUE
omaoioheaaa	TRUE
omblafdpbaa	TRUE
pgehjlpbbbb	TRUE
pgfllebhbaa	TRUE
aaahjomgboo	FALSE
aabkkiolljk	FALSE
ajjkcmmpcnh	FALSE
ajkjhgmlpbi	FALSE
befccdfbigh	FALSE
befdjoekhda	FALSE
bonneodkgjj	FALSE
bopcajnhkdk	FALSE
ckmhhgmgmkn	FALSE
ckmnbjakkpo	FALSE
dejgogfhldk	FALSE
dekcnnlncel	FALSE
docchfofiab	FALSE
docpdpflkij	FALSE
ejifledgbkd	FALSE
ejkihkmapfc	FALSE
fcdmbmllibp	FALSE
fcdodmgiami	FALSE
flaocgnnmmj	FALSE
flbbbclgfjo	FALSE
ggamfjnabek	FALSE
ggbjdcnedbj	FALSE
hajmlmdbocm	FALSE
haldpjaodoe	FALSE
hlbnjmcjpnl	FALSE
hlbppaoaddg	FALSE
idoaejahljg	FALSE
idobpbopkcb	FALSE
inhiohionpi	FALSE
inigdoiagfe	FALSE
jhoboekckje	FALSE
jiafkmleffg	FALSE
kcgpkeioipj	FALSE
kcgppikaifg	FALSE
kmifhgnabgj	FALSE
kmjibfbakcp	FALSE
lhafdpiainm	FALSE
lhdhnhoeccd	FALSE
mblpcimhbjo	FALSE
mbmcdjnlhdp	FALSE
mlkmkcgmaaj	FALSE
mlmoocoalfc	FALSE
ngbeanidapa	FALSE
ngbimgfjafk	FALSE
obgjpbjcffo	FALSE
obhoimeoabk	FALSE
oljjjadfckn	FALSE
oljkmcfkedb	FALSE
pfgcnkdibgk	FALSE
pfgjmadnfcl	FALSE
aaaagdihemjp	TRUE
aacpelmehlaa	TRUE
akefnkbkgmcd	TRUE
akenfdjapoaa	TRUE
bfapaibalfoa	TRUE
bfbabnlhkgkb	TRUE
bongenfkjbbb	TRUE
booggfcofbaa	TRUE
cipghdopggcd	TRUE
cipoponbobaa	TRUE
dcpmjapfhaaa	TRUE
ddanahanhfma	TRUE
dnleneicjdcd	TRUE
dnlhlpjmabcd	TRUE
eipihigebbaa	TRUE
eippbpmnlbaa	TRUE
fdbiljlfhbbb	TRUE
fdcdibnhkicd	TRUE
fncbcigbfcbb	TRUE
fncinecegdcd	TRUE
ghgobjiplbbb	TRUE
ghhgdiljabcd	TRUE
hamfplimmbab	TRUE
hamlcdkollcd	TRUE
hkijcljdljcd	TRUE
hkjhlbngpbbb	TRUE
ifflbngakaaa	TRUE
ifflfbicdacd	TRUE
iphdcnmppdcd	TRUE
iphjadfhfaaa	TRUE
jjpbmihnbpaa	TRUE
jjpmlfepbbaa	TRUE
kecolbceaaaa	TRUE
kedhbnehhbbb	TRUE
kogmojnkbbaa	TRUE
kojkafkooaaa	TRUE
lhifpkbbcfaa	TRUE
lhikpfacebab	TRUE
mclflmcojdcd	TRUE
mcmidhgfpacd	TRUE
mmnbipiafaaa	TRUE
mmoaakbiopcd	TRUE
nhkfnbhcbdcd	TRUE
nhkhfcojgdcd	TRUE
obilckkafdcd	TRUE
objldillnbaa	TRUE
ollhfhdkcdcd	TRUE
olmfjgopaaaa	TRUE
pfhjlnhebbbb	TRUE
pfhpnfmkcdcd	TRUE
aaabhejifnkf	FALSE
aaclmehlaepn	FALSE
akegoniicjja	FALSE
akgaomnoedic	FALSE
beegcgphigdn	FALSE
beenmkfammif	FALSE
boikhchfkbch	FALSE
bojedbcelkkn	FALSE
cifbdojokdkl	FALSE
cigjhlapcbph	FALSE
debjehpbfpjp	FALSE
decgkfiigppe	FALSE
dnoejnahgaig	FALSE
dnoghbnekfph	FALSE
ehjfidibbbhk	FALSE
ehjlbgcebbmj	FALSE
fdfihpclcbee	FALSE
fdgmhimljipf	FALSE
fninjflnenkb	FALSE
fnkeippeenhf	FALSE
ghjdijkmegaa	FALSE
ghjoaiibemmo	FALSE
haoecoepiled	FALSE
haofbmikhojc	FALSE
hkimknnklfaf	FALSE
hkjaddidhcnj	FALSE
ielopaknbjld	FALSE
ienmddhhipbi	FALSE
ipfihpidindp	FALSE
ipgcneaecgea	FALSE
jjjkjpiohckf	FALSE
jjjlofkjhgnl	FALSE
kefebigkogik	FALSE
kefpmdhomeoa	FALSE
koibchcoocmd	FALSE
koipjbkdlbhe	FALSE
linhelihmmam	FALSE
lipefpjknkmk	FALSE
mcpfmalfnmdl	FALSE
mcpnmefoliol	FALSE
mnbndcocbibo	FALSE
mnccaacphlel	FALSE
nhchkiepbeha	FALSE
nhdihkchobob	FALSE
obeabnapflke	FALSE
obehaphilkab	FALSE
oloajlffoalm	FALSE
olpcjbhdnmdl	FALSE
pfjcbfgkoeco	FALSE
pfkdekipahec	FALSE
aaabackaonhik	TRUE
aaaghalcgipfe	TRUE
akfmapidpkdaa	TRUE
akgjfdbgicofd	TRUE
bfmdfickpkbaa	TRUE
bfmldmpillbaa	TRUE
cafpogmefbicd	TRUE
cagbmpmjbfgbb	TRUE
ckoneibmjfbbb	TRUE
ckphgeejjmdcd	TRUE
dgbcldmboggbb	TRUE
dgdcgpofacdcd	TRUE
eabpipldklacd	TRUE
eacgebdemiiab	TRUE
ekcjaheohcbcd	TRUE
ekdacjpdmolcd	TRUE
fedklkdniabab	TRUE
fedlmnkombbaa	TRUE
fnnnalmbcepad	TRUE
foahecemjmbcd	TRUE
ghmipbkahbjcd	TRUE
ghnfpelnhbbbb	TRUE
hbephcffbapma	TRUE
hbfefckimddcd	TRUE
hkioehkecpdcd	TRUE
hkkfonnffbbaa	TRUE
igdjdihgcdgcd	TRUE
igfojmcdcihid	TRUE
jaiageacgejfa	TRUE
jaidaajfdccoa	TRUE
jjmncilgcldcd	TRUE
jjnmkaonfbdcd	TRUE
kciglokjaafaa	TRUE
kcjahdlnfcdge	TRUE
knanhchagmfaa	TRUE
knbfgpibbaina	TRUE
lhfdnjhahjaaa	TRUE
lhgbnfcojabab	TRUE
maccfdppbbeaa	TRUE
macoojadapfea	TRUE
mklfcnehnbbbb	TRUE
mkmlljlagebcd	TRUE
nfkfifnjpabcd	TRUE
nfkfolijbhbaa	TRUE
npleblmmbngaa	TRUE
npmbpjihahbcd	TRUE
ojnndcdbdaaaa	TRUE
okagiblbajnpb	TRUE
pfokcihcnaaaa	TRUE
pfolpnblbhebb	TRUE
aaacbdlbpoijl	FALSE
aaahibmdhjgfj	FALSE
akhnjookcpibo	FALSE
akjgabnipjkop	FALSE
bfncnbkohfcba	FALSE
bfnkkcfmmnoai	FALSE
calebfmnbgfak	FALSE
calkcjkjgeeao	FALSE
ckkcfhblpcohc	FALSE
ckkkfcmcddgld	FALSE
dgbkmleofgkfc	FALSE
dgdhbplhnhomb	FALSE
eabmkodadgphd	FALSE
eaddcjfngbgfn	FALSE
ejgmaacoaehhj	FALSE
ejhcmooobgahj	FALSE
feibijmniiapb	FALSE
feidldaecmhco	FALSE
fnkpeolfbohcc	FALSE
fnnooocniljfc	FALSE
ghpolhmlfpoja	FALSE
gidgnjliceljf	FALSE
hbhngnbggjjfm	FALSE
hbinmahbkppii	FALSE
hlhbhdpcafncf	FALSE
hlhcjephgbibp	FALSE
ifjmkokinipoi	FALSE
ifllnfggjdadn	FALSE
jafdigdgnagmd	FALSE
jafecjbcpnnhj	FALSE
jjkekflkgcbak	FALSE
jjkfmekaafaeg	FALSE
kddjobgkmhlpk	FALSE
kdendejogcoma	FALSE
knjbcbbickgnj	FALSE
knjinmbklgidf	FALSE
lgclngeeaolhk	FALSE
lgebhmfbloheg	FALSE
maalilfjeepbe	FALSE
macbhcfhhliha	FALSE
mljdmdlhhfhog	FALSE
mlklaimboehmd	FALSE
nfefpieiilnnj	FALSE
nfeipkmiomloc	FALSE
nphnfffmgaked	FALSE
npjecefohlcnh	FALSE
olkekfgoppegd	FALSE
olkkaeehmblon	FALSE
pfmpbkmlbkilp	FALSE
pfngenloplfoo	FALSE
aaaeellefhpfla	TRUE
aacjhfmghoagga	TRUE
ajilkmfemmmbcd	TRUE
ajjlbjkaholdbi	TRUE
bdefkobpgdjjaa	TRUE
bdfilhdiekkbbb	TRUE
bnlbmnmedlijbb	TRUE
bnlglapgkedaaa	TRUE
cifblkdaonnbab	TRUE
cigcciejjledcd	TRUE
ddgmkcaghgaeaa	TRUE
ddibocilocpbbb	TRUE
dmdipdoikjcdcd	TRUE
dmdkikpgfnaaaa	TRUE
efppfipncnodcd	TRUE
efppojgeeibbaa	TRUE
fabmbakkehdmla	TRUE
facfjiokaocana	TRUE
flkfmjcefckdcd	TRUE
flkkpolingaaaa	TRUE
geoaojoakdhkaa	TRUE
geopdkcmmdhocd	TRUE
gomgmdfekkaaaa	TRUE
gomjnpkhndaaaa	TRUE
hjchencaibifcd	TRUE
hjdbfcodejifcd	TRUE
idmpicfboclbaa	TRUE
idnhkgafndmbab	TRUE
ipkilgmeeiaaaa	TRUE
iplgilpcbipbaa	TRUE
jjnbmnkbaklibb	TRUE
jjnmbhgmhoibbb	TRUE
kepfpgbmopdbaa	TRUE
kepoemeijagbab	TRUE
konjdkoajdgaaa	TRUE
koomombhomhbbb	TRUE
lkdbmpdhplpbbb	TRUE
lkddagjffialaa	TRUE
mdpfjgnnbecbbb	TRUE
meaeijmecmjbab	TRUE
mnehdfkfahbkab	TRUE
mneikocaeofdcd	TRUE
ngomehgalocbab	TRUE
ngpkebefdddbaa	TRUE
oacdcacehfifid	TRUE
oaeionohjeiaaa	TRUE
olafcoalioleaa	TRUE
olahamcflfchaa	TRUE
pglepnnopfaaaa	TRUE
pgnbpglfpfdbbb	TRUE
aacfnodjalhchi	FALSE
aadodglkmblffo	FALSE
ajpcbhcmffjaif	FALSE
akakinkcpgomob	FALSE
bdbgmfhopehled	FALSE
bdbjfialnceodo	FALSE
bnffnbpoadddkd	FALSE
bnibhnnnmackdj	FALSE
cidmkadjeifiam	FALSE
cieokfjccekjmp	FALSE
dbofadoondiomc	FALSE
dbohadjpmcdipi	FALSE
dmmlahbbjafoij	FALSE
dmnlplaabakfnn	FALSE
ehciodkfagmcab	FALSE
ehcjdeiloiehog	FALSE
fafjmgbhligipm	FALSE
faiplmlepaaoke	FALSE
fkmgdgbgolopno	FALSE
fkmlgipeilckaf	FALSE
gelchmkdfdfkeg	FALSE
gemiboaeenpljl	FALSE
gookjblkjbmgif	FALSE
gooobdahbdmffc	FALSE
hijkkinhbnlamh	FALSE
hijndckgcaeble	FALSE
icfhmangcafaod	FALSE
icflpenlcjdhjd	FALSE
imigcmbkhbhbid	FALSE
imipblchegiffn	FALSE
jhbphfffjnlphj	FALSE
jhcibanhjpehag	FALSE
kbnhmffhhlhjnf	FALSE
kbnleaepdpenop	FALSE
kmcfpanemhdlha	FALSE
kmdchadkkjpdnd	FALSE
lghppcfkdnpgbk	FALSE
lgigejmpanapnc	FALSE
mbigjidkcdnbpl	FALSE
mbjfbeafbgeohg	FALSE
mmenndljonjcdf	FALSE
mmgdjagjflaagd	FALSE
nglkienpfmjjem	FALSE
ngmegponadehbl	FALSE
oablopahonpllj	FALSE
oachkofnbkojce	FALSE
olpibhgadfldig	FALSE
olpmcjcfighocc	FALSE
pfojnaohgdeehm	FALSE
pgamgnmbfbmjed	FALSE
aacfnodjakgbfga	TRUE
aadodglkmblffab	TRUE
ajpmplbocoonkgd	TRUE
akapaeepdnblhka	TRUE
bcnkmbgikonlcbb	TRUE
bcpoidobbdppgnb	TRUE
bnikglobehhonaa	TRUE
bnjhmbggjnifobb	TRUE
cibmmljbkckpfaa	TRUE
cidajmojflimkcd	TRUE
dcgkcokojiokdcd	TRUE
dchgokbgoaadjaa	TRUE
dmlpnahjioajmaa	TRUE
dmnfkalidaojcaa	TRUE
efpepeeoddjcdcd	TRUE
efppoijdeedbbbb	TRUE
fagacmkdijdoocd	TRUE
faggdfphljfaiaa	TRUE
fkbkebkhmgjcfaa	TRUE
fkchpfipfboibbb	TRUE
geijlkjdkjebbaa	TRUE
geilmoaglpclbab	TRUE
gpbjcihdcdjkpcb	TRUE
gpcjfdkihjmmjcd	TRUE
hioiadglecdldcd	TRUE
hiomhjhegmapaaa	TRUE
icjhndlcjgpeajd	TRUE
icjienmaljoebcd	TRUE
inbjjopndbnmmbb	TRUE
inbpoaeiokidaaa	TRUE
jhofeipmagelaaa	TRUE
jhpekgjdkpapbcd	TRUE
kbgklnacommnaaa	TRUE
kbibchblgcoidkb	TRUE
kllcbmjahdkpncd	TRUE
kllfefbighldbaa	TRUE
lglnmaafecgehaa	TRUE
lgnbhemlmihdbaa	TRUE
mbebmdcclbcjcgb	TRUE
mbecinafjmpnaaa	TRUE
mmhpikoboaihaaa	TRUE
mmijmdacbhmlbcd	TRUE
ngephfbjbbocdbe	TRUE
ngfcehabadfedob	TRUE
oadmjhpelockbab	TRUE
oaeipgbpfagpobo	TRUE
okndaafmjfmoeaa	TRUE
okocdkbjojafpcd	TRUE
pfkceoceicbmbaa	TRUE
pflfjgknidlcdcd	TRUE
aaahncbnmngpjkb	FALSE
aacinfipnokoolh	FALSE
akhkbkmdhcpjfpc	FALSE
akhmkcakbnfbnpj	FALSE
bepikfodofempdj	FALSE
bepjnclhhbdphbg	FALSE
cafnlejplcgpake	FALSE
caipjjdpoenbbep	FALSE
ckeinfhcmmiggfo	FALSE
ckgjilcekbhlnip	FALSE
dejhlcebofiafnf	FALSE
dekihnbekdcpkbp	FALSE
dplhoiemahjfjle	FALSE
dpmhdjienijnbib	FALSE
ejbffjjngknemna	FALSE
ejcgfgbghbkpdan	FALSE
fbodpjodolcibbk	FALSE
fbohnamlgobjnld	FALSE
flagbnocfbmocmh	FALSE
flcgbiolcbohbil	FALSE
ggphajkhinggnbc	FALSE
ggplcoakfcpjbfb	FALSE
hbkoaclkookbnbp	FALSE
hblagbeeilpeakh	FALSE
hmphegbebomimpd	FALSE
hncbemkkpncmgpn	FALSE
igmmaechajfkfpi	FALSE
igpbgbdiplgfgae	FALSE
jbmflbicnanddkh	FALSE
jbnbgjihoodkedg	FALSE
jlakeloddebbcme	FALSE
jlakkmmbfeaeije	FALSE
kfamiggdnfemiom	FALSE
kfaohpeaopibegl	FALSE
kpbfkkcoeopidfp	FALSE
kpbmboebankmkjl	FALSE
ligfconpnkljibc	FALSE
liieejbglmfajoo	FALSE
mclnkgecifhkcio	FALSE
mclpehjpeihifjn	FALSE
mndpfkdmbialaja	FALSE
mneeoggpkpdepgh	FALSE
nggiobbgnmfdhbd	FALSE
nghpopgickkjndp	FALSE
obpffdpbbejccfm	FALSE
obpnmjajaglogki	FALSE
olmdpgnidkfeiln	FALSE
olmnplgpgfeipgk	FALSE
pgibcecplhdaoke	FALSE
pgihnfehoicogkc	FALSE
aaapgmbamlpmfoij	TRUE
aacainfipnokoola	TRUE
akgikdkpdnkmcdcd	TRUE
akgplcofbedpkicd	TRUE
bfjaanoaoomfndfa	TRUE
bfkiebnpdjpkinbb	TRUE
cagddajpeckgagjd	TRUE
cagebgnpjkebficd	TRUE
cjmbblbagbbgecbo	TRUE
cjnbkocefkiipbbb	TRUE
delbdaffdjnhcbcd	TRUE
dellgfpmmmmiaaaa	TRUE
dpiilkfnkfaioaaa	TRUE
dpjlocbfmfhapaaa	TRUE
ejkgonpbnpajcaaa	TRUE
ejlcjmcbjebnifaa	TRUE
fcgcbcfijnjfedcd	TRUE
fcgdgkedgofgimcd	TRUE
fmgbnblodgilbfcb	TRUE
fmhmkdbgapmlmaaa	TRUE
gglfeknnpalnmaaa	TRUE
ggnfihklencbnbaa	TRUE
hbedflbciedechld	TRUE
hbeicmabgefidcid	TRUE
hmggkdojfafgbmab	TRUE
hmibgfmdppbdnfaa	TRUE
iibenknhekdjjbbb	TRUE
iibfdbfebcedjlcb	TRUE
jbhfndffcahlhbcd	TRUE
jbieojkpmnjcldcd	TRUE
jllmcihedoleklcd	TRUE
jllnbfpfbpmcjnaa	TRUE
kemphodooaonbgab	TRUE
kendmmkofdjebbbb	TRUE
kopdjnipjhbcmbbb	TRUE
kpajnodpmdfecdcd	TRUE
limdehahlcihpdcd	TRUE
limhahfemjbpdbaa	TRUE
mdddedejnjnmaaaa	TRUE
mddmacakagclanmb	TRUE
mncbppmlkejadaaa	TRUE
mndjlngkijdbobbb	TRUE
nhkgnankepbmahib	TRUE
nhklidkbpobhjgaa	TRUE
oblnohekoeapmbab	TRUE
obmalcjehnmdngcd	TRUE
oncgfhppabagmdob	TRUE
ondgeopkjglhaaaa	TRUE
pfoaobcppmbhpkaa	TRUE
pfpdalidnbekpoab	TRUE
aaamcihmgpbbbcei	FALSE
aaanmbbhdimkdmnf	FALSE
ajfjogfffkghaand	FALSE
ajgmdmkgeehgdill	FALSE
beijnennplpepkhn	FALSE
beijniakgjlnpmap	FALSE
bogdhajdfiobjbjg	FALSE
bogfgkpfkiejaeio	FALSE
cihkgoomncbdgnpn	FALSE
cihmahkglnjokhaf	FALSE
dclnibimlolhmdao	FALSE
dclobjhaljjlgghf	FALSE
dobmpahkbpompnop	FALSE
doceegicgadkjckb	FALSE
ehpcjiidojemjfll	FALSE
eiaaifohkihpgijp	FALSE
fbijfefmjmcpoddd	FALSE
fbikfadmpcciefga	FALSE
flpdpddlhmjlkmnk	FALSE
fmaalfejggpkkacc	FALSE
gglhnakhakpoljeh	FALSE
ggpmndkahfldnjfi	FALSE
hbmapakpnfbhnbdp	FALSE
hbmpalogeapcliih	FALSE
hmnkaekajknhndcb	FALSE
hmpdkchnncgagkbh	FALSE
ihjbipgaljeekdhn	FALSE
ihjljlblhjcipejk	FALSE
jboaadeoblonfnco	FALSE
jbocnppflnbnahpi	FALSE
jmldoifppbnlhlin	FALSE
jmleaphbpembhfim	FALSE
kgipgjpighmckfff	FALSE
kgjggcnnkkijfmbi	FALSE
lajpghaicdbjbobe	FALSE
lamoomhjlkgglfnj	FALSE
lkjbcljheedbfonf	FALSE
lkjecdammgjikkoi	FALSE
mehkcgmbbgopfpao	FALSE
mehnbaemfhfeocel	FALSE
moblkjnkcamojkgi	FALSE
modifjoejjlbppef	FALSE
nihmgloigldlafoo	FALSE
niidedfllchbjabp	FALSE
ocildfgfejeonabb	FALSE
ocjgdgnopjalcjjg	FALSE
oljmablkmdbbfgeg	FALSE
ollfijcbhljcmakg	FALSE
pfkdjdofiffmlpph	FALSE
pflccblhmddcobko	FALSE
aaakljnghkiopebla	TRUE
aadcfnncjocdoobaa	TRUE
ajalajncompojlfia	TRUE
ajbhlneefnaooaakj	TRUE
bdjmfabfbbhapopij	TRUE
bdmpmbhpbhbnklocj	TRUE
bobmecngnbjdeagbe	TRUE
bochpghicnnlmodcd	TRUE
cihhjfnbjochmnbbb	TRUE
cihjkgnlppigabdcd	TRUE
ddnhclhahkmimcaaa	TRUE
dedpkjogebpabdjbb	TRUE
dofoholcbhcdghncd	TRUE
doiiemgnigplnabcd	TRUE
ejionmpfilpijbbaa	TRUE
ejjdkfibjhcppbkaa	TRUE
fdimhmnalooebojab	TRUE
fdkfkennmddcoadcd	TRUE
fnmmcjhjdlldeapcd	TRUE
fnnmcghlkhjmljdcd	TRUE
giblfognhelffabcd	TRUE
gibomcgjnkkpgfbaa	TRUE
hclffpifkhkkojdcd	TRUE
hclgpncjmlkmohdcd	TRUE
hnjiaidogfkifaoaa	TRUE
hnmhhnhekpegebbaa	TRUE
iibliofbbfgjkgfhb	TRUE
iidiglgjndknfaaaa	TRUE
jbdgnbjkcgdgodlaa	TRUE
jbekfldepdphaobbb	TRUE
jmfmcckahgblabpgi	TRUE
jmhlkdkpbneeidbaa	TRUE
khajocnjlnkhggaaa	TRUE
khbkfbdhklojfmjbb	TRUE
lamgfgljnnlefjbcd	TRUE
lappngdedcmafpdcd	TRUE
lkjbmninmcomhcbaa	TRUE
lkljoailkddeigbab	TRUE
mempjcclhlgmadicd	TRUE
mepfnkcalfhmjbpab	TRUE
moeebhcihfmabncgd	TRUE
mogkilihnabnjffab	TRUE
nigoinnmjpblncbbb	TRUE
niibidbgnpmpihhbb	TRUE
obkmfaidcofngpdcd	TRUE
oblfhdfgjcnbmlbdb	TRUE
omdljchopkojnaaaa	TRUE
omeoaajnbpciakefa	TRUE
pflpmmchelbelebbb	TRUE
pfmehjjokochcabab	TRUE
aacbkkillegfkcoma	FALSE
aacejoldhdfomipla	FALSE
akabmfpfdekmajled	FALSE
akainjhboelmgmfpc	FALSE
bdknlnlljgbekenih	FALSE
bdldmieclbmmhidai	FALSE
bojophbheaphllhhp	FALSE
bonemkbkmpbdnicif	FALSE
ciohoninjiccfmnpm	FALSE
cjaalofnpkabfkoff	FALSE
ddklchapilkfnhdib	FALSE
ddpbhemlbpfahlhpo	FALSE
dngjjpmmdbnopbpkk	FALSE
dnicimmbkegmcgijl	FALSE
ehbpiacmmknpfjjki	FALSE
ehcliifichniaillm	FALSE
fcjkaknbjjcolgohe	FALSE
fckaelkcefhdnimjj	FALSE
fnchamebaoffjgfhm	FALSE
fndonnmgadkjnheld	FALSE
ghfcajedahpjkkcbo	FALSE
ghffagempfefoaijb	FALSE
haiccgmfpapohnmol	FALSE
haiemcnlggdnfckke	FALSE
hlndjmggggbnlpjpb	FALSE
hmacaeadppcpkfpko	FALSE
ifdjmieplmbfaknfi	FALSE
ifejgbnfalojdcjee	FALSE
ipmaggmpcbgfjciop	FALSE
ipmahbhpdfcgnjmjp	FALSE
jjifnppnaaaohjfjd	FALSE
jjiinagcejlbplfmk	FALSE
kdccbjdcajenohkoi	FALSE
kdlgkcffdcicokkfm	FALSE
kodgdppagbjejomlc	FALSE
kogeejlgggihgidfe	FALSE
ljdbngjibhdpajblf	FALSE
ljdhidcjogebpfjca	FALSE
mdodffhehdfikaihp	FALSE
mdoiiacgecdmmohbd	FALSE
mobefmmlnnbpcgljp	FALSE
mobfgllkgfpnnjalc	FALSE
nigplibblheknhlme	FALSE
nijonfghdbmmgekoc	FALSE
ocomhebeclbnkgica	FALSE
odckebhaifofnoogj	FALSE
onfkmbbjaemkonlhn	FALSE
ongajhmflfaghehjd	FALSE
pgincmmiabancanhm	FALSE
pginieanbanmjhgig	FALSE
aadmbppokdmdpjgicd	TRUE
aafbpkddgbeegfllcd	TRUE
ajjppjneefkhlnlaaa	TRUE
ajlolljddmfhglkaaa	TRUE
bdfkijpojhigbplgbb	TRUE
bdfmbneohedmbjekgb	TRUE
bnccpdbmckknlafddi	TRUE
bncjoblloeafokcfda	TRUE
chdbahnfigfampnmcd	TRUE
chdlnhpkihmghfabcd	TRUE
dbjemhnppfpiojbpbb	TRUE
dbjjfcnkgbgbbdgmia	TRUE
dmbklnpfccgiohgbaa	TRUE
dmboliocljmcplcbaa	TRUE
ehcnedmkclbdglmdck	TRUE
eheblpchdchmmhmgkd	TRUE
fbdnnmmpahfbmpbeib	TRUE
fbekadedhjlbbmplcb	TRUE
fmlafmcaojcbdkhjcd	TRUE
fmlljcneclhnbjfbbb	TRUE
ghfaphjjohmhkladaa	TRUE
ghfphdnhfiinahdaaa	TRUE
hcbapjihjhcmdmanaa	TRUE
hcbfgonfdbfmoldiaa	TRUE
hmlmnajpbbigmppmcd	TRUE
hmodomdgfafoagnoaa	TRUE
ihfkjhpigbkiobpaja	TRUE
ihflkaomphhhfdibcd	TRUE
jbaomlkhakdcbdmeaa	TRUE
jbcmamkhgfeipofbbb	TRUE
jlicdfbgnjlcnjfcfd	TRUE
jljncicdbnhkkhogcd	TRUE
kfidgfkjbojigcaaaa	TRUE
kfjghaakikjamlpgba	TRUE
kphgplfgodacgehdcd	TRUE
kpipeempcmjghehdcd	TRUE
ljbbeidbplccdefnhb	TRUE
ljbceabkhgbkdngnab	TRUE
mccjdfhhcdnbmnpdko	TRUE
mccjkpihppnfoledcd	TRUE
mmfmffeojchpeaeaaa	TRUE
mmgnllpjpimoonaaaa	TRUE
ngpbcmgnekbplhbccb	TRUE
nhaamcpibnmccdjphn	TRUE
ocipbomaniipmdiecd	TRUE
ocjinfolhkmfbkhbbb	TRUE
omlmmdgaddfpabanhb	TRUE
ommilbabiiamppjbgg	TRUE
pgejljepadijcdlocd	TRUE
pgfhmndkomdhneabcd	TRUE
aadmbppokdmdpjgihh	FALSE
aafbkddgbeegfllkeb	FALSE
ajlbldfkhalhhdpffa	FALSE
ajlmfnbkchpkncijgg	FALSE
bddnmjlgfiadkmjolo	FALSE
bdfcchooikgdigglgo	FALSE
bmkpfmiohkacjpaaej	FALSE
bmmbkejeagopkcbece	FALSE
chbmpjolmeogmajnpg	FALSE
chcibdbeiicnjnkmbm	FALSE
dbjpnfliciibjhpjem	FALSE
dblbgmdhhojcnhhnlp	FALSE
dmgiapfggpiieapmcm	FALSE
dmhdbgpdodihknoheg	FALSE
egnfooeojpgflfflkc	FALSE
egnggalgnnpeaecaph	FALSE
fbehlibcjegncbmhik	FALSE
fbidbfkjljegmliagg	FALSE
fmklinchhfenbhkcge	FALSE
fmlaeaoekojkeboapc	FALSE
ghnhhdjpfccadbbgfo	FALSE
ghnpbfocjlpmcjnbdn	FALSE
hclfgiocfkmabobfci	FALSE
hcmedhjhlgadmbjoed	FALSE
hmpgcnmlhhhmkddngo	FALSE
hnabamhlfngmdegcpi	FALSE
ihchnilgaeflcmnpan	FALSE
iheooflkckhlahegim	FALSE
japlafjbhimmejiege	FALSE
jbaoodpdgdgahfgife	FALSE
jmeglnnglhcggckpfo	FALSE
jmeiflcphkakpjnakj	FALSE
kfknoiildgeakobdek	FALSE
kflcdbefkeccpghhal	FALSE
kpeammageoebdkaemo	FALSE
kpedifkfnhkmepdbmh	FALSE
lhocaehldlecfonobb	FALSE
lhpcgooelfnmcpkdag	FALSE
mcjjagligbepchoaih	FALSE
mckcpdcheiabgjllmn	FALSE
mmedmflppfoeecjcek	FALSE
mmfkpkbpajpjflaiee	FALSE
nhkiocpgcfokehfokb	FALSE
nhklhkagfaikgabpej	FALSE
ocalkbhikngdcblimf	FALSE
occofcegffiafameag	FALSE
omjpgddbfajjfdgobm	FALSE
omjpooemeljjoblkph	FALSE
pgjkcfjkddeceagpac	FALSE
pglbjjcphdldgneono	FALSE
aaahejfbmdhkcadijke	TRUE
aabakifffkmdejlfnkb	TRUE
ajmijempgiomeajapba	TRUE
ajnbfkkileehchdnlil	TRUE
befmjomadfomojfkbab	TRUE
befnnneohjchhbgcobb	TRUE
bofoffegpgigdbnhgaa	TRUE
bohmmoghfbfdpfhdkbb	TRUE
cifgcelphgaaljobeab	TRUE
cigbnnhfgpcheefadcd	TRUE
dcdbjkoohlcgimmodnj	TRUE
dcdeglnfjgaghnfbaib	TRUE
dmhmohblepbaamhhjia	TRUE
dmiiibhbijlekinbkgb	TRUE
egdcomlnkedgdjpcdmi	TRUE
egdfolephkieeahjaaa	TRUE
fanhfmkncnmaggdfoaa	TRUE
fapdeakidldcjaojhea	TRUE
fjlcniaaablnepeiooa	TRUE
fjpkebjgimdiklilbbb	TRUE
genfblimjipjjiembbb	TRUE
genmehnhdododlgaaaa	TRUE
gpfmghkegidpnbnkbaa	TRUE
gphijohaalkfadlmbla	TRUE
hjjimoaapmfenenhpaa	TRUE
hjklacpbhinpemojecd	TRUE
idefckecliclphmbbaa	TRUE
idelihnmifekipkbbaa	TRUE
ineongcdmfiacifcecd	TRUE
infggmkpcgmkccojdcd	TRUE
jhnknmgchpkamlkddcd	TRUE
jhofpfajhmmjmfcgaaa	TRUE
kcdgkiadncpmcnjmaad	TRUE
kchdiacfklakginnddp	TRUE
kmpkahgebcpmikejjod	TRUE
knacaaolhfanniffbnb	TRUE
lhhihppaancpiolbecd	TRUE
lhhohgheiejobpjmbbb	TRUE
mdedfaoobmajjjfegob	TRUE
mdfflcppjgiakhfhbab	TRUE
mniaicikakoankdglja	TRUE
mnidaeinplbcgmgfhod	TRUE
ngbcopiapmohjppagaa	TRUE
ngbpgebanhmfcekbhfb	TRUE
oajfhhknaohpenjnaca	TRUE
oajpebnknfbbdjpohhb	TRUE
okienhjbomckojnpdcd	TRUE
okjbfkdpjpdfleafaaa	TRUE
peamblfaigheemdilkb	TRUE
peanmiaanjfoloaihcf	TRUE
aaaphomdihhndikbnfk	FALSE
aabckhoclefllfmeoip	FALSE
ajhgiclkkmlpdjabcam	FALSE
ajkjmmkkpjifaijebgj	FALSE
beonacfcpgggeingjfp	FALSE
beopkeicbpiibdmpkem	FALSE
bnoinhoaplfabaglicc	FALSE
bnommmfahpjbnnhecai	FALSE
chmihdfinpcimakioka	FALSE
chmilllkbeceffomnal	FALSE
dchgiobefgkemnddecp	FALSE
dchmlnogndmamjebigh	FALSE
dngbljbkpaehiehjobh	FALSE
dngfbplpchbbphjkkak	FALSE
ehceikhonkpklgdngjm	FALSE
ehekmgeidlamnanmmlj	FALSE
epkdjpmefgcnmmhkohj	FALSE
epkepgoapkgafpglleo	FALSE
fkmhklciebmjgckdmia	FALSE
fkmpldaebigkcegifoa	FALSE
gfiokloafgnnibjffle	FALSE
gfjajkiiodaifneonhc	FALSE
gpolelmafpngdkapdjb	FALSE
gppbpgchppilbamhjjj	FALSE
hjhbalfedhngopickdm	FALSE
hjhhjegoobcddcmiamn	FALSE
idooodbpnmckceghiac	FALSE
idpanckhmfkjeebljmd	FALSE
iojafbnilpmfickilie	FALSE
iojipcfmdfoeaaeimap	FALSE
jiljnfjhfeocologjmj	FALSE
jimfbhoadjflkckibch	FALSE
kbmbdngfkcgchdfonjp	FALSE
kbmhjblekkjfjpjhgna	FALSE
kmnlchieajadhbnooec	FALSE
kmphfpkccobidmocblj	FALSE
likfooiiboefaeeklnm	FALSE
likhkpkmemaefhnbdoo	FALSE
mcfaokobnfckhglclaf	FALSE
mcfdgomnfalfbbiloml	FALSE
mmalhjaagdopolfimgp	FALSE
mmbpcmgmlancdbifmdc	FALSE
nhbhijkmgafenegkbpb	FALSE
nhbjdkdjkknioahbghg	FALSE
oblnbacdfccmkmncepb	FALSE
obmkakbkbekkggdmgag	FALSE
olkjjliflciojjogakf	FALSE
olkjodflmheaammkbpl	FALSE
pfjnikbcjpokjehhhhk	FALSE
pfkcfickdpoojlffggm	FALSE
