aabmojbcpd	TRUE
aadgjhdcdj	TRUE
akcknmligj	TRUE
akdgfjeipc	TRUE
bemmpkcknb	TRUE
beneefogaa	TRUE
bnhefjfola	TRUE
bnhipoobdd	TRUE
chojikjlab	TRUE
chomdchhab	TRUE
dbjgmbmmcp	TRUE
dblbmgkppn	TRUE
dlkmnaolkb	TRUE
dlkodpaikc	TRUE
efmaiafofj	TRUE
efmlicaojc	TRUE
eppfejlbca	TRUE
faakelldgd	TRUE
fkpjdpjcbb	TRUE
flacagafgm	TRUE
gepadfcdbj	TRUE
gepfocflac	TRUE
gpmbpgmmid	TRUE
gpnfjeijbb	TRUE
hjfiknnoba	TRUE
hjhijpanbi	TRUE
idieaeomhb	TRUE
idjaejkhkb	TRUE
incfmhdlba	TRUE
indmmbbeao	TRUE
jhfhidkebd	TRUE
jhgplfkfaa	TRUE
kahejlejdc	TRUE
kahpefbknk	TRUE
klelpobbah	TRUE
klhenomgba	TRUE
lfnikodoac	TRUE
lfnobbodng	TRUE
maehfnjlcg	TRUE
maeiemgbdf	TRUE
mkdnnhhobd	TRUE
mkebelpjfa	TRUE
nfcohpbglb	TRUE
nfdgdpelbb	TRUE
oajpjhciho	TRUE
oakanacnbe	TRUE
omeefpkdbb	TRUE
omfjmekjab	TRUE
pfifmiolba	TRUE
pfinghdjac	TRUE
addhfhmiff	FALSE
addjmmenhi	FALSE
almjgmljhg	FALSE
almmnjkdkf	FALSE
bgefkpfkec	FALSE
bgfcnlkfmm	FALSE
bolipoehfl	FALSE
bolnngfpij	FALSE
cifmjpdlih	FALSE
cigbfjochj	FALSE
dbhkihjmgo	FALSE
dbhncgmfci	FALSE
dlakengjef	FALSE
dlccojlpmm	FALSE
efhfofebcc	FALSE
efhmfkkaph	FALSE
eppmpbefll	FALSE
fadoinfpfl	FALSE
flbjfminkj	FALSE
flbninoghn	FALSE
gfgonmcali	FALSE
gfiaemjhff	FALSE
gplonkbmlg	FALSE
gpmkaekogf	FALSE
hjifppdphd	FALSE
hjihkgpfjm	FALSE
idipdionkf	FALSE
idkdcmlemf	FALSE
imkpjfmfko	FALSE
imlobomkgp	FALSE
jgpebfpkhl	FALSE
jgpgcdehoc	FALSE
kakgkohegl	FALSE
kakldmkmif	FALSE
klbihcmfkj	FALSE
klbnjfnmff	FALSE
lgdhmbpjkn	FALSE
lgdpfnaeld	FALSE
majglpgooe	FALSE
majhelhlkm	FALSE
mkhmjadepf	FALSE
mkiepnjbfi	FALSE
nfdkmileaf	FALSE
nfdnhlpnla	FALSE
oamglgpnof	FALSE
oamonokmlo	FALSE
olgmmonhhp	FALSE
olhbgegfhf	FALSE
pgblnokfkp	FALSE
pgblpglkfc	FALSE
aabdcdffebe	TRUE
aadefhginml	TRUE
akakjcacnah	TRUE
akbajkjehlb	TRUE
bekedhhciof	TRUE
belgghbdedk	TRUE
bpddomoknda	TRUE
bpgfgkoicaa	TRUE
cjhekbmoaaa	TRUE
cjhpknihlba	TRUE
dckhbjgejjd	TRUE
dckkoiagbhd	TRUE
dneemaplhdb	TRUE
dnfdcihphac	TRUE
eidmflapfec	TRUE
eieamiamldc	TRUE
fbkcknbijoa	TRUE
fbladhgpmae	TRUE
fmdpammahff	TRUE
fmeemkokafc	TRUE
ggjkdngaegb	TRUE
ggjllcfdibb	TRUE
hajfkbbmnkf	TRUE
hamigkeegjb	TRUE
hkaejllfpma	TRUE
hkaonjkgepc	TRUE
idfokopbkhb	TRUE
idhdfnfhgac	TRUE
inmhnaakpch	TRUE
innadiejafc	TRUE
jhhonkfihab	TRUE
jhjidkbghjb	TRUE
kbahklllgha	TRUE
kbammcilbge	TRUE
klbaandjljj	TRUE
klcdfknfhbd	TRUE
lfmllhfohab	TRUE
lfnmbjbmocp	TRUE
lpmckbcaeoe	TRUE
lpojmollhaa	TRUE
mjoajleglgb	TRUE
mjocghoialc	TRUE
nebpcfjgoam	TRUE
necekilokab	TRUE
nofgfimmobb	TRUE
nohlflbcjha	TRUE
ojngnleigbb	TRUE
ojobhjpmhea	TRUE
peecmjhllbb	TRUE
peenbebmjpe	TRUE
addpmidjfio	FALSE
adfdjldppkm	FALSE
alhogfkohkl	FALSE
alijpdlgikm	FALSE
bhgnfkfmkkk	FALSE
bhhhpipkmlo	FALSE
bpihflopmmg	FALSE
bpilleooeee	FALSE
cigpboeeiko	FALSE
cihlchmoilm	FALSE
dchihgnjojf	FALSE
dckbipfhegi	FALSE
dnlmibllkno	FALSE
dnobcjghpom	FALSE
ehjjbfegekh	FALSE
ehllejcfmnd	FALSE
fbegjejfcnh	FALSE
fbeimmfkclm	FALSE
fmdgfmoopah	FALSE
fmdgkokdpeb	FALSE
gghppcdkmoo	FALSE
ggifgpjpmjb	FALSE
halefmhojdj	FALSE
halkgjpkepp	FALSE
hkokoifiddc	FALSE
hkpifkhldkm	FALSE
iedbchfpgjm	FALSE
iedfpbjeimg	FALSE
innnngcmpob	FALSE
inpeakgemgl	FALSE
jgpcbpehefk	FALSE
jhdddkgmbem	FALSE
kbkngifgcjm	FALSE
kblejolkhig	FALSE
kliimcaegkf	FALSE
kliphchplfa	FALSE
lgcdjoedlom	FALSE
lgcfedliobc	FALSE
lpnhjjnhedp	FALSE
lpogamijehj	FALSE
mkbpilleiil	FALSE
mkcnfjalgdo	FALSE
ndomemdpmlf	FALSE
ndpbioimlkh	FALSE
noleddhhpfk	FALSE
nonpnbncjln	FALSE
ojhjfcalkhi	FALSE
ojjcmbmfkcl	FALSE
pelakljlggp	FALSE
pemeamhpfij	FALSE
aaagmjbkalnc	TRUE
aaamhflgabfi	TRUE
aleodnnlbajj	TRUE
alfohnaggmkp	TRUE
beojbkagdacc	TRUE
bepncmjfpeca	TRUE
bpblfjdaaoml	TRUE
bpcaoihhidii	TRUE
ckgkaamafhen	TRUE
ckgmchjpomaa	TRUE
deklbmbhnmkn	TRUE
dekmocmielba	TRUE
dodjdcelmfbb	TRUE
doefcekbdcfb	TRUE
ehkncgbdikfk	TRUE
ehnfhihdjnbd	TRUE
fbbddollajhh	TRUE
fbbhlilenenl	TRUE
fkdbjepbhaab	TRUE
fkddommombdb	TRUE
gefnipkhgibd	TRUE
gefokggjcjbb	TRUE
gojndaoofhpa	TRUE
gokkiamhghcl	TRUE
hjfhbmdoachk	TRUE
hjggfhhipibb	TRUE
iddpcoancagd	TRUE
idejkonilbpd	TRUE
ioabbeolojfh	TRUE
iocfmhmphnaa	TRUE
jjedcebogodc	TRUE
jjhhkakaeenc	TRUE
kdldeabdobgi	TRUE
kdmfamnkpfdc	TRUE
knhhogelgebb	TRUE
knihbfkgkina	TRUE
ljckpkjdjjac	TRUE
ljdhgfdchoab	TRUE
meceaakfdeml	TRUE
mecnlgokdcba	TRUE
moccjkbhjkib	TRUE
moechdoggfba	TRUE
nhmmnfcnohab	TRUE
nhmnipakgiba	TRUE
obihjikjpbnm	TRUE
obiiccfkcjjb	TRUE
okonegojplba	TRUE
okooajaoefce	TRUE
pfbjpnjimnod	TRUE
pfcloljgpdbb	TRUE
addiemfknedp	FALSE
addogmjngmmj	FALSE
amfhkhnkdhnj	FALSE
amfkimdminoe	FALSE
bgmhllfjjclp	FALSE
bgmjfhoejmmj	FALSE
bpfocjnehcmf	FALSE
bphpngglmgih	FALSE
ckkkfdiekcjj	FALSE
cklnccfpamhd	FALSE
ddnhoafllfkl	FALSE
ddogimpogglh	FALSE
dofdakojgehm	FALSE
dofnopolkdge	FALSE
ehcgjffnncdf	FALSE
ehclhnmecnpf	FALSE
fbhpmmihnoml	FALSE
fbigohpgohlo	FALSE
fkmjhdegmbel	FALSE
fknahjifpnfe	FALSE
geembeelilll	FALSE
gefahidmpfgj	FALSE
gnngfoffpjcp	FALSE
gnnigkkbngik	FALSE
hinoajodmndf	FALSE
hiofegpkikhd	FALSE
idllbmffglni	FALSE
idmmdfhiepem	FALSE
ioiingcjadmi	FALSE
ioikpbgkpphk	FALSE
jipohenggljh	FALSE
jjakplndkfmi	FALSE
kdefmnejcaon	FALSE
kdelphildlci	FALSE
kngehafhhllf	FALSE
knghkioeajng	FALSE
liffmkdpmdpe	FALSE
lihajlhkdeel	FALSE
mddnkndpkdnd	FALSE
mdfgpjnaflng	FALSE
mnmaejjimkhe	FALSE
mnngcanmmhjg	FALSE
niinokldghag	FALSE
nikgggkohkgm	FALSE
obimihooncho	FALSE
objlogegcjgk	FALSE
oknemmmoaood	FALSE
oknjijgiobmh	FALSE
pfgfkpceailf	FALSE
pfghfhfbmohp	FALSE
aaagmjbkalncn	TRUE
aaamflgabfidf	TRUE
algfelpdcbhif	TRUE
algfmhlljkncb	TRUE
bfokiamaihlni	TRUE
bfophkokcmocd	TRUE
bopflmgcmfaio	TRUE
bopnmecjhilbh	TRUE
ckebbbmhjacgl	TRUE
ckemgfofmfdba	TRUE
dfdinnljnnbob	TRUE
dfdoolioomaga	TRUE
dnlhhbgmlgkak	TRUE
dnmbmbkdligka	TRUE
ehlefljekafco	TRUE
ehlideologbga	TRUE
faoafdlinoogj	TRUE
faoefbgjeinhp	TRUE
fmgniehfckhbb	TRUE
fmgoambnipkjd	TRUE
gdongjinbneed	TRUE
gdonmddapffjc	TRUE
goekfmfkjimbd	TRUE
goialacmogpii	TRUE
hjhpcdmgnipac	TRUE
hjifoejdfmgbb	TRUE
idmlodppaiokb	TRUE
idnakinllpdmb	TRUE
ioegnmbhijbcg	TRUE
ioeogpnmlnhba	TRUE
jjgokmkhgljbb	TRUE
jjhbandmoecjm	TRUE
kcpeonkdnifaa	TRUE
kdapdamgdmcla	TRUE
knfcbhliahglo	TRUE
knfneagdcmcdk	TRUE
ljddlccjdapkc	TRUE
ljdjihfecdnab	TRUE
mdimneceocoba	TRUE
mdjfbalhfdbni	TRUE
mnflceheojlab	TRUE
mngdagenpjaen	TRUE
nhhhbladcplal	TRUE
nhkonnillfhaa	TRUE
oblhnnpcablcl	TRUE
obmoglnmajjnb	TRUE
okohlnebaaalh	TRUE
okomephkggfac	TRUE
pfacaolebbeca	TRUE
pfalfpifmdofa	TRUE
addfijdfgfmlh	FALSE
adefipinlpkoh	FALSE
amopenfkmmkpk	FALSE
aneeofnphmdfp	FALSE
bimikpmjiimkn	FALSE
bineklpjmhonm	FALSE
cbficmocghcfk	FALSE
cbfpihgkhkceg	FALSE
cmgecalkllgfh	FALSE
cmgnghmebglmn	FALSE
dgdbpglggeogp	FALSE
dgdncjdkdbimi	FALSE
eanpgkigijfnl	FALSE
eanpkmijddggi	FALSE
ekcpcpodjdjbo	FALSE
ekdadohfdfpji	FALSE
fdhagmjpjdomi	FALSE
fdigpdfdhbcpn	FALSE
fmpbhfpimcmlp	FALSE
fmpibfkohecil	FALSE
ggokenfbifiho	FALSE
ggpoglagpmngm	FALSE
hadhfkngfoehi	FALSE
haeilhppgnkmm	FALSE
hkeodampejolo	FALSE
hkfmmmehmidnn	FALSE
ifebnhkhgmhki	FALSE
iffkenhncbjcl	FALSE
ipbjjniphhhmm	FALSE
ipcpejcnmcbej	FALSE
jjadmomlfgfkp	FALSE
jjaklhfinnjjl	FALSE
kcfgihpclhiid	FALSE
kcfhdbmegniop	FALSE
kmimfbehohegk	FALSE
kmjenjbggepoi	FALSE
lfphmfkiegfgo	FALSE
lfpiciechadko	FALSE
lpmgeheboimcg	FALSE
lpnonknncbegj	FALSE
mklnfbklmkfnl	FALSE
mklnlgolojgfm	FALSE
nfnklkledoeol	FALSE
nfogjmajgipem	FALSE
oapmkieljkppp	FALSE
obccplgigiplg	FALSE
okmdmlgpgmmfm	FALSE
okmfelahgmodk	FALSE
pgecljbfegmgi	FALSE
pgehonenoflal	FALSE
aabieemalbjgmf	TRUE
aacadnmoalgohi	TRUE
alkihcbehpflpb	TRUE
almmjhimjmpdkb	TRUE
bhanakaklcgnbi	TRUE
bhappilogbgaab	TRUE
caophdpecmghda	TRUE
capcfjaimmknih	TRUE
cmgdjnackogfio	TRUE
cmgnhglfcdbfga	TRUE
dgeifgbfgkhadm	TRUE
dgfemlilgpofba	TRUE
eaglhknnippfja	TRUE
eaimmjghahgoog	TRUE
ekbhkhelbjobfg	TRUE
ekbjcgkkjknnpd	TRUE
fclccbgicgoepd	TRUE
fclkbddnkcnhge	TRUE
flmombnedahhma	TRUE
flneflnehhbfdo	TRUE
gfohloekgfaekc	TRUE
gfopnoiknjfbid	TRUE
hacjkidfgifimi	TRUE
hackefbkhkfpkm	TRUE
hkecgjiooaobjh	TRUE
hkemdhecaedbep	TRUE
iefdahdboblnin	TRUE
iefllenhbnbklp	TRUE
ipcocelipokobb	TRUE
ipdieedighnhaa	TRUE
jijpjbhhlfikcd	TRUE
jilnmlddmccjaa	TRUE
kcokfehgpnlpaa	TRUE
kcpaacjmaoneml	TRUE
kmhaegaaepocac	TRUE
kmheleoofmkfaa	TRUE
lgfaogbbabiegd	TRUE
lgfoifmjmmpeba	TRUE
lpnibojklmafli	TRUE
lpogaclamooagf	TRUE
mkgnbnbkkdogdb	TRUE
mkhghgcjfoddba	TRUE
ngideckahkghic	TRUE
ngidgpjmbchfdm	TRUE
obeednfdldbpop	TRUE
obfakbioabnpik	TRUE
oladnliadddlnm	TRUE
olaihkapbabmel	TRUE
pfmedbnmdnnaeo	TRUE
pfnmcinkoaidja	TRUE
addiejenfgjfnf	FALSE
adeomkfggkfjed	FALSE
aloinejpmhnnkk	FALSE
alpfpljjfkepkp	FALSE
bgicfichielpkp	FALSE
bgiljnkinjlmjk	FALSE
bopeoopkjojjni	FALSE
bopkempmfjggfp	FALSE
cjlgifogiblljg	FALSE
cjlllajofidhpm	FALSE
dejdckbcojcoee	FALSE
dejjkngikjcgll	FALSE
doipojianoeldi	FALSE
dojdomemhemicb	FALSE
eiddmjeknallnk	FALSE
eieinkddipkbho	FALSE
fdcojhogohmfal	FALSE
fddbeefgkliooe	FALSE
fnamgfinimjpmd	FALSE
fnchankilnpjjl	FALSE
ghkcfakmgfgpkf	FALSE
ghkggibnjojfho	FALSE
haojlfendhppef	FALSE
hapdmkjhlfieen	FALSE
hmhamgggpjnemo	FALSE
hmhebjkjejmeme	FALSE
ifjoijjlcfhobp	FALSE
ifkccinkifipdl	FALSE
ioipmblffnhgfm	FALSE
iojfdkiefkghdd	FALSE
jjajoonfihkpfk	FALSE
jjbphmpjoimjgj	FALSE
kdkajkhjlggfoh	FALSE
kdljlpnlncahmf	FALSE
kmohngnajkmoif	FALSE
kmoonagpmhgden	FALSE
liajmfhjphfgff	FALSE
lialjhppkkjmef	FALSE
mcglfgdpfhhmil	FALSE
mcgmgnepfijfao	FALSE
mnfggdlfdkojnk	FALSE
mnfkpiebnnhfpo	FALSE
nhjgcpapgjhikj	FALSE
nhjmjnlealhifl	FALSE
objlppcfnjjmjk	FALSE
objoflcoeghjnp	FALSE
olmbolofhchghl	FALSE
ololgifkjmoihi	FALSE
pghhemgaedgfim	FALSE
pgicngainegdnn	FALSE
aaaehbdfjcelfoa	TRUE
aaaelabjbeginjk	TRUE
akmbckmpkmhjild	TRUE
akmhmifjfeknpoc	TRUE
bfpmddjibfdddei	TRUE
bfpmhnjncelfelb	TRUE
bolggciffehjgfa	TRUE
bonddebmdoaofki	TRUE
ckgkpefjblhgkkd	TRUE
ckhcblnidilkkpc	TRUE
degmcemkobghahf	TRUE
degnegopoompoaa	TRUE
dohecgdcjdgpibb	TRUE
dohllppmmhiknac	TRUE
eiplejhijojbjna	TRUE
ejacjeeeffbjicp	TRUE
fdhgclgnfpkmnac	TRUE
fdilbplldmfjldj	TRUE
foafjodhmannpok	TRUE
foagnjcfonbfoii	TRUE
ghnciidanadijcp	TRUE
ghnidpgjaiachjl	TRUE
hakjmijdhhkehha	TRUE
haklnkgfpgmnmma	TRUE
hliehjdonflnjbd	TRUE
hlilhpjbdlilgbp	TRUE
igbinegfkckckbf	TRUE
igbmdjfgofglnjp	TRUE
ipcomnjaiangkpn	TRUE
ipdgcicommmdeac	TRUE
jipadeehnmpddoa	TRUE
jipkmiefhghagha	TRUE
kdadpokkofmcafp	TRUE
kdafpoakcolkphc	TRUE
knjbnolanljkocp	TRUE
knjdnnpgaokhhab	TRUE
lhpepjnibjbeiea	TRUE
licfbgnlkamheah	TRUE
mcnkfamminjjfea	TRUE
mcnnjpkimnniana	TRUE
mnlnpobgbhjbopg	TRUE
mnmdofjnaochjjl	TRUE
ngjdnnpccjhccab	TRUE
ngkhglenkdnkajb	TRUE
ocdebakjidpeadj	TRUE
ocdhgaooommpaoe	TRUE
omdlmmiahdodpja	TRUE
omeggafpihdpmnc	TRUE
pgoegnpmdaihdgb	TRUE
phaacpccnknlabb	TRUE
addoieliplnfdkn	FALSE
adeghfgefkifkpg	FALSE
akkkjdgkllklngi	FALSE
akldnnhpngjijdj	FALSE
bgeghooegkimfmh	FALSE
bgfppmnhmchhkln	FALSE
bokfcmnolglljll	FALSE
bokfjfefmchofhg	FALSE
chefamminlfpdik	FALSE
chflokfjdecddlo	FALSE
dchjnidlmhjmakd	FALSE
dchlbmefeohhlgf	FALSE
dmahnlnllhpjddj	FALSE
dmakhmegmndnhhp	FALSE
efjfjgifgalongp	FALSE
efkdapplojijjld	FALSE
epnkmjlhikhglef	FALSE
epofmohcgmhccip	FALSE
fkgfflagpnleodm	FALSE
fkgiaeneplgjoil	FALSE
gemibnpojgkhchi	FALSE
gempiaolifglkgg	FALSE
gonnfjmeglcaikj	FALSE
googjeoahpmmiih	FALSE
hkdccnopimcbijg	FALSE
hkdgokdcadpedoo	FALSE
idofodcjmpnmfgm	FALSE
ieciljeclahppfe	FALSE
injhhjpkkgdfejb	FALSE
injkodkfhcfgmnd	FALSE
jhooimnbffikigp	FALSE
jhpegomhokhidna	FALSE
kcdpkmehnbjjgpl	FALSE
kcefiibocgcjllf	FALSE
knafigehjdfikno	FALSE
kncfbelcgghkhio	FALSE
lhhkmamhnpifnnl	FALSE
lhijaneolemmmjn	FALSE
mblopejmicmikmj	FALSE
mbminhgnfhnpkpo	FALSE
mmkpgjplokkcalm	FALSE
mmlgcmffmailfdg	FALSE
nghmmhoncnnlngg	FALSE
ngjddebnpngliek	FALSE
obiijlhjjhgimpc	FALSE
obikekfklgfljnc	FALSE
okhbfgfjgmkfmoh	FALSE
okhgeebjlmoohni	FALSE
pfdhhioffemjcnj	FALSE
pfedomkbogoiknl	FALSE
aaahmffibjeplohf	TRUE
aaajfckigggeipak	TRUE
ajpoibhmfpbpohkc	TRUE
akcdlpafpljajnoe	TRUE
bdmabdemiaibndif	TRUE
bdmobedkgmneobeo	TRUE
bopimaopglkibagm	TRUE
bpbchnpebkifhhog	TRUE
cifdgmdknanlifnb	TRUE
ciffoklfkdcjgeaa	TRUE
dcjlhkjfoafoibag	TRUE
dcjmhbggjjenaaeg	TRUE
dmdoemomhifdcnba	TRUE
dmepegkhaglfdgob	TRUE
eeihdbfelgjkppeb	TRUE
eeikimacdknbckbf	TRUE
enpmekjabcgakiaj	TRUE
enpnilffpnedeiba	TRUE
fjhghacgnnkiimbf	TRUE
fjidpdkkckijdlba	TRUE
geeilgcghbnfjgia	TRUE
gegakggnflmkklmb	TRUE
gpdmffhhbbnjgoph	TRUE
gpegpkgbhdgnaapn	TRUE
hijpcniogdlfpdbd	TRUE
hikacmgejmlfacan	TRUE
ibihhgfomllooeib	TRUE
ibjgaamndijfgfke	TRUE
imbegbjladmjhpbb	TRUE
imcapidifmalpmna	TRUE
jfjhfaopibehpohj	TRUE
jflgaleeallnmbea	TRUE
kbgdcocpgkeodfkc	TRUE
kbgdojbikfjfomkm	TRUE
klhgmcllcaopdeaa	TRUE
klhoijedmjejehbb	TRUE
lhbiefjonehmicam	TRUE
lhcigpaceiikmpoe	TRUE
mbgdfljlabbkbmje	TRUE
mbglndhegnhjjbne	TRUE
mljdakmbdffhkmji	TRUE
mljpmcphenmponaa	TRUE
nfhckildhjodkmab	TRUE
nfhiclfbdapndfna	TRUE
npflapfakogbdmhe	TRUE
npfpiedingajimmb	TRUE
okjkfgkagmbannjk	TRUE
okkdkolokghddcab	TRUE
pfbdamibpjjfhpde	TRUE
pfbimmidoekpmidi	TRUE
addfhomejmhidjed	FALSE
addjfheoeijnfnkp	FALSE
alffogjolikjinnh	FALSE
alfhmngdhihflkmf	FALSE
bhehfimecpcjkgkj	FALSE
bhekpolfkpkeoocc	FALSE
bphigonnjlhfmcfl	FALSE
bphleokjlifnklkp	FALSE
ciklmghppibimgel	FALSE
cilaokkdgioeghlg	FALSE
dbnlfcmkijhojpce	FALSE
dbnlmnljhchhpchj	FALSE
dmgneagenhpkpkpj	FALSE
dmhbonnjoppkmpho	FALSE
efaklheddlhmifgf	FALSE
efcampihlnipfipo	FALSE
eoglgojmlnljppje	FALSE
eognpmdbogofcefh	FALSE
fimejaddglojeofj	FALSE
finhdemghhaoomkj	FALSE
geeahpnhdengjmif	FALSE
geegbjlnhnnihfmg	FALSE
gojmnepmkmkmhpma	FALSE
gokemlaikdiehkgn	FALSE
hifiokhcconmghkd	FALSE
higconcklogmhdpd	FALSE
iblpkgkikogecjog	FALSE
ibmcmiicikgmljhl	FALSE
imadhgpfgoipflje	FALSE
imaenjpfhdeepmjj	FALSE
jhaphglglgledojf	FALSE
jhbfnkojphikmppg	FALSE
kbmmclgfmpnmccgl	FALSE
kbmnfnlclmcinpej	FALSE
klibhnngpilelcif	FALSE
kliemgjiingdcbmi	FALSE
lgfoicnjpbjjmhpp	FALSE
lgggcchapljekigl	FALSE
mbjgpgllnlflepml	FALSE
mbjkgfmnihoohmcf	FALSE
mldpmjhlnjcjidoi	FALSE
mleljggomoeifbke	FALSE
nfcnellafnhmpijl	FALSE
nfecdkcbphgfplkg	FALSE
npegilkcpdnjmhhk	FALSE
npeijfimhblejiom	FALSE
okapdeodglgiplfp	FALSE
okbokpjkinigkpfo	FALSE
pfcafinnminkhioi	FALSE
pfebpjfnhgligegg	FALSE
aaaaajghndamdkjae	TRUE
aaakokbfienoaeajl	TRUE
akpfdeflbbnnjhfok	TRUE
alaagefcpancklbbf	TRUE
bfinmmcpkgeckmgac	TRUE
bfjilglohiomhdngc	TRUE
boofncdgkogdompjc	TRUE
bpbddifkjgnjgcdfk	TRUE
cibhddgeojcglpimg	TRUE
cicnejbodnnpophhf	TRUE
dcclmdcfhaimidoha	TRUE
dcfpgninlnljobgnb	TRUE
dmeljpplaaceiingp	TRUE
dmfbcpkdejngkhnlg	TRUE
ehbmnmhbdeplkkakp	TRUE
ehcaaieeomemncjli	TRUE
fcacnohmcnbkfpled	TRUE
fcadjjcnngnoepajk	TRUE
fmpjgmkgmaodpmahl	TRUE
fmpmamoanjkipcofp	TRUE
ggbiipgkighkblhdm	TRUE
ggcblfnkdgkgaeggc	TRUE
gpiacdnndmmcphoia	TRUE
gplfeepgphphnkfac	TRUE
hjjmkbndjagkcipmg	TRUE
hjjofbhkaidlgophp	TRUE
idflicjlllpknbkhd	TRUE
idfoikeecgdihknbb	TRUE
iocicfnijlmfponba	TRUE
iodbgpnfjfgdenoga	TRUE
jikamocaoedphnloo	TRUE
jilcjhfgpginnlbaa	TRUE
kcnldnadglfalknbk	TRUE
kcofhhkhpeaepeoob	TRUE
kndlfmbclaipnenko	TRUE
kngfmmeimbbleplpe	TRUE
ljklkbnpkkchdfjhg	TRUE
ljlejjkjjcfgnhgbd	TRUE
mdngfcpdolloocbob	TRUE
mdobjlincmionabmj	TRUE
moenlmkphonjahdbm	TRUE
mofiikggejdkokobb	TRUE
nhgpdphpnkecnkdab	TRUE
nhgpkijghjnnfclaa	TRUE
obmgonfciocfjemnb	TRUE
obncmmccbbkmcabpn	TRUE
olleaipkgcljjlfbp	TRUE
ollmdaigjinichfli	TRUE
pgcboimeholebmnce	TRUE
pgccdoeafeifgafci	TRUE
addkieiifgkplijkp	FALSE
addmeinhfihljnnpe	FALSE
algkkmkihlkhdkonl	FALSE
algoljghhinoghjne	FALSE
bgjojpegpffnlpmlj	FALSE
bgkffghllmkloglpo	FALSE
bomgklinnmoeecpof	FALSE
bonhnjgmfcemhojpk	FALSE
cilcadjjnlfeddngg	FALSE
cilpphkphllicgllb	FALSE
dbpinpchfomkimhjo	FALSE
dbpjoihhoeinohflh	FALSE
dllidbefcokfgmpjj	FALSE
dlmddpkhciokjpbep	FALSE
efajjliohfdmompil	FALSE
efapppelinionlngh	FALSE
epngokelidghljkem	FALSE
epnldjihncbfcigpp	FALSE
fjlieaeohpdgpigdj	FALSE
fjmcdldjpcjkfgplk	FALSE
gdnfigfkpdgmebion	FALSE
gdnnakonhhmlphkfe	FALSE
gobplkccmhljmigpj	FALSE
gobpmfgipjjklogji	FALSE
hhmojajklhkndojeg	FALSE
hhninnnogcecmbemi	FALSE
icfcngjfkeedmjonj	FALSE
icfdgedjnccgfkkmk	FALSE
imjfjbglkmjkjcpcg	FALSE
imkcaeiijknllkeil	FALSE
jfkngmemkgplfgbhj	FALSE
jfmckfcopjnalhknm	FALSE
kaeplkfhgfoleggnh	FALSE
kahgneoogpegoookm	FALSE
kkpgphiogakepehek	FALSE
klbecgggllefmenkf	FALSE
lfajiimpeikodmdhe	FALSE
lfcipiiljcehnlgeg	FALSE
lpefpnohbejjcfgnl	FALSE
lpehceejojgojadgd	FALSE
mingopelbknkfpmej	FALSE
minlaeljllghhopoi	FALSE
ndmhmhgigjkdhmole	FALSE
ndmnniifapminniji	FALSE
nokjomepfclmfkfgm	FALSE
nonapmpnefhkmhdfe	FALSE
ojamheleongldddeo	FALSE
ojcihajingnpenogk	FALSE
pejkbkjfeefnjlilm	FALSE
pejmfhdohcjkhbcmg	FALSE
aaaflcjieingkibmgf	TRUE
aaapedhichdimkbfkd	TRUE
akcikcbfmloignhobp	TRUE
akcmeijebeiehkjcgi	TRUE
befcccifhmnfbleged	TRUE
befeodmfjcghhodhmh	TRUE
boebpnmoinlilmogil	TRUE
boelllcmfpnclflldf	TRUE
ciflkikgioffnpbjha	TRUE
cihmopgkakiimojnob	TRUE
dblbmmfliinobpplgj	TRUE
dblipnpfeckobfaddh	TRUE
dkapckffmpcefbjjpl	TRUE
dkbigapclbglckekho	TRUE
edpplijjjnefcfipab	TRUE
eedaflmapmljanekib	TRUE
epldipmmpkohlgpbjd	TRUE
eplldicjbleeaelfdi	TRUE
fkdbjfbekmndpknibo	TRUE
fkddgmfojfkedcmmba	TRUE
gdgppfdnlkjblknngd	TRUE
gdjmjffchmccpafkfb	TRUE
gnddbpampepfgencem	TRUE
gndehcmgllilbmhhpd	TRUE
hhkdgddanlmfnhacon	TRUE
hhkikkgdnfgfbllobm	TRUE
ibpioioeckjpfjfped	TRUE
icadcoaodlooiiifph	TRUE
ilmkgipigmoomdpeac	TRUE
ilnjjimehgaokoigoa	TRUE
jgbhalmjgaphiimkge	TRUE
jgbiahgbeenbclohof	TRUE
kadodmeahnimfjgfon	TRUE
kaepfdpcnlfjifjmbp	TRUE
kkjnmmbcdognioelmf	TRUE
kklghgghgimjchklbb	TRUE
lepfakbonhadommjgb	TRUE
lepmagnhikhlfhnmha	TRUE
lpcnkpaoeojgdcgjed	TRUE
lpdgbbgbabigbcifgd	TRUE
mjiiafjhaklocmoaic	TRUE
mjilbafplkhaffmokm	TRUE
nedcfbfbcnfcbipfdb	TRUE
nedmiablmpnhahiamk	TRUE
nojfclohompjjpepaa	TRUE
nojklfpphhhamkpkhc	TRUE
okcaacmldaeedimlfo	TRUE
okcacgbhobibognkoi	TRUE
pejmkockblcjflnkhd	TRUE
pelalbmcpdangkalje	TRUE
adddhnjohpdkoigogm	FALSE
addggnnnngfhjlejfi	FALSE
almgmhjjlihnmlhdjn	FALSE
almhdhohdhgelkeijg	FALSE
bgohigknmilefijpoo	FALSE
bgpfkigolclegolmje	FALSE
bphljlklolfcnomple	FALSE
bphmjhiplnknccojck	FALSE
cjkjpplicfmkhaggmp	FALSE
cjlgkhkgeibejpjkee	FALSE
dfdeifdopngifkpmcb	FALSE
dfdodjefcblghoepjp	FALSE
eaikkehnidjplenlfn	FALSE
eaimohhpokjmdpmmed	FALSE
elikklahmkikkpfkpg	FALSE
eljjnjfaeigdfdhhjm	FALSE
fendbnmnffmmigfhoi	FALSE
fenmbcffknnfceikjg	FALSE
fomeonhcenodggloak	FALSE
fonljipjoipeoddhcg	FALSE
gjikflccpkgpphncel	FALSE
gjipmealopogkmoogg	FALSE
hdmamkdddfeohgkjik	FALSE
hdmnbcoihgkciejcnc	FALSE
hoolccdpdimmliamjg	FALSE
hooniafhikejfffifn	FALSE
ihkolhkchampogpelj	FALSE
ihmfhpllbhnlipkhmn	FALSE
jbmomilhjkmfocjgeh	FALSE
jbngggpfgpcjpjipch	FALSE
jmjoingmnalhgfmhij	FALSE
jmkdgoghlpilegnmhb	FALSE
kgbioehlhojifnlkhn	FALSE
kgbppifjhelnnhpnoc	FALSE
lafjeihnhgklklephp	FALSE
lafkmiodomoggopnki	FALSE
lkcflpoglmobhhofoc	FALSE
lkehflmmpaeedjhndk	FALSE
mdipmaklgpkmdppmmh	FALSE
mdjcgffibfkoooinpk	FALSE
mmhmblejknmgnmgehk	FALSE
mmhodhccehiapjdodn	FALSE
nhgefdgcnppdcncadf	FALSE
nhhdahdlignhkkkdkd	FALSE
obkmooflncpicfeipf	FALSE
obmcoighnjmkhmpmef	FALSE
omgnniipjbolihnnmn	FALSE
omgnnimbocmkhkmgoi	FALSE
pgbfpejppckmjieogg	FALSE
pgchpoodnbilmmjflf	FALSE
aaambejhficmphclimj	TRUE
aadgdlhegpnnobfklmk	TRUE
akhhbdmmjfjfoebfjie	TRUE
akjlbjmdclgamjfajkb	TRUE
begihbjlmkhnahbikme	TRUE
beiapbcpolcpnndpjlc	TRUE
bohhklpecncohekciag	TRUE
bokhkdmbcfmbpaojjfm	TRUE
cklbapnnjhpphgeajjl	TRUE
cklfjnegigokghbdcge	TRUE
deflhckapdndingodgb	TRUE
deihknmmcadfcdhigec	TRUE
eaefeifdhjhiccbcdcn	TRUE
eaggmoaciefamnmbind	TRUE
ekiafhkbgdnmpbpmlmn	TRUE
ekififdjpjlhenjlbfa	TRUE
fempgbabhmdhopfeabf	TRUE
femphfdmnehighhekac	TRUE
foejhkpgkimmjgpojba	TRUE
fogdndpmdepnideadlc	TRUE
gijodgofgamdcjnhahd	TRUE
gikdmkchpokacjcaocf	TRUE
hdbaecblmefpcieojfl	TRUE
hdbajinjbbkpjdepggb	TRUE
hmnkocdkbgmblejfgad	TRUE
hmojclonnfkclcmjgaa	TRUE
igmdpomeaomahngfcff	TRUE
igmmgomciioclkjbmfd	TRUE
jadlaoefalaokbkofdf	TRUE
jaeffifeebfdncmimmo	TRUE
jkbnnbgfaclfealhphi	TRUE
jkdaalgkloihniacllm	TRUE
kebncaockjpdogdbnmj	TRUE
kebppnidkcldefhaiaa	TRUE
kpgeednofidhobpdjpp	TRUE
kpgkncilmbeidedgglp	TRUE
ljkhiicadhkcfmfldnj	TRUE
ljlkblbkphimoihaief	TRUE
meiobdoladlfmkhikkl	TRUE
meioopokabbkbnigbom	TRUE
mofipaiaknipeckkkdo	TRUE
mogljfdblbejapmjken	TRUE
nhlmnjjoodnphlkndba	TRUE
nhlnmmiacefkjanhlmo	TRUE
oamkimcaflnlnoabooj	TRUE
oamobpglfmmfebbpkik	TRUE
olbckhcmndpcilipopd	TRUE
olepallibelfbheheem	TRUE
pemddifijclmcibglnb	TRUE
pemhfhggmnebajiobhf	TRUE
addmelnjkmkpeomdjkp	FALSE
adeilfjipddoolgdmfi	FALSE
allmpmjhdidkfjfhjnh	FALSE
allnffigdikhkefmpeo	FALSE
bggnnfopponplpgeege	FALSE
bghemicfmlghehoenco	FALSE
bogmfhcimlngjjephjp	FALSE
bohcnijplfeglnkhohf	FALSE
cipdenecokbmglpifph	FALSE
cipigbfmkmfofogjofl	FALSE
ddnhhanngikdlpfenlh	FALSE
ddombiecgghonjjmene	FALSE
dnpnhdjaefmkgdoeieo	FALSE
doafoofjmgefplkmoen	FALSE
ehpebomgohgmfgohepf	FALSE
eicapdmhgifgdglmijo	FALSE
fcbmhmmoolghkoimffg	FALSE
fcchmmkmminglhjakpg	FALSE
fmbjllflkglokmholpf	FALSE
fmcboocpkclfhjkfone	FALSE
ggciomkdmcpapfkofdg	FALSE
gggbkgjeoiepkmjpljp	FALSE
gpfmahiimddfkhnllop	FALSE
gpgennpmjgdpihieofk	FALSE
hiigkjjfmcogdihioea	FALSE
hijdgkmkjgbehglmefk	FALSE
idfajfhejdgopmnhogm	FALSE
idgielpbhniklpklicl	FALSE
iofhfjoelmolihdigjk	FALSE
iofhkfhhbjlcipjnjin	FALSE
jienpeaedfonpknffhe	FALSE
jiiadmikeedmdlhjhod	FALSE
kcgdedocpfakieefldp	FALSE
kcnkpjdmmmmbpjfnkgg	FALSE
knplehaopgippfjhenh	FALSE
koafekjopemhigeppjd	FALSE
ljedhiifkhkfeaiiljf	FALSE
ljedpjplcieoolbhckl	FALSE
mdldlhjfpaemljfgmgg	FALSE
mdleniihihgefijpkhp	FALSE
mnagmldimjdghkidgnp	FALSE
mnaihffokmgmpjllgnh	FALSE
ngppjphhjneaeipkgjp	FALSE
nhadglphmmieekomknn	FALSE
oampgdgfgjoeiooikfd	FALSE
oanggjdgheneimpkplf	FALSE
oknebgfljpjfmcmcclp	FALSE
oknjcgedhhengmmnbck	FALSE
pflojcibflflifjfceg	FALSE
pflphfmbfpejlkhjoph	FALSE
