aabaoehjmh	TRUE
aabbcpapnc	TRUE
ajpgadagkn	TRUE
akafbmhjep	TRUE
befkhikoaa	TRUE
befpdnmhaa	TRUE
bonbphepaa	TRUE
boofkenkaa	TRUE
cinomjmoaa	TRUE
cipacoaoja	TRUE
dcgmnimiaa	TRUE
dchcbpmiaa	TRUE
dlgohahpda	TRUE
dlhankhfla	TRUE
efhnlphala	TRUE
efibbdomaa	TRUE
ephpmhbkaa	TRUE
epiolpcgaa	TRUE
fklganbjia	TRUE
fklhefmoaa	TRUE
gfafecbdca	TRUE
gfajchcnka	TRUE
gpibnbjnaa	TRUE
gpijegkbaa	TRUE
hlebdedfaa	TRUE
hleibjjcaa	TRUE
iffpampacd	TRUE
ifgadgbfai	TRUE
jaapdgipea	TRUE
jabchkldna	TRUE
jkajjklmoa	TRUE
jkaljnmfoa	TRUE
kdlbgmmfaa	TRUE
kdmchdkoaa	TRUE
kojbpmldaa	TRUE
kojfmlhnaa	TRUE
ljdggobaea	TRUE
ljgaodngna	TRUE
meejmkkoaa	TRUE
mefnomdhaa	TRUE
mobggmonaa	TRUE
mocblfpmaa	TRUE
njljlpbiaa	TRUE
njneipahha	TRUE
ocpnkobjaa	TRUE
odaoiobfla	TRUE
omdmelcgaa	TRUE
omgggcobaa	TRUE
pgmfbdhmaa	TRUE
pgmfkgblaa	TRUE
abbdgegmnb	FALSE
abcielkbee	FALSE
ajphcmfljl	FALSE
akbcbpgjph	FALSE
beannpdlnh	FALSE
bebdicdiol	FALSE
bolnijdkpn	FALSE
bopjfoajek	FALSE
ciijiimaoj	FALSE
ciippmbohk	FALSE
dcfncnedbb	FALSE
dcgclpbmjg	FALSE
dlbcmklomb	FALSE
dlbibhoali	FALSE
eeokhdhjid	FALSE
eepbggbboh	FALSE
epgalbgech	FALSE
ephmngihoo	FALSE
fjmomhgllp	FALSE
fjncachnfo	FALSE
gehmligijk	FALSE
gehpgkojpa	FALSE
gpjfngaclf	FALSE
gpjidfnhmb	FALSE
hkdokdgjbl	FALSE
hkeeepjlnl	FALSE
iepgkbmiij	FALSE
ifbdeniglo	FALSE
jabhhhgkme	FALSE
jachnpilol	FALSE
jjjhdhhagk	FALSE
jjmbefmcel	FALSE
kemjlndfmj	FALSE
kemkoejeje	FALSE
kpbgaffplo	FALSE
kpcajhiffm	FALSE
ljhecapkef	FALSE
ljhihclifh	FALSE
mdopdddedf	FALSE
mdpeoneafh	FALSE
mokelocgid	FALSE
moklaolcbg	FALSE
njidnpldjf	FALSE
njifelnpcd	FALSE
odlldcbcib	FALSE
odmmdmlbhl	FALSE
omhhfndhph	FALSE
omiblbfild	FALSE
pgmcbocllp	FALSE
pgnlifnppl	FALSE
aabekionjdc	TRUE
aabjnjhogdd	TRUE
akngagdmmgp	TRUE
akpkhgpojda	TRUE
behgajmdeda	TRUE
beihochkoaa	TRUE
bpfkbbjfcaa	TRUE
bpfkghofbaa	TRUE
cklohfkkiaa	TRUE
ckmgllemdaa	TRUE
dfjhegmjmaa	TRUE
dfliddomama	TRUE
eamcilflppa	TRUE
eamgjhffifa	TRUE
ekkabmpccal	TRUE
ekkjkebefaa	TRUE
ffbbhbeobaa	TRUE
ffccnnphkaa	TRUE
fohhdkahbba	TRUE
foidlaplhca	TRUE
giehbpkdmaa	TRUE
gieipjaaocl	TRUE
hcbgpoedcaa	TRUE
hccdbnjleaa	TRUE
hlgpflcemaa	TRUE
hlhimbmfada	TRUE
igcagpfcmka	TRUE
igcffghdnaa	TRUE
jadifgjjlja	TRUE
jadonnocnea	TRUE
jkhacngbida	TRUE
jkhaemigdha	TRUE
keobpcnfdaa	TRUE
keplipglaap	TRUE
lacibceceea	TRUE
ladijeimafo	TRUE
ljnnpfdodaa	TRUE
ljplmmlbkaa	TRUE
mehejalgcea	TRUE
meifidlhdaa	TRUE
mnmdahcajjc	TRUE
mnmgccidhaa	TRUE
ngphimhmcaa	TRUE
nhaalpcdmeg	TRUE
oalmbngnoja	TRUE
oamghpimcda	TRUE
okhoajpajgb	TRUE
okjcllgbbaa	TRUE
pfagebfpjha	TRUE
pfajikcicba	TRUE
abcigglpodn	FALSE
abdedjheilm	FALSE
akpfjeicpnk	FALSE
akphmchjepe	FALSE
bgbpoooofmb	FALSE
bgcaegnejgc	FALSE
bphgleifnll	FALSE
bphkbmiopjl	FALSE
cjjeojcjadj	FALSE
cjmabhenldg	FALSE
dgbkfkkfehg	FALSE
dgcmoepenbn	FALSE
ebaekoloejh	FALSE
ebappmbecnf	FALSE
elbogbejohb	FALSE
elbpinajmlc	FALSE
fedkhdkjhle	FALSE
fefmgdkfoje	FALSE
fpaoegkbnom	FALSE
fpbahmicekj	FALSE
gibcjghonlg	FALSE
gidhgnoabjb	FALSE
hcbmmcccike	FALSE
hcdkinplihi	FALSE
hljkkcmbfkc	FALSE
hljlgmblbek	FALSE
ifgokibjomg	FALSE
ifhekjfchcd	FALSE
jahjohnlnjo	FALSE
jailflhlcpk	FALSE
jkfimobeijd	FALSE
jkgfmgkklbg	FALSE
kfcpjmjeoff	FALSE
kfdbkfciech	FALSE
lajionmokib	FALSE
lajkhfpbdcf	FALSE
lkapnibngkp	FALSE
lkbcojncehm	FALSE
mekdbjfmmpf	FALSE
mekpegmpnep	FALSE
moamgglfhfk	FALSE
mobjgmakcfi	FALSE
nhhnjnnnkng	FALSE
nhiclogigom	FALSE
oaoppkhkjbb	FALSE
obakdcoefef	FALSE
oknnlmokhgb	FALSE
oknoagipjnj	FALSE
pemglcbjnde	FALSE
penamgfockf	FALSE
aabfgkldmpnb	TRUE
aacdlglplefo	TRUE
akcmmbokhiba	TRUE
akdhfdfgbmga	TRUE
bedahjlgncba	TRUE
beeehoblffaa	TRUE
bpcmibholeaa	TRUE
bpcookfokiaa	TRUE
cjcibbggglaa	TRUE
cjcidngophaa	TRUE
dedbkihpciaa	TRUE
dedemkdpjjaa	TRUE
dpaafaiijdof	TRUE
dpbdpadfkjha	TRUE
ejfjpopalofa	TRUE
ejgglakjjlna	TRUE
fdimjnhlepaa	TRUE
fdjcjebdbiaa	TRUE
fnpebnbcomaa	TRUE
fnpgfociipaa	TRUE
ghbfoojddoaa	TRUE
ghdfdogejmaa	TRUE
hbgahhmijhia	TRUE
hbgjhdeabnna	TRUE
hldiaadnbmah	TRUE
hlemoigjagda	TRUE
iemhihapghna	TRUE
iemmckjdkkaa	TRUE
iokgiiiknoaa	TRUE
iokjhgcggiaa	TRUE
jinimacfogea	TRUE
jiobeblochaa	TRUE
kcjcnaicedea	TRUE
kcjffhcgkeaa	TRUE
kmpmhgemnoaa	TRUE
knaeaagocmkk	TRUE
lfiikocgkcaa	TRUE
lfjnobmijcaa	TRUE
lomjbbinngaa	TRUE
lonlifhcekaa	TRUE
mkgahgbijeba	TRUE
mkhaafncnjee	TRUE
nelifppdefaa	TRUE
nemdgpnpidaa	TRUE
npbdajledgpa	TRUE
npbfhpfohiaa	TRUE
okanbjabpdih	TRUE
okbbdlempaka	TRUE
peondchbggaa	TRUE
peppkbejgoaa	TRUE
abcofnnocleh	FALSE
abebdiffhlpo	FALSE
akjndclmnofb	FALSE
akkjcdnfkjlm	FALSE
beanldeefkgn	FALSE
beconklbabhj	FALSE
bojblmdaeebd	FALSE
bokncicfihbe	FALSE
cjkdanpljbhp	FALSE
cjknmafielfl	FALSE
dehellookfbc	FALSE
dehkdfdljadh	FALSE
dpfohcjgdjha	FALSE
dpfphkdeghml	FALSE
ejadhdjhephj	FALSE
ejadicgimpef	FALSE
fcmmfcmgklef	FALSE
fcmncoaobipk	FALSE
fnngobakdkfl	FALSE
fnnhacobgnli	FALSE
giifacmbbmpc	FALSE
giifafiecmbn	FALSE
hbfiobhkdhnn	FALSE
hbhppiafhleg	FALSE
hlkmgfoclcbp	FALSE
hllfkgenbmhf	FALSE
ieknoamcgijc	FALSE
ielgeflphhnf	FALSE
ioomgmkohocg	FALSE
iopdgdpjicok	FALSE
jikgambflige	FALSE
jilnajkobecm	FALSE
kcbphnkdkdkb	FALSE
kccamholnopc	FALSE
kmlaklcgcklm	FALSE
kmlmphjcblho	FALSE
lgkdhcamdogn	FALSE
lgkfnklebnle	FALSE
loledkmbfgbd	FALSE
lomnafodijlj	FALSE
mkfjbdcbpjdc	FALSE
mkfkeiknbbgf	FALSE
neonnjpbcbgb	FALSE
nfccfppjpenl	FALSE
npclpcfgblii	FALSE
npdbddaniibj	FALSE
okcjanbhneni	FALSE
okfdmamgjnpj	FALSE
pendebbblgdh	FALSE
pengcpiefpnp	FALSE
aabfgkldmpnbd	TRUE
aaclglplefoje	TRUE
akbooohdpemha	TRUE
akchimpmhfgfa	TRUE
bdimehhpbecaa	TRUE
bdkkfccjlpdaa	TRUE
boljjdmgeopaa	TRUE
bomgilkbbphaa	TRUE
cjpokbijmchaa	TRUE
ckadbkegjpdap	TRUE
deecajeninmma	TRUE
degchafaoknac	TRUE
dpfjgfijcaabf	TRUE
dpfleddphklaa	TRUE
ejabfaflmoojd	TRUE
ejbnopfhehkaa	TRUE
fdahmjmbnbcoa	TRUE
fdammfociipba	TRUE
fnfadljolfofa	TRUE
fnfbiikianjga	TRUE
ghoolfjggnjaa	TRUE
ghpcioibaijka	TRUE
hbeolpipopgaa	TRUE
hbfcaoennllna	TRUE
hkpphfbpdhkaa	TRUE
hlalafjbfhakk	TRUE
ifdiahahkdimp	TRUE
ifepbamjpgcla	TRUE
ipaaeniechcea	TRUE
ipbancfigjnga	TRUE
jilgplicpnhaa	TRUE
jilokolfajjea	TRUE
kcpgpblaofgla	TRUE
kcpnfdpillnaa	TRUE
kmiakbbhkdcpa	TRUE
kmilhaemfkkha	TRUE
lgagdgdnokila	TRUE
lgbcohldbjjaa	TRUE
lopkjpoomjoaa	TRUE
lopoahbcgbnka	TRUE
mjgakgbioncla	TRUE
mjgjdloojbpaa	TRUE
nefkpcgjgffaa	TRUE
negaajjbpdieb	TRUE
noojpinoioaoa	TRUE
noopddgfcoeaa	TRUE
okjocgcglaifa	TRUE
okkakhbimccna	TRUE
pdmoomgiabcja	TRUE
pdndpkfmpkmaa	TRUE
abdhklopfeong	FALSE
abgeehniekkkj	FALSE
akjmjfchomnmc	FALSE
akjpogpmgbpfh	FALSE
bfdknafekpfoo	FALSE
bffoeedbcjmmo	FALSE
bpignpehhkeah	FALSE
bpikbapbmjcnl	FALSE
cjldablmkfhcd	FALSE
cjlgdflfgmiim	FALSE
ddoangejodgbg	FALSE
ddpcchhncalkn	FALSE
doakbfgiehljc	FALSE
doaohjepdfifn	FALSE
eiimelckebagh	FALSE
eijejehppjnnk	FALSE
fclnbpmmcechd	FALSE
fcmffgfnihbpl	FALSE
fncolkmmkfolb	FALSE
fnddcjpafdigf	FALSE
ggeiehilmkeeg	FALSE
ggenimjlfabel	FALSE
hbhfjhhbdhnpc	FALSE
hbhhflmfpookj	FALSE
hlillccjfpkcb	FALSE
hlkpocobfamei	FALSE
ifhnoemainphf	FALSE
ifkibkhcmbbdc	FALSE
ipinmflhmojia	FALSE
ipjecieapfpdi	FALSE
jjofoolgaomll	FALSE
jjohhobmkpdee	FALSE
keikhdnonbcmo	FALSE
keioghpbkdhgc	FALSE
kpacooeiikfpf	FALSE
kpajbjpfjdbcp	FALSE
ljhalghnlihgb	FALSE
ljhhnpobogjad	FALSE
mddecfeadbijg	FALSE
mdebdndnnmlak	FALSE
mmgnfgkoccgfc	FALSE
mmjfccenkipjn	FALSE
ninnbbfgcoehl	FALSE
nioafhejndief	FALSE
ocnlfndflhene	FALSE
ocnlhnnhoiadf	FALSE
omlgjaecekjib	FALSE
omlmbboenehla	FALSE
pgafdjnbgklcl	FALSE
pganbmgilepei	FALSE
aaadgomilohgok	TRUE
aaadjilngclgfg	TRUE
ajkfkkdnjiaido	TRUE
ajljlajeldogen	TRUE
bfejlifhpkgmaa	TRUE
bffdjddpnhdoaa	TRUE
bphfhnhllbgiaa	TRUE
bphkdjjhjjddaa	TRUE
cjbmgcfcgihpaa	TRUE
cjcbaljckcnmla	TRUE
dddmlgmdjmaiga	TRUE
dddnnidnegdiaa	TRUE
doblojlpdofdaa	TRUE
docgajfogmkjba	TRUE
eighbhniepcmaa	TRUE
eigoklkbabbmpa	TRUE
fcopgdjhjgaoea	TRUE
fcpafkbijcfkpa	TRUE
fmllnckekpcpaa	TRUE
fmndlgbiaifiga	TRUE
ghbddeppdnjjaa	TRUE
ghgjjokgknlcaa	TRUE
hbjapdcnifooha	TRUE
hbjdbbbpppknaa	TRUE
hkpgcacpfkdaei	TRUE
hlaleojpdenoga	TRUE
iffjlkdoafgpca	TRUE
ifgdipedohhpaa	TRUE
ipneoidkppglaa	TRUE
ipoalckjejnkca	TRUE
jkholhcebfklaa	TRUE
jkhoniocabigca	TRUE
kecifgnfmigfaa	TRUE
kedgmpaodjankn	TRUE
kopldoobddodaa	TRUE
kpabkbdjoepmia	TRUE
ljmhokeoghamfa	TRUE
ljmibblifhjaja	TRUE
mddecfapkdggan	TRUE
mddgnikbghbkaa	TRUE
mnflifjdecpeaa	TRUE
mnghimpdficnaa	TRUE
nidcjmpfhiipaa	TRUE
niemkfflpjhfaa	TRUE
ocpcdlgeepefaa	TRUE
ocpgenpifbfhaa	TRUE
omngibhmkoocaa	TRUE
omolkpboconfaa	TRUE
pgcmdjfadcceba	TRUE
pgcpkfhpmigafa	TRUE
abbomkcdljkhbe	FALSE
abchphdhjebmie	FALSE
akdmpodkhcicbb	FALSE
akdoleddmlphho	FALSE
bdeffkhedcpfmg	FALSE
bdgbmjdanjknle	FALSE
bnelobjjgclkgj	FALSE
bngihedpijdldf	FALSE
ciicndehjbdohm	FALSE
ciidlhjjlhilhf	FALSE
ddfepbiahlhbdo	FALSE
ddffhodkdhkenk	FALSE
dnopolediemcne	FALSE
dnpagcgdemhmpm	FALSE
ehfjkcnafnbefp	FALSE
ehfmkdhhhbnimj	FALSE
fbkgdogdhbello	FALSE
fbkiecljgaooop	FALSE
flchbclopidehg	FALSE
flclpccnefomba	FALSE
ggkkjmpgciconk	FALSE
gglpdiigggfdbm	FALSE
hanbjcpcghjnfn	FALSE
hanjbnhgcgdgme	FALSE
hkhclnfihkpdfn	FALSE
hkijfcklooeigg	FALSE
icggdncpodbnnb	FALSE
icghlahcblncei	FALSE
indfkgoaffneen	FALSE
indglpkpbdjhml	FALSE
jhailpmdcklhih	FALSE
jhakmmmnkhcgnl	FALSE
kblpbjakgnfjko	FALSE
kbmhhkmgoldpin	FALSE
kmikbdojgelkfo	FALSE
kmimhdneebdjon	FALSE
lgimaoepidcfio	FALSE
lgimcmfbkdmfmd	FALSE
mcciklkobjlaob	FALSE
mcdiepcgfohhci	FALSE
mlmkpdifaikipi	FALSE
mlndhmojkebojf	FALSE
nhfncnopkgknlo	FALSE
nhhecpenlngkgn	FALSE
obmeichhibebch	FALSE
obminbcabnkbnn	FALSE
olkgcphaofgneo	FALSE
olkillpfhcpdmg	FALSE
pfnjpmhcgmipja	FALSE
pfpjbfkpmgninf	FALSE
aabbcledgkcaifc	TRUE
aachbkbpmcjjojm	TRUE
ajfmcjpknnimija	TRUE
ajfndpfdphbaomc	TRUE
bcjoalpmjlggnla	TRUE
bcjocfegbncigaa	TRUE
bmaomaehihnobbo	TRUE
bmclcolldheplaa	TRUE
cfnadcjhiblleca	TRUE
cfncjafhdghfkfa	TRUE
dbmfpjdgimngbaa	TRUE
dbmgmjlafejgeak	TRUE
dllbhoejogkaima	TRUE
dllgojfgacdbepa	TRUE
efnddcbnkjnfnaa	TRUE
efoacjglpchfkna	TRUE
fbflkpceclnmmaa	TRUE
fbgkodfmdnddbaa	TRUE
flnjpjblgnhodaa	TRUE
flpniodpbichaha	TRUE
gfbmmofifplaipa	TRUE
gfcpgddfngfbkaa	TRUE
hagglcelnmlfhja	TRUE
hahgpmmkkcipdao	TRUE
hkcdkiocdgpkafa	TRUE
hkdhapdjmjlmnma	TRUE
idpdnjihegpclaa	TRUE
iebnlkijiibopaa	TRUE
ionijnofcgodiaa	TRUE
ionncmecpfgiiaa	TRUE
jkalhpookoccdpa	TRUE
jkbaihkjnkaikpo	TRUE
kemanfalcgfnfai	TRUE
kemenlcgpeheoaa	TRUE
kolgbagmdbmjadh	TRUE
komjcbegaeilooa	TRUE
limkjiflieapcca	TRUE
lindfbenmpclkaa	TRUE
mdfbbbmebfpnpaa	TRUE
mdfgldmdhddjbaa	TRUE
mnnfgkgklijlcaa	TRUE
mnnhhojlcihcafa	TRUE
nhfeijighhjcpaa	TRUE
nhgfeeoenjodkaa	TRUE
obhhomomlcajbda	TRUE
obilkmldcmadbca	TRUE
omiclpakbgoagbc	TRUE
omicmlmjobmibaa	TRUE
pgbpiaaljegdhcj	TRUE
pgccobomfpnkmaa	TRUE
abbpknngbjlgmmb	FALSE
abcghifolcnehhm	FALSE
ajldbhfmdpepcpg	FALSE
ajldhploikohnif	FALSE
bdljapjbpgmjegj	FALSE
bdlkpddfleopjof	FALSE
bmhkpmahmfjoopi	FALSE
bmidcebpbnloafn	FALSE
cgjlnolcnidjenm	FALSE
cgkcfcafmedednm	FALSE
dclkflhmcncjpni	FALSE
dcmdimkdlfngeia	FALSE
dmffmhobemaplbi	FALSE
dmficpnohdelcpe	FALSE
efknckkipolfgfo	FALSE
eflcffnnfiginjd	FALSE
fbbldcbljhijlfj	FALSE
fbeaohkoogkginn	FALSE
fklnjmcafnlmlmb	FALSE
fkmhaplmpdlhmli	FALSE
gfhlgmlinanpccp	FALSE
gfjnlaojmjhocgm	FALSE
hagidolidejdgpe	FALSE
haglgldjbfhcmpk	FALSE
hkeamigeonhedhb	FALSE
hkebanilihcbkfh	FALSE
iehigamjfngndfg	FALSE
iehlljpkpaefkhp	FALSE
ioomibgcackdhgo	FALSE
ipalplklpohmndm	FALSE
jjkbllinfpnoigo	FALSE
jjkedchmmbbldnc	FALSE
kebjhlnmpgpokdj	FALSE
kecfhldbmcpgofm	FALSE
kojfkdndlbmnmfa	FALSE
kojiglpjejinaed	FALSE
ljalnhdbdmobcmn	FALSE
ljchjgbiclggjap	FALSE
mdicacfnlljifbm	FALSE
mdigjlnppgmbkjg	FALSE
mnpemmificgdlnk	FALSE
mnpfdfndccalnpo	FALSE
nhimakkjjbndmil	FALSE
nhldckchdagllhk	FALSE
obnngodkonimbop	FALSE
obonkonakfndmnk	FALSE
omhocknbamkfmmj	FALSE
omhphgggnfhkamh	FALSE
pfnbnfgickmcghl	FALSE
pfndacnnnjgmibd	FALSE
aaehfeindmgdehaf	TRUE
aafgmdbhakgmcccd	TRUE
alchjaiegdakoikl	TRUE
alcmncneflngbeda	TRUE
becnmeenkohjmaba	TRUE
becobeeningkenaa	TRUE
bolhjckmmmjfjiaa	TRUE
bonkgdmkgjkabiba	TRUE
cihokadcklinjbea	TRUE
cijcmmhjlmhhgmaa	TRUE
dclglocagpkoekea	TRUE
dcmfeoaciffaflcm	TRUE
dmmeokcgndeeecaa	TRUE
dmnbgfbcfecijcaa	TRUE
ehmmeoiojaioioha	TRUE
ehogdkehiejdogaa	TRUE
fchlbeohhfehfiaa	TRUE
fchnliljnmbknhaa	TRUE
fnijhbnacoolfnca	TRUE
fninmlclkckpmada	TRUE
ghbdjolgfnocnhaa	TRUE
ghbnlkpkonlgfaoa	TRUE
hbcjjpldhpcehdaa	TRUE
hbcjmcaapmibfeam	TRUE
hkjnempbomdppeaa	TRUE
hkkckbbndidlheaa	TRUE
ifhgllclacmggfha	TRUE
ifilmefaigidocba	TRUE
jaeklnidfddkeela	TRUE
jafkihncbiedcega	TRUE
jkdjfediilkgnfaa	TRUE
jkdnmlgmggebglaa	TRUE
kefodgbhnpgingaa	TRUE
kefooahdoahkjepg	TRUE
kohldlbplhckkfaa	TRUE
komlgmaccmieleja	TRUE
lildbkehoneomlaa	TRUE
lildmdheeclioeaa	TRUE
mddhminmkidommaa	TRUE
mdeabjfdlamgdjkc	TRUE
mncidggkbdhdfjaa	TRUE
mnckokbceafdgjda	TRUE
nhhlbmgkdcnjjmaa	TRUE
nhigdaobfjkmooka	TRUE
oceihehjkjhhpcaa	TRUE
ochpidmmfknigjaa	TRUE
omonkljgfdglidaa	TRUE
ompehkckkgnjgdaa	TRUE
pgnimdfiepbpgcaa	TRUE
pgoaeplnnfbfljda	TRUE
abbbdlnnkikhnpbj	FALSE
abbbmejckdjlkgoj	FALSE
akfmmdimflmpifik	FALSE
akfobkgkcoonklmm	FALSE
bfcpgjapjjcmnnpm	FALSE
bfdgpiomjhompdmo	FALSE
cafhjcdodbjphhpj	FALSE
cagbhbejmjlicdoj	FALSE
cjojfheclojghgij	FALSE
cjpfigijlbdjjgni	FALSE
ddljbglnkpgdgodp	FALSE
ddmgeocplgkaonpf	FALSE
dnhceglfagdokimn	FALSE
dnhhcdcggachepkl	FALSE
egljdikihemjljlk	FALSE
eglmcgflgdekehaf	FALSE
fbffpfgnkncfmaje	FALSE
fbgdmafopjkilime	FALSE
flmkmiedeombkjih	FALSE
flobjieoeahfbkie	FALSE
gflaoojjnlihibmd	FALSE
gflcogccppglidhh	FALSE
gonbndimbfdekpij	FALSE
gooddbonofigbamd	FALSE
hilgjcmigfeofdid	FALSE
hilkekbjaofeepip	FALSE
icmepdaigcnjidoh	FALSE
icogfmnikmifihcg	FALSE
iocdemjfpafdkmcd	FALSE
iocfcadbjfbeggbk	FALSE
jjcaibiohobeedlb	FALSE
jjccjfdljphadddn	FALSE
kdikkageckcmnfgc	FALSE
kdinlgogbfcfnhoh	FALSE
kploncmijbamdlck	FALSE
kplpeldnjeinckad	FALSE
lkkdijnahhkncecm	FALSE
lkkigodhbablfbgc	FALSE
mehcjmdhhfnhckpn	FALSE
meijheohepdjllpb	FALSE
mpjnnajkiphemllo	FALSE
mpjoklefjjkapmln	FALSE
njjojnnljecbggdb	FALSE
njkbbdehbhecidha	FALSE
ocpkcbmccopiagic	FALSE
odbjldcdhklhojon	FALSE
omehppkligdaliic	FALSE
omekpikmfhkdmiio	FALSE
pgnlojfmpnhfeioj	FALSE
pgnniinnmhpfmfek	FALSE
aabmcliaaboljahom	TRUE
aabnecckojaaolckm	TRUE
ajmpneojhlpehnfda	TRUE
ajnlaljebpoddjgbe	TRUE
bepeampcjdbijkjja	TRUE
bfanchcbgmeacmoea	TRUE
caekdnbdpigkmejba	TRUE
caelnbigejmdadeni	TRUE
ckmanlcpkhclmjnea	TRUE
cknkbababedoojlmp	TRUE
ddhpiiepknagbaejc	TRUE
ddijbhnakbhmbelga	TRUE
dncdjbplbaejaknkk	TRUE
dneglmlnmajldeloa	TRUE
ehgcidefhnanfpaad	TRUE
ehgcjoicbnlgcehaa	TRUE
fbmdjhkfkgpepdbaa	TRUE
fbnipgkmpaihmabie	TRUE
fmcgpbigjkflfllaa	TRUE
fmcokenddjokgbjaa	TRUE
gfmkeaeldihdadigl	TRUE
gfnfecmdipichgjaa	TRUE
golgdmhlgfbokpkaa	TRUE
gomhmmapdoikglmga	TRUE
hjnnojfkobjedeaia	TRUE
hjogckneplkpagcoa	TRUE
idhjhjedalkahmakl	TRUE
idmglckeaoficofaf	TRUE
inpikeklodhflpjaa	TRUE
ioabhcpeahacnhheo	TRUE
jjnicgdbkepcjelaa	TRUE
jkaafggmmemmhioch	TRUE
kehkfffpcjcabhhna	TRUE
kejpdfmdcmmhjcdaa	TRUE
kpkionhhfonapjmla	TRUE
kpkkjaeenieielpfa	TRUE
lkghhbhdjchbbgoaa	TRUE
lkhaiheelpejpiiga	TRUE
mfeidpcgbpobllkaa	TRUE
mfianbonjekcahkmp	TRUE
mpfcdifbmhckfocaa	TRUE
mpfcfkggipkbenoaa	TRUE
njlmhfgkjpkhiokaa	TRUE
njmclgadplcobalma	TRUE
ocoelhchadcilcjoa	TRUE
ocofgldjehmdgolaa	TRUE
omhipkhhleljnanla	TRUE
omidmpgnaipflgina	TRUE
pgkhmhahadplpchpj	TRUE
pgldbakiamdfghlij	TRUE
abblfjdjhpkkgkdig	FALSE
abdocbnnbbnojclki	FALSE
alemdonheodhdljff	FALSE
alfhmhfkghedlcnob	FALSE
bfdanlnlnbfiohcpm	FALSE
bfdkpjfnfnaeclkph	FALSE
cadcpfbillghfckcl	FALSE
caebekccoekpdpbbo	FALSE
ckjdildgeeoidchnh	FALSE
ckjhkmoaonheikbgj	FALSE
dfeemmidbkbiekkcc	FALSE
dfehhkkkmkpmbdbde	FALSE
dpdmpkbokibjaelfd	FALSE
dpdofalmkcoggomeg	FALSE
ejeijllbochneoiah	FALSE
ejfgijnlkkpellcjg	FALSE
fcmlkemopghomdopo	FALSE
fcmpcaieofdoofpog	FALSE
flpcjnbpnlefknpmh	FALSE
flpmklhadgomhemgb	FALSE
ggjpnlhkbnlbnjoae	FALSE
ggmfikiifbplhncic	FALSE
hadnkbpocehmgcgkn	FALSE
haihmhfbbjmldojlc	FALSE
hklinabfijkmphhob	FALSE
hkmeigflkcgfphgao	FALSE
ieokcmebegckkmbkp	FALSE
ieokdoipmpmodlkfm	FALSE
ioomedmigmmnkdbnl	FALSE
iopmplmakndceedpl	FALSE
jicckmahcplkhpmdo	FALSE
jidfgffpchpnjoffh	FALSE
kbnlklpglpmdbfklf	FALSE
kbodmhcgodjjhggom	FALSE
kmfaibojdiofpekgn	FALSE
kmffjaiifopdcimji	FALSE
lfifdbaijlcodlmlc	FALSE
lfiihfijjmomppfgl	FALSE
lpifdhljinolgcfla	FALSE
lpipbhadebjohmfhg	FALSE
mkcenhdienkfmcbba	FALSE
mkdabjhcohenfijkp	FALSE
nfgdpabdoojebbcmb	FALSE
nfhacfhgifmkkooej	FALSE
oaeljobmlfdkjkkib	FALSE
oaeohemfmpddoljid	FALSE
oknjdiamfcfildgmo	FALSE
oknjijjbcpopiampd	FALSE
pfgdnjkhjplephkkh	FALSE
pfhdiknjbllopicen	FALSE
aaanloenbaehmcbhak	TRUE
aablaaoeeoncglpimo	TRUE
ajhpckkgpabefbnooh	TRUE
ajijopebkpegacfeje	TRUE
bdomoghchnijenpfaa	TRUE
bdpfmcolbehbncodaa	TRUE
boahjiklcbcencjfga	TRUE
boamhjfdjpleemnnla	TRUE
cidonmbadgjcmpopma	TRUE
cigabdjkjpkfbpphha	TRUE
dbcmfaicgpjoadpigl	TRUE
dbeeahhmhpomaieoke	TRUE
dlfhkjnkpgdlgennaa	TRUE
dlgfjkoijdoaelbeha	TRUE
egadgkcfblajidcape	TRUE
egcoooohakkefmcoda	TRUE
fannjgeojdfbmafgki	TRUE
faobipcaeofngnidnn	TRUE
flkmpgpgijemgnmhaa	TRUE
fllhgidinjaookhgoa	TRUE
ggijlecopcpgienbaa	TRUE
ggikfoeokfommcamda	TRUE
haaeajaekfciekoijo	TRUE
hacghmgdpjkmeallip	TRUE
hkdodnlpjlhpapjoga	TRUE
hkeocmdacfbkflmila	TRUE
idkdmbklnnifgkllaa	TRUE
idkmcjhdnfhbkpfiaa	TRUE
indcoiioiechcoepaa	TRUE
indlkdjhmfkkgjonaa	TRUE
jijgnocbpmofkofoaa	TRUE
jilnjkjhlkhlfkhama	TRUE
kdohdacchgclbnmcka	TRUE
keaohbalhjnocdffbg	TRUE
koeiemdpmncgelcfaa	TRUE
kofajjpgkcpohiigha	TRUE
libmmkkafkikmjdoca	TRUE
licadajnijmocnejna	TRUE
mbiaabdipkoiljokdm	TRUE
mbibgpiilniihiljaa	TRUE
mmkemohfjofokgoeaa	TRUE
mmklnkkomnmgndhoaa	TRUE
nghjkfkiagciafcema	TRUE
nghjlpcanmihfcjpga	TRUE
oafnhoapoillmeokmf	TRUE
oaikaommccohkgipjn	TRUE
olchmhkcekdaofbnda	TRUE
olcmdbbbamghppabln	TRUE
pffikpllplcbjjffaa	TRUE
pffohngfomlglbbkaa	TRUE
abcglflcijipjopnlj	FALSE
abcpgfooegoefcldin	FALSE
albcjmobckkdkgkndp	FALSE
alblcekbcknlgdkffn	FALSE
bfflpbgapdmgkemlpp	FALSE
bffpoiodkaknhiihel	FALSE
cahkldkmhnnmdjpokk	FALSE
caidicdiloobbjcjfj	FALSE
ckcngelbniokmelagh	FALSE
ckdpaffnjjkiiilnjm	FALSE
demfbgdapphnijomne	FALSE
deobjpbaihnhbchomj	FALSE
dpopecdaboogfpcffc	FALSE
eabopdbcnmigdkgpjc	FALSE
ekcadlckjjdekpcpbn	FALSE
ekcebaflmjinejdcpo	FALSE
fdpbapjodjfficggcm	FALSE
feaindgkkeblebgbne	FALSE
fnjeidimmhkgakplpo	FALSE
fnjpdggapooicmdobf	FALSE
gihfhondedncldpcna	FALSE
giigafgpnpmldfkilg	FALSE
hcpmglpcbpgoicemmi	FALSE
hdadicfnjmbinhecme	FALSE
hnpdeloihmenmlnhfb	FALSE
hnppiigcnaoihlfecj	FALSE
iicjgbhfffcnbneedo	FALSE
iicngihdfmejhjdgle	FALSE
jddlgpbbdfpdafcjck	FALSE
jdepceiohhhjpmcmma	FALSE
jnbiagnofbdnfmcpfe	FALSE
jndjhajkilejklihjk	FALSE
khnfeppjahmdgfkjcd	FALSE
khninjonnpknabiecd	FALSE
kppolnnapjnekghief	FALSE
lacdgcgpdmppbhlnho	FALSE
ljgdojicmjmldhijhm	FALSE
ljgnhkpaedmgpofcpc	FALSE
mckgdhedmkmimflfea	FALSE
mcmcpcmoaifpnmkenm	FALSE
mngddnalebgpelmjjl	FALSE
mngmoljhbnddkcodpc	FALSE
nhpfbmfoklokhpdfph	FALSE
nhpmklfeldkbgddfci	FALSE
obmffbpgcpijjcojfd	FALSE
obmjhpdhbhljepibod	FALSE
olijenjdbflbiajimd	FALSE
olilidaoklnnjfbmpl	FALSE
pgddmagciddlhcfnci	FALSE
pgdidenipbmhpojmka	FALSE
aaappbkplgljgmcnele	TRUE
aabfdoijbmgmdfokekb	TRUE
akoeibheccbclmobagf	TRUE
akpaonhgdcmilaecdjf	TRUE
bfjkogmnbjfdoelbkaa	TRUE
bfmdaaajgfljdgnbmin	TRUE
cakjciidganiofpocli	TRUE
cakljlimkbmjkiddjna	TRUE
ckeeaobgjjmcjeiibfa	TRUE
ckeibbklcmjnnillbaa	TRUE
dekgfjihiphljibgnaa	TRUE
dekigcliebfandkpdfa	TRUE
dponamondbcppapakll	TRUE
eabdbhnfpljlpghogfa	TRUE
ejkloefgkbhaeocfina	TRUE
ejlmpaclemjpneaeckn	TRUE
fdoiiefoidocfeodcaa	TRUE
fdpaomaplinfmhjhfcg	TRUE
fnlhmhnnhfdffenikaa	TRUE
fnljkkoojkehhhdhaak	TRUE
ghpjflkanfmbopckmja	TRUE
ghpnjcpkamaealimbjn	TRUE
hddpmolcdmflcbbaija	TRUE
hdeplehpjmmhnibifaa	TRUE
hojkklddddjmohnnjaa	TRUE
hojlinbldiaagflbean	TRUE
iiamppfbbonfogodlga	TRUE
iibgkeojhddgoojhnaa	TRUE
jbplhffdpjpcfkpinaa	TRUE
jcdcfeomahmkjhhkadp	TRUE
jnboaogjgbkmieaikgh	TRUE
jnbpkkcalgnjnongnia	TRUE
kggjilphpocipgpheaa	TRUE
kghdlbehkdbichglnaa	TRUE
kpncfffbeignancokca	TRUE
lablodgdkjfmkbbpffa	TRUE
lijdgjmagjcbioamjoo	TRUE
likbdlfamekchpaaegg	TRUE
mckhhpikialabchmnba	TRUE
mclgonpannckdmpeoea	TRUE
mnajpioogagjfjkodeo	TRUE
mnehigbgojpcgalglea	TRUE
nhhjamfepcgmcpfaean	TRUE
nhhpibejchanfannaia	TRUE
ocailgfdkkoeolcnkga	TRUE
ocaneghhpknmeekggae	TRUE
olkmeaoeadellhkkppb	TRUE
ollnpffnjkpbnmepkaa	TRUE
pffpnebfoodoeagdgpa	TRUE
pfgpclmhncplobamlla	TRUE
abbccbhhhkikliechdl	FALSE
abbeejcdkcenjdkodgm	FALSE
akgpliibligdpbgeflf	FALSE
akickcgennhicbcnndc	FALSE
bekcfdmhbfolnkafpoe	FALSE
belbiaojooijdbkbbod	FALSE
bpcgohmbmomldjjklmj	FALSE
bpdcncppikcmldcnndg	FALSE
cimmkgbcmghdjeapgbb	FALSE
cinccelfkfcampkjlpd	FALSE
ddcppphgogfpigbokal	FALSE
dddhjgnbdccipnopnif	FALSE
dnkohjbbjifbkmkpcdl	FALSE
dnlaljfceipfbkgicfh	FALSE
ehlfgohdkfjimhdijmm	FALSE
ehljklefopjanglmemj	FALSE
fanpdnbldfoldmhdpdg	FALSE
faodpbcmljjeokpbdpj	FALSE
flkbfiachobidfillch	FALSE
flkcaigogbfkhkjppee	FALSE
ggoknngeenikmcldhkn	FALSE
ggpnalcholeddkmfdfh	FALSE
hbdfkhhedgipjbnkadh	FALSE
hbffebogjgnijmpaifc	FALSE
hlebciajbpimdjmhbop	FALSE
hlejoabhgbpfkbphndb	FALSE
ifanbklfjjnppedddoj	FALSE
ifbigfiliekbfgkkeoo	FALSE
jbeopmlgchekfhabhcc	FALSE
jbgbjbbkofjljmlfbai	FALSE
jmknhacnifdgbknmbki	FALSE
jmkonnmpmockolhipao	FALSE
kgchlfamgnckdockbik	FALSE
kgciocgoclgiopacfii	FALSE
lanbhihhkefpkkmndem	FALSE
laodocegkbjnglpljcf	FALSE
ljheigfidgnjiabhohh	FALSE
ljhfmkpgkamgbdbhhkp	FALSE
mdkfafeblpedoddpfpg	FALSE
mdkpbadlcjgbihjlpid	FALSE
mnlgkhpadfblonfopkm	FALSE
mnmpgngellgpemdcmji	FALSE
nhiopbfncccafgbllfe	FALSE
nhjcccadofghfbllfhj	FALSE
ocnedhmfgjgmiggcmea	FALSE
ocohibebinclmjenlho	FALSE
onhhchaoogfnipminoh	FALSE
onhkpolcednabffbmpn	FALSE
pfomfngglnidkcffgla	FALSE
pfpcapccbcogobfckco	FALSE
