aaaahpmjpp	TRUE
aaaakkiaef	TRUE
ajifompbcd	TRUE
ajipjfibab	TRUE
bdkfkkabab	TRUE
bdkgcmabcd	TRUE
bnknniaaaa	TRUE
bnllifabcd	TRUE
ciiggkabcd	TRUE
ciihknabab	TRUE
ddbffcabcd	TRUE
ddbiciaaaa	TRUE
dnhhmpaaaa	TRUE
dnielnabab	TRUE
ehehoiabab	TRUE
ehfeilaaaa	TRUE
fbojahgaaa	TRUE
fcafjdagaa	TRUE
fmfpcgabab	TRUE
fmgcfbaaaa	TRUE
ggdgcbabab	TRUE
ggeemfabcd	TRUE
halgjkcbab	TRUE
hamifnhaaa	TRUE
hkoodoabab	TRUE
hlagkeobcd	TRUE
ifpfdacbab	TRUE
ifpjlmabab	TRUE
jaimceibcd	TRUE
jaiomhpaaa	TRUE
jkkehfabab	TRUE
jklpefaaaa	TRUE
kfeknoaaaa	TRUE
kffmknabab	TRUE
lacddlnbcd	TRUE
lacedjafaa	TRUE
lkbdonaaaa	TRUE
lkbmmdabab	TRUE
mfchiiaaaa	TRUE
mfcoipabab	TRUE
mnpbceaaaa	TRUE
mnplppabcd	TRUE
nhnpilaaaa	TRUE
nhpepgaaaa	TRUE
odejboaaaa	TRUE
odfkhhaaaa	TRUE
omcdgcabab	TRUE
omcgflaaaa	TRUE
pfkdfhaaaa	TRUE
pfkhcbabcd	TRUE
aaabinkljb	FALSE
aaablfgodp	FALSE
ajfinkcjpd	FALSE
ajfmnmfdnk	FALSE
bdompjpgcn	FALSE
bdpaminhdn	FALSE
bocgjidmod	FALSE
bodcelndjc	FALSE
cijjlicpoe	FALSE
cikdepmdmf	FALSE
dcolopgjfg	FALSE
dcpagmjofi	FALSE
dnfnlcogdf	FALSE
dnfockpedm	FALSE
egklaldppl	FALSE
eglhogakel	FALSE
fbiianimig	FALSE
fbiihgbplk	FALSE
fmaepfmibk	FALSE
fmbjghffbp	FALSE
ggpcncbbni	FALSE
ggpghooino	FALSE
hafgpahcdm	FALSE
hafiblhbia	FALSE
hkmdlemgni	FALSE
hkmgajoahg	FALSE
ifmieooikf	FALSE
ifmjjkbfaf	FALSE
jaoiaggfnh	FALSE
japicndjed	FALSE
jlednggecd	FALSE
jlempgacnp	FALSE
kfencgohld	FALSE
kfgemohkkb	FALSE
ladpciodak	FALSE
ladpclhgof	FALSE
lkdobledjp	FALSE
lkebanbllk	FALSE
meglicfnka	FALSE
meglkjbkbb	FALSE
mofhfhkhdo	FALSE
mofjkpojmn	FALSE
nhklflbigm	FALSE
nhlcnpfbhf	FALSE
odamhbdchn	FALSE
odamjbodok	FALSE
omclfanega	FALSE
omcnajcggd	FALSE
pfkaboaphn	FALSE
pfkamecgbb	FALSE
aaaahpmjppk	TRUE
aaaakiaefnc	TRUE
ajkhjomnaaa	TRUE
ajlcplaagpa	TRUE
bdifbknaaaa	TRUE
bdjdhndaaaa	TRUE
bnlkbapakaa	TRUE
bnmkgglaaaa	TRUE
chjloheaaaa	TRUE
chkfpphabcd	TRUE
dcnjiklabab	TRUE
dcocpmpaaaa	TRUE
dnhfmkfaaaa	TRUE
dnhhidcaaaa	TRUE
eieclfjabab	TRUE
eiefgcdabab	TRUE
fccgdmjabcd	TRUE
fccjkbmaaaa	TRUE
fmjbnbagbab	TRUE
fmjfohoabab	TRUE
ggccahcbfcd	TRUE
ggcjnfkaaaa	TRUE
haikmdknaaa	TRUE
haipnjllbab	TRUE
hlchadafbcd	TRUE
hlckdoeaaaa	TRUE
ifkfnefaaaa	TRUE
ifllpigabab	TRUE
jahjmpplbab	TRUE
jaimbibpabk	TRUE
jknomegabcd	TRUE
jkokhloabcd	TRUE
kfjjgkdaaaa	TRUE
kfkgdplabcd	TRUE
ladgooibkcd	TRUE
ladiagjhafa	TRUE
lkehmceaaaa	TRUE
lkfapdncaaa	TRUE
membnigabab	TRUE
memchjanaaa	TRUE
mocbeieaaaa	TRUE
mocedgeabab	TRUE
nigdhnjabcd	TRUE
niikbimaaaa	TRUE
ociifpbaaaa	TRUE
ocikfjoaaaa	TRUE
oljkdffaaaa	TRUE
olkpbhfabab	TRUE
pfnaogkbnab	TRUE
pfnhchmabab	TRUE
aaaninldinc	FALSE
aaeidogjnbd	FALSE
albecmhcfhk	FALSE
aldgnmpcopl	FALSE
bfnfaiomfpk	FALSE
bfohlfobhdi	FALSE
bogcphofnpm	FALSE
boibgomekbm	FALSE
cjiehepnenp	FALSE
cjippfnhegi	FALSE
dednclecmhm	FALSE
degjcfonjld	FALSE
doimdmgiekb	FALSE
doinbloalpo	FALSE
eijmfbgfdde	FALSE
eijnaaiamjg	FALSE
fcoeojllmjb	FALSE
fcooelgnfjb	FALSE
fmeicciiffi	FALSE
fmeoehnekea	FALSE
ggglgnflgai	FALSE
gghjdpnkojp	FALSE
hahdgmbipjb	FALSE
hahfeplfncb	FALSE
hklodhfokmn	FALSE
hkmfhpdcjeh	FALSE
ieldgmkmhne	FALSE
ieldmlnhpkk	FALSE
indidpdjocf	FALSE
indnmlkejok	FALSE
jhelpkfdjod	FALSE
jhfhdgfikfl	FALSE
kbjlpjadegk	FALSE
kblkpcbabcf	FALSE
kmfapdfpffe	FALSE
kmfehdmlckh	FALSE
lhdfaipdhnb	FALSE
lhdfefnimed	FALSE
mcamgnfomgm	FALSE
mcaoeicoiab	FALSE
mmfhadggfkj	FALSE
mmfhbpmjooi	FALSE
nginlifbmgh	FALSE
ngjfachodgh	FALSE
npipiblkbge	FALSE
npkhhhaaiaf	FALSE
ojgfafgngnd	FALSE
ojhfeakeefi	FALSE
pfamklodmac	FALSE
pfcilljlbja	FALSE
aaamhmkchpma	TRUE
aaebjdogjncd	TRUE
albodfchbjod	TRUE
albpanapcbaf	TRUE
belpnpbnabcd	TRUE
bemabfnolaib	TRUE
boddolfeabcd	TRUE
boddpckcaaaa	TRUE
cjdgfoboabab	TRUE
cjeabeojbdcd	TRUE
ddikhlboabcd	TRUE
ddippnehaaaa	TRUE
doigmcnpabab	TRUE
dojcdmfgabcd	TRUE
eidinjgiaaaa	TRUE
eiegfonoabcd	TRUE
fceofdikaaaa	TRUE
fcfijomahbcd	TRUE
fmcdmfmdaaaa	TRUE
fmcdmjgjabcd	TRUE
gggimkgcabab	TRUE
gggkpgfcaaaa	TRUE
hanbbkdighab	TRUE
hanmobjclcpd	TRUE
hljckbdiabab	TRUE
hlkmjgflabcd	TRUE
iejbhjnmabab	TRUE
iejbjkncaaaa	TRUE
innbllpkabab	TRUE
innigedhaaaa	TRUE
jglbiccbaaaa	TRUE
jglhnkkgabcd	TRUE
kbggkifcabab	TRUE
kbhnmdflabcd	TRUE
kmhlaccfhbab	TRUE
kmieneihabab	TRUE
lghkoeicabcd	TRUE
lgifgojnabcd	TRUE
mbondpnkabcd	TRUE
mbpjemoeabcd	TRUE
mmeenodhabcd	TRUE
mmehoajhkaaa	TRUE
ngialnlogaaa	TRUE
ngiemfidaaaa	TRUE
nphomidgaaaa	TRUE
npjbhnpfabab	TRUE
okfanielnaaa	TRUE
okfhfpkhabcd	TRUE
pfeenbecaaaa	TRUE
pfegnhlnabab	TRUE
aaanejknjcgf	FALSE
aabakejmhkmh	FALSE
akghemhhjffj	FALSE
akghpfliloef	FALSE
bcpobnainolj	FALSE
bdcmjceblfkl	FALSE
bmoejgfkbiga	FALSE
bmpbpeagelhh	FALSE
ciahikdaimpi	FALSE
cibbehjbpabi	FALSE
dcpckeanccac	FALSE
ddaancocdajl	FALSE
dneojbdhifne	FALSE
dnfaegkcgoip	FALSE
eheblmgcdjfi	FALSE
ehejfjjoflgo	FALSE
fbmohdhppmch	FALSE
fbnkpbekciod	FALSE
fndecmicebfe	FALSE
fndmgepdmjcn	FALSE
ghpampagfeln	FALSE
giadknalhfnf	FALSE
hdedcpjjamjj	FALSE
hdefjjapcmia	FALSE
hobcimlkpeje	FALSE
hobnnegneogp	FALSE
iifcijgniglk	FALSE
iiggocifnbdi	FALSE
jdgnlfajdkif	FALSE
jdhphgfgpdjm	FALSE
jnifdbeckncd	FALSE
jnijgmgaalkm	FALSE
kgpcmkenjjdd	FALSE
kgpjiiijaklf	FALSE
lcfeapbneflp	FALSE
lcfeploanjng	FALSE
lnjlggeimkjc	FALSE
lnkpngdlonah	FALSE
mgpkiifbbfbf	FALSE
mgpmjmndbknl	FALSE
nafjbjdonfnb	FALSE
nagjggholhbe	FALSE
njmplhlabgod	FALSE
njnbmfigbnhf	FALSE
oclipefhdbgb	FALSE
ocmjgghdbbam	FALSE
omilnldifoop	FALSE
omiohikfbnpb	FALSE
pgkfchfopdpk	FALSE
pgmbcbknifmp	FALSE
aaamdijpmibpa	TRUE
aabeabipochkf	TRUE
akglimljjpbab	TRUE
akglkjojhcaaa	TRUE
bdmedmldfaaaa	TRUE
bdndoemncaaaa	TRUE
bnhkhcbopaaaa	TRUE
bnigendhcabcd	TRUE
cidfddclkaaaa	TRUE
cidfpmkmeaaaa	TRUE
dcmnlgaoapfaa	TRUE
dcnapljhobmcd	TRUE
dmkpehinhaaaa	TRUE
dmlbaiphlebab	TRUE
ehbilbhfmabab	TRUE
ehcabjdihkdcd	TRUE
fchogpmphaaaa	TRUE
fcincnnnkabab	TRUE
fnnclcibbaaaa	TRUE
fnobcdchanbcd	TRUE
giipgfgdpabcd	TRUE
gijbdahgbbfab	TRUE
hdffgjcmgaaaa	TRUE
hdhijmkhcabcd	TRUE
hombodfllabcd	TRUE
homddemplaaaa	TRUE
iigbnblbbabcd	TRUE
iigmjfbmkabcd	TRUE
jdbbhomfjabab	TRUE
jdbjdpgfcaaaa	TRUE
jnihkbifiaaaa	TRUE
jnijppnflaaaa	TRUE
kiakcebaipada	TRUE
kibbkhdojabab	TRUE
lcdhehpopaaaa	TRUE
lcdhicohfaaaa	TRUE
lnfepgldlaaaa	TRUE
lngafnolifbcd	TRUE
mgpjofinbabab	TRUE
mgpolbjogabcd	TRUE
naggpjnkpfbcd	TRUE
nahjhjekjiaaa	TRUE
njfifidajhbab	TRUE
njgoanjkgkaaa	TRUE
ocjogholhabab	TRUE
ockcbjlpiabab	TRUE
omkofklddabab	TRUE
omkpckakghbcd	TRUE
pgdbhliedabcd	TRUE
pgipjkhhgaaaa	TRUE
aaacpkkichbng	FALSE
aabaimljolflc	FALSE
akekmgfoobdld	FALSE
akfmhigjjjobg	FALSE
bfmhnfllggpbf	FALSE
bfmmdnamjplfe	FALSE
bpeconeeelkja	FALSE
bpfeaebdmoamj	FALSE
cieekofnlelgo	FALSE
ciflklccfilmp	FALSE
ddjigioledhla	FALSE
ddkiofpplelae	FALSE
dokbcmjaeedmd	FALSE
dolnlmdgeccpf	FALSE
eihnplncnpdei	FALSE
eihomadgkhfkk	FALSE
fdabioeaigmkd	FALSE
fdaphkkgikpej	FALSE
fofcchchlnaim	FALSE
fogeaalacifen	FALSE
gihlhkpkjmdmi	FALSE
giigniioiechn	FALSE
hdclnofobjdne	FALSE
hdcmjhjciifdf	FALSE
hniagehgbodhf	FALSE
hnjhjfpadihii	FALSE
igleojeephpka	FALSE
iglgakmgpioig	FALSE
jaeacimljlmik	FALSE
jaeebjjigaklk	FALSE
jkkfjjemojgdd	FALSE
jkkgphefifipi	FALSE
kebmdeianhfon	FALSE
kecaedpdicjpl	FALSE
kodeeblcloaab	FALSE
kofkbanlapkpo	FALSE
ljbinecbgbcaa	FALSE
ljbjnapmbgjln	FALSE
mclkjnadglbkh	FALSE
mcmbcajiclecl	FALSE
mmhfghlehpjop	FALSE
mmhpjopfgkgjc	FALSE
nfomekhfdndjh	FALSE
ngbgonaffclhl	FALSE
oaoemhnmalmnf	FALSE
oaognaihllejj	FALSE
okiijencdohjl	FALSE
okjagfdafeojm	FALSE
pfghdeoeifgjc	FALSE
pfhgfcaahldmn	FALSE
aaabojpjhbgamf	TRUE
aabagkjhmjdjag	TRUE
akgpcppdmmfbcd	TRUE
akhpijhpbabaph	TRUE
bfjhlmigndabab	TRUE
bfllmbikmmaaaa	TRUE
bpgigbhaeepaaa	TRUE
bpgpjkomgjaaaa	TRUE
ckaeffbbfdpoab	TRUE
ckajpjogmepbcd	TRUE
ddkanipjpolbab	TRUE
ddkbabnnhdlecd	TRUE
doickilfcpaaaa	TRUE
doiohpaencjaaa	TRUE
ejijddacbaljhb	TRUE
ejjcbinkpiaaaa	TRUE
fcngejlgbdaaaa	TRUE
fcngggfoaibecd	TRUE
fnnhmmbdgpabab	TRUE
fnnmhmejpoaaaa	TRUE
gigjmkkihjaaaa	TRUE
gigkpfnighaaaa	TRUE
hcmipeoincaaaa	TRUE
hcnflopnapnaaa	TRUE
hnejciifdfaaaa	TRUE
hnflhpnchfaaaa	TRUE
ihcodpgpjanbab	TRUE
ihgjpflacnjaaa	TRUE
jafakegnibjmcd	TRUE
jaflpdpojeebcd	TRUE
jjfkbkgcgjaaaa	TRUE
jjgmpmnggcaaaa	TRUE
kdjankmonmmbcd	TRUE
kdjhjhphchaaaa	TRUE
kodockpnadnaaa	TRUE
koegelaeghabaa	TRUE
lillcnhieeaaaa	TRUE
limgikhadhbkcd	TRUE
mcofhmlbaklbcd	TRUE
mcombanhepjbcd	TRUE
mmjakffbfkcifd	TRUE
mmkonieaffkaaa	TRUE
ngjnfhifhcaaaa	TRUE
ngmckclibagaaa	TRUE
oakgmghbdfmpab	TRUE
oakoefkccainaa	TRUE
olhccdbnpkaaaa	TRUE
olhdckcmcmabab	TRUE
pfdfhlddnpabab	TRUE
pfdfkkgljnaaaa	TRUE
aaagfoplboimhn	FALSE
aacakmjmbpolno	FALSE
akflbbbbpbhomm	FALSE
akhbdhhekhfgpi	FALSE
becgoanpiiebnc	FALSE
beednpenloadpp	FALSE
bofoapmaaknfeb	FALSE
bogblcpcmjmlhe	FALSE
ciapikeidbjiea	FALSE
cidabjehbjfmma	FALSE
dclhgcbihphppl	FALSE
dcllgjdodjepji	FALSE
dnioggcjgnhpjd	FALSE
dnkjhckdofdbkj	FALSE
ehiljpekiphfen	FALSE
ehjmddepnknacm	FALSE
fbjaphpjiaokkn	FALSE
fbnnbbgcekhpho	FALSE
flojmbbhoobaoh	FALSE
flokefjpfjikpe	FALSE
gfggoephfdbgma	FALSE
gfhacmnhkmmfpn	FALSE
gpljkejeeeajmg	FALSE
gpmaipfajmmmcp	FALSE
hjknoibifoegem	FALSE
hjlbphemeappdb	FALSE
icpkpbjbhdioli	FALSE
idbbddggacmoof	FALSE
imaopghenpigbj	FALSE
imchndkkacplgo	FALSE
jgpnjiidabbfan	FALSE
jhbncelpbodign	FALSE
kajpbjehhglpme	FALSE
kakamoajeeckjn	FALSE
klmhgihecopjlh	FALSE
klnciikgmhpjhe	FALSE
lfaioidalcaikh	FALSE
lfancagnpjkipb	FALSE
lphbniiimkjgnd	FALSE
lphhfkegogljfm	FALSE
mkijnemkcjpjjf	FALSE
mkinmbcofpdifi	FALSE
ngicmfenikagab	FALSE
ngjoaldpbgllhc	FALSE
obbhebijbpoonk	FALSE
obbljmbceimiah	FALSE
olbbfefgegkjkg	FALSE
olbkbalgjmbkni	FALSE
pgbleffkphiofe	FALSE
pgcjeengkhcofd	FALSE
aaafenokanhlgma	TRUE
aacjlilpaonkmna	TRUE
akgjfggajijenaa	TRUE
akhmpoicaekdeaa	TRUE
beeffkpaoghoaaa	TRUE
beekolfddjagaaa	TRUE
boheaghbdeidecd	TRUE
boiepooninbabab	TRUE
cigkckdbndiaaaa	TRUE
cigkgbjlnnafbcd	TRUE
ddboifobjlcaaaa	TRUE
ddcgepmcfeiaaaa	TRUE
dngmlajpilleaaa	TRUE
dnhekggfipnabcd	TRUE
ehflekjflcdabab	TRUE
ehgdbkabcglpfbd	TRUE
fbkbmecgkekaaaa	TRUE
fbkoijhlnflabab	TRUE
flifaodmkkjnaaa	TRUE
flipigbgdikaaaa	TRUE
gfnebdlnnappaaa	TRUE
gfogndkkdpjabcd	TRUE
gpihcfgbnmlabab	TRUE
gpimiabgainboig	TRUE
hjkeaghnlocnbab	TRUE
hjkjheaodbphdcd	TRUE
icnnebbkcnmabab	TRUE
icomlakngjgcaaa	TRUE
imjbiolinlgabcd	TRUE
imjdfebfohmabcd	TRUE
jgodhglbgjdaaaa	TRUE
jhanpogemjbkkcd	TRUE
kbamnldhamojcaa	TRUE
kbbkmjiidabbfab	TRUE
klfoknllnhaoaaa	TRUE
klgibfmbmlmaaaa	TRUE
lfhpideacilkaaa	TRUE
lfjedkjflaipaaa	TRUE
lphomohbnhdaaaa	TRUE
lpiimomipldaaaa	TRUE
mkcdhamocnifaaa	TRUE
mkdengolibadbab	TRUE
nffioppdbngabab	TRUE
nffkdgnkjgoabab	TRUE
obgfalkknfaobaa	TRUE
obiihahafamnmka	TRUE
omdknjiofnmabcd	TRUE
omflkjpeempabab	TRUE
pfioflnaljpdbcd	TRUE
pfipdmbfbifabcd	TRUE
aaaepicdeflgmjf	FALSE
aabgfcaigcokoji	FALSE
ajfffkohaonjgfp	FALSE
ajjpnhigklflckl	FALSE
bdnkelmnlgjdplh	FALSE
bdnnbfkpdlidald	FALSE
bmkgjkdokkfhlla	FALSE
bmkhdoijemkpbdd	FALSE
chakdfdlknpofif	FALSE
chcdddllbgkhobd	FALSE
dbhjkgnojjpejcn	FALSE
dbhnoancocebhho	FALSE
dlnfgefbpblgcoe	FALSE
dlngfphajmlcibg	FALSE
efoindmcofnphom	FALSE
efpnbbdecicbjcj	FALSE
famlamkcilpclkp	FALSE
famoaoenhebinof	FALSE
flbcepbaimgibmf	FALSE
flbeinmllibogpk	FALSE
ggcncflmlkmljpj	FALSE
ggdohaiclhhhpak	FALSE
halhnekknopbnci	FALSE
hamkjjlbggpplcp	FALSE
hkpncagojeokpko	FALSE
hkpnfoacddfhnje	FALSE
iemhojkobjdmheg	FALSE
iemlakajfokjlde	FALSE
ioobaplomodkeef	FALSE
iooefclhmfjnomd	FALSE
jiendigaafngddh	FALSE
jigkadfnjaadilh	FALSE
kceicmcphlgolai	FALSE
kcfiffmojpblenp	FALSE
kmcaopdibibklba	FALSE
kmcdaphdmcdpcmm	FALSE
lfnjfadoaabihfo	FALSE
lfnogibocclpijg	FALSE
lpdbenohgacanjk	FALSE
lpdmgooecjnbaom	FALSE
mkcmbknlhgencfj	FALSE
mkcnefghcbjglon	FALSE
nepnhgpapbhmiac	FALSE
nfaibbcogkfenob	FALSE
npcbblogofagnmg	FALSE
npccpejhjfgeehj	FALSE
okmdnpfomjebabd	FALSE
okmpacokeeijjfb	FALSE
pflpicclkmkhdkd	FALSE
pfmdipkhloobmie	FALSE
aachcipngnaikkga	TRUE
aaddhkdjoacmjmea	TRUE
aldieklemillfbab	TRUE
alfehjlaoikcgdaa	TRUE
begfedanccnolaaa	TRUE
behipkfglmnbabcd	TRUE
bopgdhamdjnkebcd	TRUE
bpbggphghiadfaaa	TRUE
cjdoceodfbgdaaaa	TRUE
cjeegadgalfbjama	TRUE
dehjpmeeaaafbkla	TRUE
deildhjcockiaaaa	TRUE
dojmnkahdgbfdjab	TRUE
dojobcpbkahbbapb	TRUE
eifbocahmjdicaaa	TRUE
eifddocnneoeabab	TRUE
fcifdmgedkgcabab	TRUE
fcilepkafaiehmaa	TRUE
fmcoopeciifeabcd	TRUE
fmdmgnpapingbjab	TRUE
ggiekpmoobblaaaa	TRUE
ggiianjfpfkleaaa	TRUE
hahjoalombhpaajc	TRUE
hahnkoppbmgcdekh	TRUE
hkfnbflpkiamcbab	TRUE
hkhadgelejcdcaaa	TRUE
idpiagpnpkceebcd	TRUE
ieaabkknmfkepeaa	TRUE
inpfoilncedbabcd	TRUE
iobeagkppbffjeab	TRUE
jhpogjhmghohabcd	TRUE
jhppnjfpbhgnabcd	TRUE
kbimoccefefahbab	TRUE
kblifidjhfohaaaa	TRUE
kljoejmllkeoabab	TRUE
klkemmknpgphaaaa	TRUE
lgdbgembmfepabab	TRUE
lgdcklmkjebhabcd	TRUE
mbbkmahnopnikaaa	TRUE
mbdigfikdfmpabcd	TRUE
mkldgemjpdgkabab	TRUE
mkmbcpnbojbjabcd	TRUE
nfjepoceaefjnaaa	TRUE
nfkfjejamkpmmbcd	TRUE
npnfelgdhjicabab	TRUE
npnghfamlggekaaa	TRUE
okddeljmceoeabab	TRUE
okdjkppjgoajiaaa	TRUE
pfjfiolkeihiabab	TRUE
pfkfmnhniamcdaaa	TRUE
aachcipngnajllhe	FALSE
aadhkdjoadnknfph	FALSE
alebklmgijolllkf	FALSE
alefmbfhflfilief	FALSE
bfaehoecjlkodafc	FALSE
bfaemadoihocbmpg	FALSE
bolddldmbpkdnlbo	FALSE
bonmmfobhadgkcmh	FALSE
cjnmigkjhbbgacik	FALSE
cjphmgmipefaobcp	FALSE
dehajfbdjmhmfcjc	FALSE
dehbkcbnkphajpcm	FALSE
doieblkomgcjihlg	FALSE
dojedgmogognlmfh	FALSE
ehhekbibmkenocdh	FALSE
ehjgemcopfbeghmb	FALSE
fcmaflkmghghicml	FALSE
fcmhjlldhabnphhf	FALSE
fmjbcfonbfjcemhe	FALSE
fmkhmbhnpoldepan	FALSE
ggjhbddaoedabcih	FALSE
ggjkmhddfdamjbon	FALSE
haofnefnibhlpaae	FALSE
hapbkpioddgapdna	FALSE
hkcnibckkhcmogdm	FALSE
hkdaikljjpoiplpf	FALSE
idokojiejhakhemk	FALSE
idpflclplblccoaa	FALSE
iocdfhmmjdddomfd	FALSE
ioceekblmfldnnnm	FALSE
jhggncfmcnapahdp	FALSE
jhgnfnakledmlhgh	FALSE
kbgokhlkefabidnd	FALSE
kbhjcdeicmiepobi	FALSE
kljohjlkmplbnnjj	FALSE
kljojechkpfjhomh	FALSE
lgdmokhepajbncnp	FALSE
lgfnincepfbbmgdd	FALSE
mbpenimnjilnkgha	FALSE
mcadelnfindmpbei	FALSE
mljgifgingilaped	FALSE
mlkahnoemjnmfelj	FALSE
nfccdkgjnfbcbocb	FALSE
nfcmcfjjdacofdnm	FALSE
npmihadgpkeppljf	FALSE
npmmbfhhghnbfllm	FALSE
okkkdehcbnfacjao	FALSE
okljpoceebmkcmce	FALSE
pfnnhpohoihnboce	FALSE
pfpecfhabfnamnjk	FALSE
aaaahjdnjpndngcjj	TRUE
aabcihakafmoddngf	TRUE
ajeniiamlmkcpdhaa	TRUE
ajgakgoogjjgeflaa	TRUE
bekineajjamidneaa	TRUE
bemljceimogkkaaaa	TRUE
bokdonnhfmfmeaaaa	TRUE
bokncbohbcknacbcd	TRUE
cichppoojbcnmabab	TRUE
cidhbphipcifcabcd	TRUE
dddpchfdlpnfbaaaa	TRUE
ddebffkohjnhkabcd	TRUE
dobdcbonfimmgabcd	TRUE
dobhaoimjbkoecihd	TRUE
ehpgnfnogklhlaaaa	TRUE
ehphoblcdgecoabab	TRUE
fbogcnofpbhdfaaaa	TRUE
fbpfajhjlfnnfkbab	TRUE
fldbbaplefgaglfaa	TRUE
fleogipblmenakbab	TRUE
gfbolglelihkmaaaa	TRUE
gfcanljgdiobejgcd	TRUE
gpjahjgmpbhdbgjab	TRUE
gpjdibohejennaaaa	TRUE
hkhghlhgkhdfoaaaa	TRUE
hkhjagphmeilffaaa	TRUE
ielcmfapfegclhbab	TRUE
ielkillohjnpkabab	TRUE
ioofnifkfoknfaaaa	TRUE
ioojnakpbabopkbep	TRUE
jidcaacmlojnjgbcd	TRUE
jidkhkocfbeccaaaa	TRUE
kcnlpacnfgjgbbbab	TRUE
kcobcnafdfddigaaa	TRUE
kniamaedponjfpcaa	TRUE
knikjfhoigebpaaaa	TRUE
liglbiibhkpokabcd	TRUE
liglpoecahgomiaaa	TRUE
mcocmedigkepnaaaa	TRUE
mcodbldamokffkaaa	TRUE
mlmlchgdlhacdpbcd	TRUE
mlndmfcdcjcngabcd	TRUE
nflbfgalmgcijfbcd	TRUE
nflpbbcbhdalmkaaa	TRUE
oanbmdppgmnikhkab	TRUE
oaoghidbmaajhaphf	TRUE
okoollnoahlhlobcd	TRUE
okopkmpdpbppiabab	TRUE
pfkpkdfmiddkiabab	TRUE
pfldgdbmpjjcjaaaa	TRUE
aackjclgpemdeejbi	FALSE
aacnmooldflpmijbk	FALSE
akdeaehlapeebffbe	FALSE
akdibofcjcpihckcj	FALSE
bfgodhnmhgjbcbeob	FALSE
bfgpaclhplbdkekco	FALSE
bpcigeeeghbbocncl	FALSE
bpcmfgngpkloipknd	FALSE
cijkeghpgncbdjanm	FALSE
cilkdamdmlojkbmdo	FALSE
dbhhfolljbaadjadl	FALSE
dbicbjhnlndeblgnf	FALSE
dmejghjbkibemkkki	FALSE
dmejmlaolfkkkdfjn	FALSE
ehhgmkhdopjknlplc	FALSE
ehijjpoabdnackhcn	FALSE
fanedcjedclohnfmh	FALSE
fapgedkdcijkekamn	FALSE
fkkchnlcjgmjmmacj	FALSE
fkknmeaingdghigfj	FALSE
gfbldeoiedococadj	FALSE
gfcohmokcjnpomaaf	FALSE
gpbojglpohanfgcpe	FALSE
gpcbjojeahnkcaaek	FALSE
hjackkapdanmojpjd	FALSE
hjaeinedbnddcjola	FALSE
idccbacdflghdfhhf	FALSE
idcdhceiilpeijmfi	FALSE
imppfhejhfhmkeddi	FALSE
inahabklfbdbggide	FALSE
jflgbimlfhiaaflkn	FALSE
jflgdlimeegflmfmo	FALSE
kbfeebpmjbfkcfopl	FALSE
kbgimklddegianmij	FALSE
klacpifdappdhodha	FALSE
klapohohniphcfkkk	FALSE
lfhgklecjfdinmhcn	FALSE
lfiknjcghiolfgplg	FALSE
madolgaonjfncknbk	FALSE
mahabeemaepfpholh	FALSE
mlhhfddelfnnflped	FALSE
mlicbaofdbldomnpa	FALSE
ngjlcicnjpndpmkhd	FALSE
ngjncbfiaopfilmlf	FALSE
npnamioobigcbbphp	FALSE
npnfnkgmajpjneagc	FALSE
okifiidgcgdloembh	FALSE
okiinjahhpgiamake	FALSE
pelhbeckbpepnlgpj	FALSE
pelpblobgjfckdjpa	FALSE
aaaalhoiofhmpbambg	TRUE
aabfilbajfjknfofpa	TRUE
ajenkdgnacgkdpihaa	TRUE
ajhdelfocmodmoiaaa	TRUE
befkmdjgiflofdabab	TRUE
befmahfblhhljomcbd	TRUE
bockdnmdmfkgijabab	TRUE
bodgohpjdppjlnabab	TRUE
cikeegmcbenlhkabcd	TRUE
cikicocdlkdcpcabab	TRUE
dcmgjjimgmmbbdabab	TRUE
dcndcaachnleaimbaf	TRUE
dnjcidcjiklihlabcd	TRUE
dnkljalfkpgflobpab	TRUE
eihfkefhpjkjlpabab	TRUE
eihgibfilodeflaaaa	TRUE
fdahclbblbnmjegbcd	TRUE
fdbhjnolpiinifabab	TRUE
foalddgpebigdgfocd	TRUE
focjnmfloabcbejcid	TRUE
ghpigneanfnbidficd	TRUE
gibgkpgigkbcjmaaaa	TRUE
hchgfpmgbijapjjaaa	TRUE
hchplbfbcoehopaaaa	TRUE
hmkamgfjiponahkdaa	TRUE
hmkgbdgdjfhpdkabcd	TRUE
igoncgafjoklpmjbcd	TRUE
igookimplfneiabfab	TRUE
jbkiopfmalkgfndaaa	TRUE
jbklakefkbejnohicd	TRUE
jlfpekcglgihjoabcd	TRUE
jlgaenkklamengibab	TRUE
kfgklekkjdhljkabab	TRUE
kfimfnhllohgmpabab	TRUE
laeggfieggfakemlaa	TRUE
laegpjkidmpaloloaa	TRUE
lkpijffdiccedmabcd	TRUE
llacgkbgnleopocppd	TRUE
menkcbigbjaonmagaa	TRUE
meomcjmkplmhmfabcd	TRUE
mpbaikpgnpjfegfaaa	TRUE
mpcbgnfnkelbhkaaaa	TRUE
njipoiekoeoaagbhab	TRUE
njjipohkiecmcakbab	TRUE
odfhnojkhaeinclaaa	TRUE
odgadhaaocngofiela	TRUE
ompkpcchdagabnhjab	TRUE
onabdnofbeplefdmcd	TRUE
pglilbflbmafapblaa	TRUE
pglmgfaenpddidajaa	TRUE
aadhdgbkjhmmkbakjc	FALSE
aadkbddjfolpgdhemk	FALSE
akedncbefcbeagcolm	FALSE
akejejfbhbgjbjcknf	FALSE
beldedngafkefhnhco	FALSE
belgcmeolfpjnjlhbk	FALSE
bofipemgoknfclphai	FALSE
boghlccoijegcmclok	FALSE
cianmojiphdacahpbn	FALSE
cibbmhmiejkjekgfnm	FALSE
dcafbdagepfamjommd	FALSE
dcamgeednjggligaed	FALSE
dmcnhddoeahpnddhce	FALSE
dmdbfbpoihiaagjnbo	FALSE
egidagaeffofgcbpah	FALSE
egijoiahikcmmkdjna	FALSE
epnolilnmmhkbkdegp	FALSE
epnophfcicimglkfgd	FALSE
fkcneceglmnbmibcee	FALSE
fkhcfhahfmaojfpopc	FALSE
gfgifcgillpnalmihh	FALSE
gficbchfkljdekpfca	FALSE
gohjnbejefkmcnglkh	FALSE
gohmjkiocecddgffch	FALSE
hjpbloecjpcpbmjoof	FALSE
hjpfiakoiedddhboka	FALSE
ieaimlbnmojllomhjk	FALSE
ieaocciljcopcjopia	FALSE
iodnahikipcpokcaap	FALSE
ioejacphkhggiocdic	FALSE
jiokmpldnkfdmgpnpd	FALSE
jiponlhmfpcahpfahp	FALSE
kclplcnpkbbdbnklee	FALSE
kcmajchniknpnnjcna	FALSE
kmhmamclbbiohblfnk	FALSE
kmhpfekieakjphjnbp	FALSE
lgpaopjpnokafcmmdc	FALSE
lgpjoegfmimeijfnmd	FALSE
mbijpioplfkeeilfgi	FALSE
mbjojjidcmkpmcjbil	FALSE
mmchejjnkhbbodlljb	FALSE
mmcjjekhiicipdedji	FALSE
nfilcppoianpdlfkoc	FALSE
nflfkmkgomafklmaig	FALSE
oaejlimgjchjpenlie	FALSE
oaghchpkmgeagldaoo	FALSE
olejdleondlmpcfbjm	FALSE
olfknjobdfdoljpecl	FALSE
pfhpefofdelpaafchp	FALSE
pfijngflgnfdcdlabe	FALSE
aadhdgbkjhmmkbaihab	TRUE
aadkddjfolpgdhemkaa	TRUE
akfmakdpgdlibioilcd	TRUE
akgmildbpibhlclmbid	TRUE
bekhmjgdaokilciapaa	TRUE
belhfomngncbfmfaaaa	TRUE
boicenngjdhgnimaaaa	TRUE
boigojhmjmlkmanmbab	TRUE
cibpkgoeahklkllcbab	TRUE
cicbhookidihibjaaaa	TRUE
dcecjnfphffbjcjabcd	TRUE
dcfciaigbafhpmbpbkj	TRUE
dmikeopgaklhkjamcaa	TRUE
dmlhphmechaeeaolkaa	TRUE
egnmhchnndkgafepaaa	TRUE
egoafeckdeimakamoaf	TRUE
epnkoogimljdkohaaaa	TRUE
epocbcfgjdnklikabab	TRUE
fkielhbhibichknaaaa	TRUE
fkijgkgiopbkhllaaaa	TRUE
gfgnceienhbhbbfaaaa	TRUE
gfigppeagfcdcolnaaa	TRUE
goldpnohddlajcbjhcd	TRUE
gomdapjepafalgjajkk	TRUE
hjlloeoljaoonbpikcd	TRUE
hjllohebdpildnmaaaa	TRUE
ieineahdopmegodfbcd	TRUE
iejdhbakemibloophab	TRUE
iodgdehnpikdgphaaaa	TRUE
iogcebmeklomabgnbcd	TRUE
jihhodnmoejlppfabab	TRUE
jiiehhekfefdffoabab	TRUE
kdbkeddmkbebkhnaaaa	TRUE
kddabjgejgeibjgpeab	TRUE
knhnmlkakkdalfodbcd	TRUE
kniacafmbpgcoknhegd	TRUE
lhhgoafiagfekdafnda	TRUE
lhiajdladenenkfjeaa	TRUE
mbkiafkhnfonljpjbab	TRUE
mbkkccppmojbfddaaaa	TRUE
mlfodbfencoaikfkaaa	TRUE
mljhncdmcbhebleabab	TRUE
nggpjgngcjfeedlabcd	TRUE
ngibckpmnhkifbgaaaa	TRUE
oainkmkfaceoidcljaa	TRUE
oajkajhjbpmfknledcd	TRUE
olcdbdmpldcmigdabab	TRUE
olcmehjopdhkfdlabab	TRUE
peokkncalngdcbfjgcd	TRUE
peppgbldjdleondabab	TRUE
aaaljcbhdkjogjgdckg	FALSE
aaapgpopghclmblljmi	FALSE
aklndfogjhfpedkmdpj	FALSE
akncnahlbffibldkcfn	FALSE
begccbngoanhdfchcml	FALSE
beggokfhdokckelpbck	FALSE
bomdaiaacgbgmknhjbf	FALSE
bomhckgacgdepdinlid	FALSE
cjfcoaoelcobcpcjpon	FALSE
cjfnejmceafnhochmja	FALSE
ddbbnemgeeihbpnbbaj	FALSE
ddcicabjbdlgmolochp	FALSE
dnfpgcndlolnedjboji	FALSE
dnhedodnaljmdlpaaeh	FALSE
efiobbpfcpkpkamdldh	FALSE
efjdjjmnbldmhldcgcd	FALSE
fafemnipffcfienakmh	FALSE
fafibofddamccniffcc	FALSE
flleimfmaacmlkjlmhk	FALSE
flmbjeofbfipgabndij	FALSE
gfgloechpfpalcafimj	FALSE
gfihalclclcpihcamon	FALSE
goonnnbkpkllhnjongg	FALSE
gopgkkpplnedkolbdmb	FALSE
hipemakkdambppimanp	FALSE
hipnpeleofmheiegmee	FALSE
icjbhfdklncdnapobll	FALSE
ickakhbpoibnbhjnmlc	FALSE
indgmiokadnanoepmkc	FALSE
indgoohplejidiaicld	FALSE
jifholfhepkimnpimed	FALSE
jihbagjodpkdighfljo	FALSE
kcednpehkfhklmpopee	FALSE
kcgiolchfhmafopdhlc	FALSE
kndaoonellcfifojnhp	FALSE
knegbmekpggkhfjnkbg	FALSE
lhoegjdmllkpocgnpcj	FALSE
lhoejjdfmikmcpkjkhb	FALSE
mbnichgjmbmhbgjbldh	FALSE
mbnkpboilibcnlnhbpo	FALSE
mmeiihngofcfgbkadie	FALSE
mmgeeejolkmhejjplnh	FALSE
ngcmmnehgbkiabjjafd	FALSE
nggpllkedblhgbooodp	FALSE
oajmafaploiienidhik	FALSE
oakpofodbblfoegojpn	FALSE
olibkemoepdhjlneehk	FALSE
oljecpfgnilnialeeef	FALSE
pfkambcaagpnookpilg	FALSE
pfkaogiokncihojmnlp	FALSE
