aaahaonnlo	TRUE
aaahinebma	TRUE
allbjcjaaa	TRUE
allknmlaaa	TRUE
beokggaaaa	TRUE
beolpiaaaa	TRUE
bpmhojaaaa	TRUE
bpnhogaaaa	TRUE
clblhdaaaa	TRUE
clcmnlaaaa	TRUE
dfbcbgaaaa	TRUE
dfbgjiaaaa	TRUE
dplnifaaaa	TRUE
dplnmbaaaa	TRUE
ekgbinaaaa	TRUE
ekhaplgaaa	TRUE
ffhcakpaaa	TRUE
ffhfliaaaa	TRUE
foobeoaaaa	TRUE
fooinkaaaa	TRUE
gjhbofaaaa	TRUE
gjkdjgaaaa	TRUE
heieieaaaa	TRUE
heiiegaaaa	TRUE
hobagjgaaa	TRUE
hobfliaaaa	TRUE
iipomkaaaa	TRUE
ijahccgaaa	TRUE
jcimieaaaa	TRUE
jckgbpaaaa	TRUE
jnfadmoaaa	TRUE
jnfemnaaaa	TRUE
kgjmpiaaaa	TRUE
kgjomfaaaa	TRUE
lahhhdeaaa	TRUE
lahoinbaaa	TRUE
lkcindaaaa	TRUE
lkdkgbaaaa	TRUE
mehgbdaaaa	TRUE
meihhmaaaa	TRUE
mojmplaaaa	TRUE
moknhlaaaa	TRUE
niahdndaaa	TRUE
nialcjiaaa	TRUE
oblajkiaaa	TRUE
obloklaaaa	TRUE
oklccoaaaa	TRUE
okmfmgaaaa	TRUE
pfbimlaaaa	TRUE
pfclhgaaaa	TRUE
aaaiboompo	FALSE
aaaipfcnff	FALSE
alhcmaoonp	FALSE
alhgdpeppd	FALSE
bgfbbbicpm	FALSE
bgfhfegkhi	FALSE
bpolobcage	FALSE
bpommgkpgn	FALSE
clioipkidp	FALSE
cljjdojlfa	FALSE
depfjikbae	FALSE
dephffphei	FALSE
dpjjjjobcp	FALSE
dpkefmfogf	FALSE
ekcicgfopd	FALSE
ekdgankkpe	FALSE
fedoldbcik	FALSE
feedpfgdib	FALSE
fojgialfmo	FALSE
fojohilepi	FALSE
gjbfnojnmg	FALSE
gjcbnkfanl	FALSE
hdnmaeoekj	FALSE
hdnopopddd	FALSE
hoblpnnnme	FALSE
hocnleeokn	FALSE
iifgopljip	FALSE
iigfphdmgi	FALSE
jcloeoehbb	FALSE
jcncllncgd	FALSE
jmoijfnkbd	FALSE
jncahhgonk	FALSE
kgljejocoh	FALSE
kglpejkfbo	FALSE
lahfldinkj	FALSE
lakndihgjg	FALSE
lkikekddmp	FALSE
lkinflkphe	FALSE
meojcjfimf	FALSE
mepdidopoj	FALSE
molldgeika	FALSE
molnpbanpl	FALSE
nhpdmenank	FALSE
niaomjgbjj	FALSE
oblfjbcdfa	FALSE
oblkjfnonf	FALSE
olednhidkm	FALSE
olemjmifhn	FALSE
pfkfgogdle	FALSE
pflehmnfnm	FALSE
aacfofdjgaa	TRUE
aadecfiekaa	TRUE
albgjigcaaa	TRUE
aldnglchaaa	TRUE
bekmdjcaaaa	TRUE
belkanlbaaa	TRUE
bpcfnioaaaa	TRUE
bpcmabhdaaa	TRUE
ckdefdoaaaa	TRUE
ckdehkoaaaa	TRUE
ddapkaefcaa	TRUE
ddbfafhcaaa	TRUE
doflaacnmaa	TRUE
dofplbdaaaa	TRUE
ehnnhlgaaaa	TRUE
ehnpdnkaaaa	TRUE
fcfbjliaaaa	TRUE
fcffbphaaaa	TRUE
fnhdjngaaaa	TRUE
fnhhkdoaaaa	TRUE
ghjlhloaaaa	TRUE
ghkamekkaaa	TRUE
hcgipogaaaa	TRUE
hcibeljaaaa	TRUE
hmmljdaiaaa	TRUE
hmoalmnkaaa	TRUE
igjogggaaaa	TRUE
igkgcjeaaaa	TRUE
jcamhcclaaa	TRUE
jcbdjehaaaa	TRUE
jmlilpjaaaa	TRUE
jmmjdmgaaaa	TRUE
kgkclecaaaa	TRUE
kgkeecjaaaa	TRUE
laijcgbmaaa	TRUE
laipioiagaa	TRUE
ljlelhkaaaa	TRUE
ljmcicpaaaa	TRUE
mdagemabdaa	TRUE
mdakbbmpaaa	TRUE
mmbmohdaaaa	TRUE
mmdnjlhaaaa	TRUE
nghhgflaaaa	TRUE
ngijmdlaaaa	TRUE
obnoiepaaaa	TRUE
oboghepaaaa	TRUE
omfbdfdaaaa	TRUE
omfbgfhaaaa	TRUE
pfemhicaaaa	TRUE
pfgcoimaaaa	TRUE
aacfofdjgee	FALSE
aadcfiekboo	FALSE
alanodncoml	FALSE
albeoogpphi	FALSE
bfifcepnimb	FALSE
bfjfgnjobeo	FALSE
bpdeabaehhl	FALSE
bpdhefamdao	FALSE
cjibkncojjc	FALSE
cjifnofkdaa	FALSE
decnkgcabjo	FALSE
dedfafmhlld	FALSE
dobgpbmiaja	FALSE
dobhlfhdgha	FALSE
ehobeakcdnb	FALSE
ehocobdpfjj	FALSE
fcealigofec	FALSE
fcegiejapbl	FALSE
fmpciailmgn	FALSE
fnacahdocfp	FALSE
ggneaegfklp	FALSE
ggnmepajjgj	FALSE
hcdoeeibage	FALSE
hcdogmeihog	FALSE
hlnmnnolbbl	FALSE
hlnodmlkkml	FALSE
igmlkmjfinj	FALSE
igoobgmkhma	FALSE
jbnjjpdfllb	FALSE
jbnofconenn	FALSE
jmlddfelpin	FALSE
jmlodhikogn	FALSE
kfodbjmloca	FALSE
kfponlfdgoo	FALSE
lafkpmbcaap	FALSE
lagigogajlj	FALSE
ljoglohhpfn	FALSE
ljogmbchmng	FALSE
mdfpbjfenbp	FALSE
mdgehgmckdk	FALSE
mmkpmibclcj	FALSE
mmlabilgkfc	FALSE
nhiggeapppc	FALSE
nhjhkjojbnc	FALSE
obnodapiich	FALSE
obnomhcnnkp	FALSE
omhficcekfa	FALSE
omhiladaefb	FALSE
pfokpomjcme	FALSE
pfpjfjhljog	FALSE
aabofihfnpaa	TRUE
aackfaafnkoi	TRUE
akonkjebpaaa	TRUE
akppenpgnaaa	TRUE
bfacoplmpaaa	TRUE
bfaecijbmaaa	TRUE
cacmemmhmaaa	TRUE
cadmiggpeaaa	TRUE
ckgaccmedaaa	TRUE
ckgginfeaaaa	TRUE
defhkfcdaaaa	TRUE
deflcgcfaaaa	TRUE
dpgbajfhlaaa	TRUE
dpggeeilaaaa	TRUE
eimlmfhlaaaa	TRUE
eimpokjlaaaa	TRUE
fdnglapcjaaa	TRUE
fdocoihiaaaa	TRUE
fnpkmgomaaaa	TRUE
foamkpellaaa	TRUE
ghpdoengaaaa	TRUE
giacfdnblaaa	TRUE
hbokfbcbaaaa	TRUE
hbpgopkbaaaa	TRUE
hmacgnhfnaaa	TRUE
hmacmpfeafaa	TRUE
ifamadijkkaa	TRUE
ifbbidhfaaaa	TRUE
ipknhkcnaaaa	TRUE
ipmbihnlaaaa	TRUE
jjiaffhlaeaa	TRUE
jjiiieaiaeaa	TRUE
kddmjihgaaaa	TRUE
kdeilmgkaaaa	TRUE
kmdpcjcdaaaa	TRUE
kmflkohkaaaa	TRUE
liefcmdeaaaa	TRUE
lieiofgjaaaa	TRUE
mdfkjpneaaaa	TRUE
mdgnjblbaaaa	TRUE
mobkgociaaaa	TRUE
modhafcamcaa	TRUE
niophlekaaaa	TRUE
nipdmkmhaaaa	TRUE
odnhbdjpaaaa	TRUE
odoehoidaaaa	TRUE
onhocdpnaaaa	TRUE
onhpjkabcaaa	TRUE
pglncnmabaaa	TRUE
pgmciiikaaaa	TRUE
aabofihfnpkf	FALSE
aacabgolpjmk	FALSE
akpnglofgnlf	FALSE
akppmfdoblei	FALSE
bfdnnpmbdpcd	FALSE
bfeilbiaomil	FALSE
caibicmmgapd	FALSE
caiglocncodb	FALSE
ckpeejlicbpf	FALSE
ckppcnfggmdd	FALSE
defajpbhlhfc	FALSE
defnoopgmeej	FALSE
dpdigfnjobmp	FALSE
dpdlhpbdicgb	FALSE
eimcbdajogac	FALSE
eimjfkjjkkoh	FALSE
fdkfdkkpkdah	FALSE
fdocaikdgcib	FALSE
fnhgjdpdobkd	FALSE
fnhnjliinlmi	FALSE
ghjnhdnllnje	FALSE
ghlbpcemcepf	FALSE
hbihcjhkbdia	FALSE
hbjepaljeidi	FALSE
hkonnkgjeceg	FALSE
hlcadgnokmbl	FALSE
ifnoifacgmof	FALSE
ifocgeahheob	FALSE
ipjjlkdafden	FALSE
ipmbmbhiomjl	FALSE
jjglkkeklilp	FALSE
jjhaajilfkga	FALSE
kcmlgclbfkkl	FALSE
kcooelcncoec	FALSE
kmeaakdaoefg	FALSE
kmgcfldaphdh	FALSE
lhgllkhogoan	FALSE
lhgpohfjeeal	FALSE
mdbmpnhkkihi	FALSE
mdbnfpbffoci	FALSE
mnhkihbgljon	FALSE
mnkkhkoaimkm	FALSE
niffdojmcgdc	FALSE
niflcppnimmb	FALSE
odhblaadlppk	FALSE
odhngkfmmkog	FALSE
omnmjnjpgcpj	FALSE
omocfhpninob	FALSE
phcfpjogjddf	FALSE
phcmbbhjbhjn	FALSE
aabgggdjfbdaa	TRUE
aabjkmdoaella	TRUE
aknnmfcgpjaaa	TRUE
akoblinbknaaa	TRUE
bfcbnfojmaaaa	TRUE
bfchfbkldaaaa	TRUE
bpfekcmbeaaaa	TRUE
bpgdedlngaaaa	TRUE
cjhdbjmdgaaaa	TRUE
cjiphbgnbaaaa	TRUE
dcmegefpfaaaa	TRUE
dcmkcbpjlaaaa	TRUE
dmgehnomnaaaa	TRUE
dmgmcfgojaaaa	TRUE
egkagidcngaaa	TRUE
egkohdghiaaaa	TRUE
fanicgajldoaa	TRUE
faopjcpppoaaa	TRUE
fkamoidookaaa	TRUE
fkancgfmelaaa	TRUE
gejehfceeaaaa	TRUE
gekdmnknoaaaa	TRUE
goemegbhpaaaa	TRUE
gofioilcnaaaa	TRUE
hjiblkmhjaaaa	TRUE
hjkfdodhoaaaa	TRUE
icnfndhkiaaaa	TRUE
icpfppnpdaaaa	TRUE
inkhhlopkaaaa	TRUE
inkiklgbpaaaa	TRUE
jhnggjbgbaaaa	TRUE
jhonaejijnaaa	TRUE
kchlhhkmfaaaa	TRUE
kchmdobidaaaa	TRUE
knacmhihdkaaa	TRUE
knancidmiajaa	TRUE
lhediabifkaaa	TRUE
lhemmjahjfaaa	TRUE
mblphdiaaobaa	TRUE
mbnpomocabaaa	TRUE
mljoggedoaaaa	TRUE
mljpjdkfpaaaa	TRUE
nfpgbcbpdaaaa	TRUE
ngafiejmnlaaa	TRUE
oafpiikgdahaa	TRUE
oajcbfjgkfaaa	TRUE
omiapildlbaaa	TRUE
ominiaihhbaaa	TRUE
phbhmiobkaaaa	TRUE
phbnnoijlaaaa	TRUE
aabgggdjfbdkm	FALSE
aabjdoafmmblm	FALSE
akmdgdadmopeo	FALSE
akmdglfoicgbp	FALSE
bepeglnhnpaco	FALSE
bfapmglgpoahp	FALSE
bomhlnjmgdlon	FALSE
bomnjoiblpaoc	FALSE
cjbnalplmfage	FALSE
cjcbjnimnjkgk	FALSE
ddmnihblbkknc	FALSE
ddpoifppddamd	FALSE
dnajkbdbejjfe	FALSE
dnchnmkecnimf	FALSE
egkedecjfpnof	FALSE
egkjnnjljffnp	FALSE
fahbpkeagnafc	FALSE
fahnepmlogbnh	FALSE
fkdecgoiaeakp	FALSE
fkdelenmddblk	FALSE
geocjfcgckpan	FALSE
geoeocjkfmhoe	FALSE
goompcjenmmek	FALSE
gpacodogpjand	FALSE
hipffgipdkkjh	FALSE
hipgaokjaggfn	FALSE
idkocpdddifhe	FALSE
idlohbajjcckh	FALSE
inlbajgcgadcl	FALSE
inlfmmgkgefbk	FALSE
jhmlagopbhcmp	FALSE
jiamoalhdmcdf	FALSE
kdbpmekfpgaai	FALSE
kdcddnpajplcf	FALSE
kmofkflpfpfhe	FALSE
kmpfjjkajfjkh	FALSE
lgdhagkalhihm	FALSE
lgekjcafkloag	FALSE
mbapojnkoomkl	FALSE
mbccmcfjbbfal	FALSE
mlckldlcaemkp	FALSE
mldknkmfbigko	FALSE
nfgijojpjhhmg	FALSE
nfgmmaijkkidb	FALSE
oahhijaoodjcj	FALSE
oahjoddmiipma	FALSE
omfcipbonibpo	FALSE
omfkjaadmcmpb	FALSE
pgnbpppbbldok	FALSE
pgnffojmmnllj	FALSE
aabgggdjfbdkaa	TRUE
aabjmdoaellakl	TRUE
akgcjgbjbffaaa	TRUE
akkefgbemaenaa	TRUE
bffdhijmdlaaaa	TRUE
bfhedhokikaaaa	TRUE
bpbmbbjpidaaaa	TRUE
bpcfenhfpgaaaa	TRUE
ckbpkejecpaaaa	TRUE
ckcocigmfmaaaa	TRUE
ddojoebkcgaaaa	TRUE
ddpijgpbopaaaa	TRUE
dmohheiikfaaaa	TRUE
dmpdkebogmaaaa	TRUE
egiimdngieaaaa	TRUE
egiknggbnkaaaa	TRUE
fakicpdiodoaaa	TRUE
falnpmeajjipaa	TRUE
fkhmphdiebaaaa	TRUE
fkhoiiaajoebaa	TRUE
geffeieaeggaaa	TRUE
gefgjlgmpahaaa	TRUE
gnkgffjdliaaaa	TRUE
gnkifaiboeeaaa	TRUE
hipdlglbonaaaa	TRUE
hipiplbeefaaaa	TRUE
ideehffjlapaaa	TRUE
idegajbpaikmaa	TRUE
inncppmbkpaaaa	TRUE
innkhjlmiaeaaa	TRUE
jifgnmcbkdaaaa	TRUE
jifpdolcleaaaa	TRUE
kcnjgdkacliaaa	TRUE
kcokonnahnjaaa	TRUE
kmdicokfgoaaaa	TRUE
kmgflopdebaaaa	TRUE
lgmgamjjggdaaa	TRUE
lgnfbdpnehaaaa	TRUE
mbamkagaijehba	TRUE
mbdnfjcgijaaaa	TRUE
mlifghhaddjaaa	TRUE
mljmjgikojaaaa	TRUE
nfkombjldeaaaa	TRUE
nfkpmodiokaaaa	TRUE
oafopnhfjdbaaa	TRUE
oagijnjjkjhaaa	TRUE
olnbkllideaaaa	TRUE
olnmmfecboaaaa	TRUE
pglfbehddnaaaa	TRUE
pgmbccbbehaaaa	TRUE
aaabjejnechmpm	FALSE
aaabpcndmfcnld	FALSE
akaklffchkjfoj	FALSE
akanefcjmigkhe	FALSE
bffdbbppjgcaga	FALSE
bffefigkofpjad	FALSE
bomailfjkcpaco	FALSE
bongicdcaflhcn	FALSE
cilnnhadmnacgm	FALSE
cimcgpchdcfhmb	FALSE
ddemhgboaplnfo	FALSE
ddgggagfpoobnn	FALSE
docambkbfadhpe	FALSE
doccldafookhlp	FALSE
ejfaigddhhgheo	FALSE
ejffegnjdlphlm	FALSE
fcnlbgkecoipfc	FALSE
fcocbcpfacincb	FALSE
fmlfomnfhainbm	FALSE
fmlimkbiikhkpp	FALSE
ggbmklamiahhnn	FALSE
ggcddobdgpdkdp	FALSE
gppghlkdpbhcga	FALSE
gppgohbglaeenk	FALSE
hljanhhaljilmh	FALSE
hljbamcpfdcgpj	FALSE
igokaidccjeiee	FALSE
ihabcepjoialhk	FALSE
jbbpfnlonocfbj	FALSE
jbcclgidhllcaf	FALSE
jkplmobjjkficb	FALSE
jlaagnodbicmlm	FALSE
kfjpdpccibfbkh	FALSE
kfkbpanhodkagh	FALSE
kocfdpbhcmbngh	FALSE
koeblglepiclgf	FALSE
lhimobkdhapebk	FALSE
lhindoffbdajji	FALSE
mbppnbepgbocoj	FALSE
mcapmkjdlnocac	FALSE
mldglkcemjjfhl	FALSE
mldgngkdmiapfg	FALSE
nfddjmallpiiab	FALSE
nfeejdjhapipkh	FALSE
oakgpndmgfhcoh	FALSE
oakjknhneckacl	FALSE
omdmbocjimlned	FALSE
omeiaaoioahddf	FALSE
pfbjdlkoohaoao	FALSE
pfcocnchppnnig	FALSE
aaafdgokfpgkhpa	TRUE
aaahklogkckedga	TRUE
akgmckcfjdhmaaa	TRUE
akicfflecnnkaaa	TRUE
benodgacpgbdaaa	TRUE
bepipeoojmpaaaa	TRUE
boemjcnegjkaaaa	TRUE
bogacbpblahcdaa	TRUE
cjdapnmdjpepaaa	TRUE
cjddjmofmppaaaa	TRUE
dcodnjcpomdaaaa	TRUE
ddanmddifphdaaa	TRUE
dmbihcbebonaaaa	TRUE
dmbmbdohjgcaaaa	TRUE
ehifldjehooaaaa	TRUE
ehjlbfnoiioaaaa	TRUE
fbkhlpbommgaaaa	TRUE
fblgldoblgpaaaa	TRUE
flcnfnagjkehaaa	TRUE
fldifjdkhajiaaa	TRUE
ggaappdiogkipaa	TRUE
ggciodondachaaa	TRUE
hahkighmnphbaaa	TRUE
hahojnakgckohaa	TRUE
hkipnjjnhmmaaaa	TRUE
hkjhalkfjnfbaaa	TRUE
ifeklhgpdmaoaaa	TRUE
ifelbgapmehhaaa	TRUE
ipdbeckncgfaaaa	TRUE
ipdcepingaoaiaa	TRUE
jjbbklaeajkdmaa	TRUE
jjcccgjfcdiaaaa	TRUE
kdidoodmijfaaaa	TRUE
kdikkjmaplmkaaa	TRUE
kohfddmpgecaaaa	TRUE
koikffmjcobaaaa	TRUE
ljbmmejmdnkaaaa	TRUE
ljcnljonnljaaaa	TRUE
mdgohmppolbaaaa	TRUE
mdhkoejglenaaaa	TRUE
mnmihbmipmhaaaa	TRUE
mnnhmclpkokaaaa	TRUE
nhfdmioknadbaaa	TRUE
nhgpekgmacodaaa	TRUE
obpcolkdljakaaa	TRUE
obpeekeglakpaaa	TRUE
ollhomlhfloaaaa	TRUE
ollloomeghpaaaa	TRUE
pfoclcifnbhaaaa	TRUE
pfofbejpabkmaaa	TRUE
aaagehplghlilmp	FALSE
aaaihldlfehgokd	FALSE
akfinebcglohfbh	FALSE
akfkdlkjncjccdn	FALSE
behpjfafagfonkm	FALSE
beimmfdbphnhpkp	FALSE
bolcgabanokcjgg	FALSE
bombfacggcmbdne	FALSE
cinfpoebigcppak	FALSE
cioopakmiemopac	FALSE
dcpodgmmhmkkaik	FALSE
ddaoheigafbghla	FALSE
dncehikdkcnlecb	FALSE
dndlbjoojehaaoe	FALSE
egpmdmmglnijbbj	FALSE
egpphlimaefgkdo	FALSE
fbgpjbinpdnoonk	FALSE
fbhjelciibonbgo	FALSE
flhgiiohmbdomih	FALSE
flidbmkfggcdpla	FALSE
ggehfdofmpopkib	FALSE
ggekkfoipmpdfin	FALSE
hahldoelomkmdla	FALSE
hahmgppgnneeojl	FALSE
hkbgfpifpbehdhe	FALSE
hkcbpdeagajmepn	FALSE
ieeedbogkakflik	FALSE
ieeondpmiolhjjd	FALSE
ipgafnfcklopljm	FALSE
ipjjcgpikkbicop	FALSE
jjjkaehipamkpkm	FALSE
jjkknchkbemfcij	FALSE
kefglibholmghop	FALSE
kefkgpkaboomhge	FALSE
kohnhkloopcfoii	FALSE
koialigihglgmom	FALSE
ljgilkdkemffhai	FALSE
ljiikmhoafgmjjj	FALSE
mdeihnfogkfpfac	FALSE
mdfcpehjcjjbmjh	FALSE
mngicbfojdbjlkk	FALSE
mnjkgnjdckfibkb	FALSE
nicdedcdkjlfnof	FALSE
nieajofcocomfkl	FALSE
obkdechfemfpacp	FALSE
obkmfnolkajmdcb	FALSE
olpohbjkdjnbepc	FALSE
ombdihmiknhmmpn	FALSE
pgcclmaiainheee	FALSE
pgcfienaffkenao	FALSE
aaaehchofieicnaj	TRUE
aaaolbddfmppaabo	TRUE
alahknfijagkebpa	TRUE
aldbpigjcgcgnaaa	TRUE
bfijdinjpjnfaaaa	TRUE
bfjkoailidbohaaa	TRUE
bpheiihkgmnhaaaa	TRUE
bpjlbnodagmccaaa	TRUE
cjjiiabgfjebgaaa	TRUE
cjkfdcfloncbaaaa	TRUE
degfgidkmlfbaaaa	TRUE
degpnddmmadffaaa	TRUE
dnoedcffmoomaaaa	TRUE
dnolidocbcpakaaa	TRUE
ehmaikaaekahfbic	TRUE
ehnjlkpfddgeaaaa	TRUE
fcgfmdkdbfjdaaaa	TRUE
fcghnkfpfagdgaaa	TRUE
fmjfgnnmcdcjaaaa	TRUE
fmlejklaefiodaaa	TRUE
gifoponcihioaaaa	TRUE
gigaphanmehahpoa	TRUE
hbiocelalnckbaaa	TRUE
hbjeldffmiebaaaa	TRUE
hmapbemkpnoahjaa	TRUE
hmbacpgjcdcicaaa	TRUE
igienbnaikhnmaaa	TRUE
igihedlmomfeaaaa	TRUE
jbnhibhechnkaaaa	TRUE
jbnlkfojbohanaaa	TRUE
jldjphbdnkooaaaa	TRUE
jlebgamnofciiaaa	TRUE
kefjgpcjcpbamaaa	TRUE
kefmenigkfobaaaa	TRUE
kpalbkilejhfjaaa	TRUE
kpanlmmhcacfebaa	TRUE
lijjghgeegameaaa	TRUE
likkociaajbdooaa	TRUE
mcillnfgnbjcaaaa	TRUE
mcjnacnimcklbaaa	TRUE
mlmmipbmnglpaaaa	TRUE
mlnjcbejolbfaaaa	TRUE
nflnellgapkkeaaa	TRUE
nfoacepobnnogaaa	TRUE
obblakikmgdafana	TRUE
obgpmdbgaiillaaa	TRUE
omfmjiomebmlaaaa	TRUE
omgldojkpfllaaaa	TRUE
pghmfjfbibgjaaaa	TRUE
pgidjabnccgcgaaa	TRUE
aaafidipgjfjdobk	FALSE
aaapmceegnbbcpcg	FALSE
alamejkphcdiampe	FALSE
albdbhcfoddpekdp	FALSE
bfdkbkiojpphdkbe	FALSE
bfdnelokkihmbdpp	FALSE
bphgjmncbiohdlgp	FALSE
bphgobeeaiacdnal	FALSE
cjhfaahpdkmjlfjl	FALSE
cjiddkcdneidpdfi	FALSE
deeanlibhhbmglfl	FALSE
deeddcnmphjflinl	FALSE
docghijkeikeococ	FALSE
doclelieaohiahim	FALSE
ehpieaoiehkggpjk	FALSE
eibnepmlejpenkhp	FALSE
fcfflmlmmkfpfppa	FALSE
fcgidemahpnmakdm	FALSE
fnbjjnoccikphjig	FALSE
fnbpfpmhcegjdkda	FALSE
ghlpfmeoehboiajk	FALSE
ghnndbjbdlealngm	FALSE
hbmmcfgdllddiabb	FALSE
hbngmpdionlapngb	FALSE
hmbgbodmbaeghkie	FALSE
hmccmfaimklkmlab	FALSE
igjjkmmlfimmjnna	FALSE
igkalpckghbgmbof	FALSE
jbflcdcifcnfjkno	FALSE
jbfnhilnkhipaknn	FALSE
jlcblblpedflgbgk	FALSE
jldghcmodjbncicf	FALSE
kfaljcmbadnneenf	FALSE
kfcabogpoklidbkc	FALSE
kooiladfgjfednob	FALSE
koojiofimanchmno	FALSE
liefdgndfhjlfgod	FALSE
lieflacghhpollch	FALSE
mcidoeehpkohjihk	FALSE
mcikindkihcnmmae	FALSE
mmkfhmlonemfkdjj	FALSE
mmkniloccleacbeb	FALSE
ngojhjpdkgafmfcm	FALSE
ngphaimcadljidlj	FALSE
obncajjkgcgcedlc	FALSE
obncnadpmnjcdoia	FALSE
ombahiiendffpdck	FALSE
omcifkhhncjbadem	FALSE
pgpgkblobbdpiofm	FALSE
phaaigipnoknmagc	FALSE
aaakgdigmlinjibfa	TRUE
aaamlckeoolfcpcfa	TRUE
aknphgihndlkgkaaa	TRUE
akplbafaopbmelfla	TRUE
bfmhpbofckmhfaaaa	TRUE
bfojidbkldjkmaaaa	TRUE
bpmemaeipopognaaa	TRUE
bpnbcfgpfhpecaaaa	TRUE
ckcafjpobgdjfpaaa	TRUE
ckdbieingllllaaaa	TRUE
dedmjopnilcfcaaaa	TRUE
deenedembgfkdaaaa	TRUE
dobdcpennfijpaaaa	TRUE
dobdgeipciobeaaaa	TRUE
ehgblnlbkdjmdaaaa	TRUE
ehgdbmkpnapgelaaa	TRUE
falhfkjgkokdgoaaa	TRUE
faljffjcaannaobfa	TRUE
flfdijadohlbacpaa	TRUE
flfkimancldhkiaaa	TRUE
gfhhkmalgnmkbpaaa	TRUE
gfhjcpbcnmoniaaaa	TRUE
gopihonokdaokfaaa	TRUE
gpbdoddlbemljaaaa	TRUE
hkbcfojgikjfkaaaa	TRUE
hkcpbkbefnomnaaaa	TRUE
igbofdoaolfbjpaaa	TRUE
igcknogmodbaooaaa	TRUE
ipiibkkgjemoabaaa	TRUE
ipjmjfphpckniaaaa	TRUE
jieaknpalbphbhjaa	TRUE
jiefligfnebmkaaaa	TRUE
kcjfeajleolnbjaaa	TRUE
kclpjknffkippaaaa	TRUE
kmobdbbmkgkmhaaaa	TRUE
kmobmkholmfdgaaaa	TRUE
lggoajedhncocjaaa	TRUE
lghdoemnlakmooaaa	TRUE
mbjmiafeojcbikaaa	TRUE
mbjnnogjhdnbmaaaa	TRUE
mlohjfkjhbcphaaaa	TRUE
mlonhobggjmpcaaaa	TRUE
ngdgfoibpenfkaaaa	TRUE
ngfeoilpgapfmamaa	TRUE
obnpninbfhfajfaaa	TRUE
obojhdbdaieldafaa	TRUE
omcciomhhohdmaaaa	TRUE
omddhagabgkohaepa	TRUE
pfkfdhbddfkkhaaaa	TRUE
pfljhigpecgoiaaaa	TRUE
aacapfiepcedgjjbe	FALSE
aadalofnbebimnkgo	FALSE
ajonnnbapeijlljmm	FALSE
akafdpiadglocbpmh	FALSE
bdokpcjjddmnhjnjb	FALSE
bdpgipaedkgjjhfmd	FALSE
boapkaaemjmhkfhhg	FALSE
bobhocababclheocm	FALSE
cideaplnmoakmjchm	FALSE
cienhjaklmdobbjda	FALSE
dcchacjdabibnggde	FALSE
dcclnhbihoacppamh	FALSE
dnbilpjdnfjipgmdi	FALSE
dnbjmmpgkajienlkj	FALSE
egbomplggpegjakok	FALSE
egdjpmnngdieefgbi	FALSE
fblggfoblbdoiknjh	FALSE
fbngbbllefpggfkaj	FALSE
fllbkiddgdjgdijjg	FALSE
fllejmekjgndmeong	FALSE
gelobcbgopoghcofn	FALSE
genappoeihmicopgo	FALSE
gpdkbjjnfcjahlfpo	FALSE
gpefcnhdbiggjnnbg	FALSE
hjnlcnmceiccemehp	FALSE
hjofokfjiejallmdd	FALSE
iefbcjdojcfogoplm	FALSE
iefbojkmifdmfjcdk	FALSE
ipbfidalhiebbapfc	FALSE
ipbldaacnnbodmodh	FALSE
jjmiepfnldaboodlo	FALSE
jjmkgofdjmfkbbihj	FALSE
kcfijpohhmmemflho	FALSE
kcfpfbjlciampogho	FALSE
kmgkpemdaphgepkdc	FALSE
kmgolehcidgnhncbg	FALSE
lhcifgbgcoacnajnk	FALSE
lhdjgohkpmolcoeci	FALSE
mcakojkknaiinelol	FALSE
mccgehlgfhkmjbkmn	FALSE
mmflfldkpmnoebmlj	FALSE
mmfpobidmcnjpmcnm	FALSE
nhipomojlmalffbjm	FALSE
nhjafadmfbgnjmfif	FALSE
obmdnohhppkikbcdg	FALSE
obncajmbjanibdddl	FALSE
olknjjagbfolhhngo	FALSE
ollnpieaabpfhjgcm	FALSE
pgajeggbpignjfhhe	FALSE
pgbffodnobpeoglpl	FALSE
aacaopehdobpdcfppa	TRUE
aadiaahknemadahlmj	TRUE
ajppiipekkaoalapnc	TRUE
akahocjdlampmhkfja	TRUE
bdkmogbfoeafbjoaaa	TRUE
bdkmpgjkfcmeehaaaa	TRUE
bocehholbfedamnaaa	TRUE
bocfhdmbhanophkaaa	TRUE
cifoaoejbkghlnhaaa	TRUE
cifpmegcknmnmjaaaa	TRUE
dcihofhjagaejpfcaa	TRUE
dcjgmniccndklfaaaa	TRUE
dmlblljnfekoadfaaa	TRUE
dmmndpogfofihjaaaa	TRUE
eghhafdndblnfebaaa	TRUE
egijnipognoaieeaaa	TRUE
fbmonkiblmpahlgaaa	TRUE
fbojfmcmiipjpbaaaa	TRUE
flbngpgpdicllanaaa	TRUE
flenpcgldnoijpaaaa	TRUE
gfekidjecmmjkkaaaa	TRUE
gfhpmfcoldhhdcaaaa	TRUE
gpeodkibcfccjacaaa	TRUE
gpfdnilopmhkdjaaaa	TRUE
hjndcndkejahonbaaa	TRUE
hjngpbfpighgphaaaa	TRUE
ieigejecacbpbcbaaa	TRUE
ieilcblhedeapgjaaa	TRUE
iolahdoemdkenmjaaa	TRUE
iomadmlmggahemdeaa	TRUE
jioaphpjgklaccmala	TRUE
jioppjmbpophjbaaaa	TRUE
kdimahhgcjpajekjaa	TRUE
kdjngfjeejcijmaaaa	TRUE
knnpdgfpnefdpalaaa	TRUE
knpfjooonkldabnaaa	TRUE
lgomibpafckopnjaaa	TRUE
lgopbfffbgmihfaaaa	TRUE
mbnjbjlggodfdlaaaa	TRUE
mbnkjahejkmlmkoaaa	TRUE
mmnnddhejcegddaaaa	TRUE
mmomhcknkbddcdaaaa	TRUE
ngobgopinilpfnaaaa	TRUE
nhbffibiabgkbagpaa	TRUE
objhjknnikanokiaaa	TRUE
objmpngidpjjbdaaaa	TRUE
olobddmcdaefldkaaa	TRUE
olonpmnoebmljoaaaa	TRUE
pfmonbbepnoiefaaaa	TRUE
pfnkkiigcpaoljfaaa	TRUE
aabgphhenjfhoogobf	FALSE
aaccdfbepencecmoad	FALSE
ajlancbgfhgjcapjlp	FALSE
ajmpgmibejdncfbhih	FALSE
belnblbajnfgecaiap	FALSE
bembhijhnidgcahoeb	FALSE
bpgpnpkilcbcjfnbgc	FALSE
bpipklofghdmenogkl	FALSE
cigjkkdjfngpllpfen	FALSE
ciglfjhlkihlhbjlbb	FALSE
dckpmeekgimcdekklf	FALSE
dcmcgodccokcgdfpmf	FALSE
dmjbnpckbcehnoidjc	FALSE
dmjkipghginmkijcdi	FALSE
egjlaphgjlhkicnfdg	FALSE
eglnmfeckahabnnggb	FALSE
fbdcokgjinpcgfbphg	FALSE
fbdnemfnecddbcknpf	FALSE
fkmapchmococfogdjm	FALSE
fkmbbndddlgfhnhmfk	FALSE
gecnmmkikibpahnekc	FALSE
gedblilincjmoocfgf	FALSE
golgfainphnfoiedni	FALSE
gomaajmhkmpjkjiimn	FALSE
hiikbmajgapienheij	FALSE
hijldijdpkiajbgial	FALSE
icmkahphcnheddnona	FALSE
icmpodmlippldfaiio	FALSE
inkjdpplgfcfnmjkbk	FALSE
inkkacgnoddchicgeg	FALSE
jhdpaeldbdnfkhkhpc	FALSE
jheppncaegcjgkokmc	FALSE
kbfnebipklnomjakfp	FALSE
kbhgppigldnbknomff	FALSE
kmddcbbpholncjajco	FALSE
kmdkgjbeofnllfhgol	FALSE
lhadhlnpdkccimmame	FALSE
lhaidjciomgebilgha	FALSE
malfipnbbecndcepag	FALSE
mamcogfdphlkaiplll	FALSE
mmdehkfoakplpeeodp	FALSE
mmdpoblialckpdmbgl	FALSE
nfpikdldcmfipaneco	FALSE
ngbamjbmgkclakhihh	FALSE
objghldnfopgndlbfo	FALSE
obkbgiedbpnbhbnggd	FALSE
okjmpdeebilfemfbmf	FALSE
okkgonjmnhbkckmpon	FALSE
pfkjpdhhnbhbpodlmi	FALSE
pfkpkfckdickiijbcl	FALSE
aablokdacjabgeldkog	TRUE
aacnikdbpflmknkbbaa	TRUE
akghkgdfhnciohknaaa	TRUE
akihgloeecnbjdhcaaa	TRUE
bdmcbefjfbmpiibaaaa	TRUE
bdmjmkdbdejjmfcaaaa	TRUE
bnllpblaiegjfembaaa	TRUE
bnmjepnbehejgmpaaaa	TRUE
chklafpndihonblnaaa	TRUE
chkljobopkgcpgnaaaa	TRUE
dbijkkbhgfdcmkhaaaa	TRUE
dbiofomjcfnknnbaaaa	TRUE
dkeifhdidpkpjgnaaaa	TRUE
dkejpmcoeeplkhpaaaa	TRUE
efnnbbfleonhgooaaaa	TRUE
efoedndanfngdecjaaa	TRUE
epanfjcpipgbknkeaaa	TRUE
epbbgcjfkfbhgelaaaa	TRUE
fjhmgingpfmhdgmaaaa	TRUE
fjiebnombhmbndfaaaa	TRUE
geijfjedlibnahbdaaa	TRUE
geiomfbbghkafolbaaa	TRUE
godpjmeldlfjcoeaaaa	TRUE
goeaccljhnclfhnfaaa	TRUE
hikeonphofcbenjaaaa	TRUE
hikfokebmejkoaabana	TRUE
idbmmicebgdfmokaaaa	TRUE
idchbecocobaclklaaa	TRUE
ipghefgnmkippanaoaa	TRUE
iphppkgfdfceegiaaaa	TRUE
jjkbgbalopeiodfbaaa	TRUE
jjkilcijenjabebmaaa	TRUE
kdfiejfpginnfimaaaa	TRUE
kdgnoodddfdcfogaaaa	TRUE
koapkmddinkikinnaaa	TRUE
kocimnolbkblnpanaaa	TRUE
lifdmhmbgklmflamaaa	TRUE
lifgcdnmbiemmfgaaaa	TRUE
mdmjdafhkicggoejaaa	TRUE
mdmlppclhadhhhpoaaa	TRUE
moilpmgnknkjijnaaaa	TRUE
mojgimgfecdibekaaaa	TRUE
njebaopjnbjjpploaaa	TRUE
njebndilceomgjjaaaa	TRUE
ocjabldjdcfnmabhoaa	TRUE
ockmfclibmaipnfcaaa	TRUE
omiiompjjdkjfnoaaaa	TRUE
omimoghgolapnmmkaaa	TRUE
pfimpegdjmnejlfaaaa	TRUE
pfjjcllcijeemooaaaa	TRUE
aabahljdkkbjclocnoc	FALSE
aacbjidoifhmfofjlbh	FALSE
akcfdgpcdboalephbmb	FALSE
akcomgcnlhjofbgckjp	FALSE
bdigmblafjpnjmjhbid	FALSE
bdikagmflmonllmmfcb	FALSE
bnmfpeideiobmlenffb	FALSE
bnndjmilacfjieigplj	FALSE
chnalodmmllgkigpfdm	FALSE
chnfgaaoddkhhcaeknp	FALSE
dcnldnmlclmjjjjbifn	FALSE
dcogdmleemmheoehafc	FALSE
dmnapdbpkolpmngefil	FALSE
dmodmbhihiknghdloob	FALSE
ehmpcclnlgdcaipkcce	FALSE
ehnfijgcdkdhbfjlmlo	FALSE
fdlbjoioceeimidehkp	FALSE
fdlgiplgdlggnimhkge	FALSE
foepijdbebakcklbfom	FALSE
fofefkopbalolajdapm	FALSE
ghopboaccahoekacgfg	FALSE
ghpkhepkjojpbokgpmd	FALSE
hcfidokpekofdbgiddf	FALSE
hcflnlnbckmgjjcfbll	FALSE
hmkojblakpigiocbpid	FALSE
hmmcklhdljflndkoamh	FALSE
igacbojbhffbjhndbnm	FALSE
igagocgkokpcciblicd	FALSE
ipccbgmoifdleeijdib	FALSE
ipcdfailaodhaemgbbl	FALSE
jkinhjahobckdcpeppg	FALSE
jkkbkonmbljgagclbbk	FALSE
kddlchjjnekflianmng	FALSE
kddmmdnaalgeneiedla	FALSE
knehmjakodefkoemkcg	FALSE
knfgjoebepeiklgidmn	FALSE
lidfoihgmodckfmfmmg	FALSE
liembfabonaccndojie	FALSE
mcjlheigddaabbjjkom	FALSE
mckfanjcelajadkmehc	FALSE
mnabdhjafeipgfpcpaj	FALSE
mnakhmlehacaddpifmm	FALSE
ngpjciholpnaeknpmeb	FALSE
nhacobaadcckhmbhjii	FALSE
obgealpffpkolkjgijf	FALSE
obglnfnphcdkdgdfhhb	FALSE
olccidajnefbnenaamc	FALSE
olchpnklpdpefhddjbf	FALSE
pfpekhcbdchgmkildnn	FALSE
pfpgjdlikfkdnooophl	FALSE
