aaaedcagcb	TRUE
aaailihkdb	TRUE
ajknihbgjn	TRUE
ajlblcjklc	TRUE
bdmebhilab	TRUE
bdodnjcmab	TRUE
bnigmnpbab	TRUE
bnijpkfhab	TRUE
chejkhjfab	TRUE
chgfedbhab	TRUE
dckjmoniab	TRUE
dcmcgcmoab	TRUE
dmahggknnb	TRUE
dmbcnifbab	TRUE
ehjcjnkadb	TRUE
ehkajdjfhb	TRUE
fbmpkaonab	TRUE
fbndakdnjb	TRUE
flogphmiab	TRUE
flpkdadfib	TRUE
ghcjchgnab	TRUE
ghdeiiiiab	TRUE
hbjpdpaepb	TRUE
hbkkbldoab	TRUE
hlnialnlkb	TRUE
hlobpodnab	TRUE
igaibcnnhi	TRUE
igbkibimab	TRUE
jbbnpoomab	TRUE
jbcpbmagfb	TRUE
jljoelndab	TRUE
jlmajpakjb	TRUE
kfmeifldab	TRUE
kfnhgbegab	TRUE
lalcnhaoab	TRUE
lambmdnbgn	TRUE
lkacklcglb	TRUE
lkahejmlhb	TRUE
mfmimodnab	TRUE
mfnahmgcmb	TRUE
mpgooefpab	TRUE
mphaoohkab	TRUE
njmhecngab	TRUE
njnalofafb	TRUE
ocklganlbh	TRUE
ocklokgmab	TRUE
onegnmekab	TRUE
ongjeimeab	TRUE
pgpoclcoab	TRUE
phbaiilmeb	TRUE
aaafjlmfpe	FALSE
aaahlpjdjd	FALSE
ajlcfeklol	FALSE
ajlhkkjfcp	FALSE
bcildmogdj	FALSE
bcjdbpeaoa	FALSE
bmphmiogah	FALSE
bmpninmgpb	FALSE
chfmbncdde	FALSE
chgmfpdgki	FALSE
dbnedjhjle	FALSE
dbohhfilfg	FALSE
dlokdkgalh	FALSE
dlpfpnnioa	FALSE
eglncbloio	FALSE
egncgbggil	FALSE
fbgiadlaik	FALSE
fbgnpmbimo	FALSE
flcjolljpl	FALSE
flcodmlkkg	FALSE
gghddngkge	FALSE
ggkcehiplh	FALSE
hbfgmnobci	FALSE
hbhmcikokm	FALSE
hmejlmdnlk	FALSE
hmepdociaj	FALSE
iglcbfamfc	FALSE
iglhgojfek	FALSE
jbkfmkmenp	FALSE
jbknejiikg	FALSE
jldcapcflk	FALSE
jldhldfgbh	FALSE
kfeaekkcjp	FALSE
kffpbbgaee	FALSE
lajnjidmcd	FALSE
lakcofgmkl	FALSE
lkhjnnecaf	FALSE
lkijdngmeh	FALSE
mekckcigli	FALSE
mekdajofih	FALSE
mpbglankoe	FALSE
mpdmppnbok	FALSE
njjllkjoeb	FALSE
njkagdmfkp	FALSE
odclnikigd	FALSE
oddhddopbi	FALSE
onbkbdakni	FALSE
onchfkmgjc	FALSE
pgjjnleigf	FALSE
pgkeeokdom	FALSE
aaalkafknnb	TRUE
aabehmemjid	TRUE
aljhdkmigdb	TRUE
aljiimdocbe	TRUE
bfjneeclmab	TRUE
bfkedjngpab	TRUE
caecpkioebb	TRUE
cafcandhhjb	TRUE
clpaipfpjcb	TRUE
clpocpldeab	TRUE
dfcplpbbdab	TRUE
dfdjjhojoab	TRUE
dpeghhagohb	TRUE
dpekfaikiob	TRUE
ejgmfbfbbab	TRUE
ejhipihnpab	TRUE
fdphdjppoab	TRUE
fdpjbmhkkab	TRUE
fobgmdmcgab	TRUE
foceanmfeob	TRUE
gijgiocecab	TRUE
gijhenagbeo	TRUE
hbkifdaocdb	TRUE
hbmnckahhbb	TRUE
hnanoaakiab	TRUE
hnbldgjlhab	TRUE
ihhhiakfbke	TRUE
ihhjcjbafmb	TRUE
jcapflfdinb	TRUE
jcbppkaginb	TRUE
jmhmjliegab	TRUE
jmjoflkabdp	TRUE
khfdidcoaeb	TRUE
khfpolcfbab	TRUE
lcjccgjmiab	TRUE
lcjekcnfhab	TRUE
lmcamgobhbm	TRUE
lmcgbneainb	TRUE
mgbbifdceab	TRUE
mgchibpniab	TRUE
moojcehmbab	TRUE
mpbffbcngab	TRUE
njdjmklcgab	TRUE
njeakohgeib	TRUE
odcnnfelkab	TRUE
odeleicfiab	TRUE
ondcciapdob	TRUE
oneelibkfab	TRUE
phaklcefllb	TRUE
phbjdmkhdab	TRUE
aaajegojeei	FALSE
aadnlalhlgi	FALSE
amcihplncgj	FALSE
amdhglkahoe	FALSE
bfffdddbkdm	FALSE
bffnijgagpp	FALSE
cafiinnljia	FALSE
cafljpoaphc	FALSE
ckminbapilm	FALSE
ckngaghejjn	FALSE
dfhhajaenii	FALSE
dfihahpigaj	FALSE
dopbibakfjl	FALSE
dpbhgnchafm	FALSE
ejnnmhpegpj	FALSE
ejpjmhgjlnk	FALSE
febfnlhkfhj	FALSE
febjnffaaka	FALSE
fohhccdikkh	FALSE
fokbbholnij	FALSE
gilddmopkbh	FALSE
gilmfhhenic	FALSE
hcgfdcfomjb	FALSE
hchikcclbmi	FALSE
hndnmgoehlh	FALSE
hndoihoaldi	FALSE
ihmedchfiik	FALSE
ihnhkhieidb	FALSE
jblldoppnnp	FALSE
jblncejjpgf	FALSE
jmgbcgjjdea	FALSE
jmjgcnchceg	FALSE
kifigapikji	FALSE
kifokfmmjop	FALSE
lblmdneeepf	FALSE
lbmncimdmjj	FALSE
lmadmgnhcne	FALSE
lmaejpnmcaf	FALSE
mffaegidljp	FALSE
mffhikpahnl	FALSE
monopjnkaoc	FALSE
moodkafhijd	FALSE
nipjglofmeg	FALSE
njbblemcfof	FALSE
odikbhnpdoh	FALSE
odjpcooifdo	FALSE
onelbiomain	FALSE
onfdaffmcji	FALSE
pgljknddceg	FALSE
pgmpcholmif	FALSE
aaalkafknneb	TRUE
aabhmemjidca	TRUE
alhjndpipdab	TRUE
aligagmichdb	TRUE
bfeafphblkdc	TRUE
bfefhajlkfnb	TRUE
cadihmofplfb	TRUE
cadmcgpojkob	TRUE
ckknajdgajpb	TRUE
ckkoccbmljab	TRUE
delehpiefnab	TRUE
delfjigfigab	TRUE
dpelcndcheab	TRUE
dpibojhalhob	TRUE
ejgkpjmbdeab	TRUE
ejhonaclofcb	TRUE
fdinmlkejcab	TRUE
fdjagmdbpleg	TRUE
fndinndplfab	TRUE
fnecoiiecoab	TRUE
giidjpdhneab	TRUE
gijoffnghpab	TRUE
hddpindkdkab	TRUE
hdfegfjiajkb	TRUE
hnihaollkefb	TRUE
hnimhijjoafb	TRUE
ihigchihlbab	TRUE
ihjabilmkcge	TRUE
jbjdccnodfab	TRUE
jbjeggcfdnab	TRUE
jmddijdbkkab	TRUE
jmdhflflnpab	TRUE
khamjehcbmei	TRUE
khcblodnikab	TRUE
lcffcgohfpab	TRUE
lcgpjkeadnkb	TRUE
llmkeffoabbf	TRUE
llneahkfnfdb	TRUE
mgelhhakpgab	TRUE
mggjfpnlnhab	TRUE
mpbidgoopcab	TRUE
mpbjnkkhncab	TRUE
njpbljlbebab	TRUE
njpefmoilnab	TRUE
odbomhfhbjab	TRUE
odcjdkejliab	TRUE
onflihjbopab	TRUE
onfloefenagb	TRUE
pgdjniemcdab	TRUE
pgehbomlheab	TRUE
aaalnadadmlm	FALSE
aacmagcnnanh	FALSE
akefkfddddmf	FALSE
akfoghpjfapg	FALSE
bepffebceimp	FALSE
bepfijnndcam	FALSE
bplgcbjnfgcm	FALSE
bplgeagadgnm	FALSE
cjodhnopknef	FALSE
cjonlkofohgd	FALSE
dfcdflpjnapi	FALSE
dfdbnfjcmeee	FALSE
doekcagpoiie	FALSE
dofonogiendc	FALSE
eicfnjmdifpp	FALSE
eidebgmgjogk	FALSE
fbndehiaigok	FALSE
fbnglicfegda	FALSE
fmnanfmpjlkk	FALSE
fmnclcaenonm	FALSE
ggnedbdndpgm	FALSE
ggnojlmejbhe	FALSE
hacjdfaeannh	FALSE
hacmicjloamc	FALSE
hkmidcjnmfih	FALSE
hkmpmdcpiboh	FALSE
ieelfnelohdm	FALSE
ieffhhailcnl	FALSE
iohpoopfhghb	FALSE
ioiaimpnganj	FALSE
jimfgjfijifh	FALSE
jimncooknfif	FALSE
kdfbjmmalpkf	FALSE
kdfbkoljddid	FALSE
konooeknkbeb	FALSE
kooooanamnaa	FALSE
libccbbgkgef	FALSE
lidebdglknjo	FALSE
mcmbpkilbdeb	FALSE
mcnbfopfndfe	FALSE
mnkgmoidnkgn	FALSE
mnkhbamiinkg	FALSE
nhooakfoinde	FALSE
niaikgmedlga	FALSE
obmldngjngid	FALSE
obnheifkpkja	FALSE
omlohgamoojo	FALSE
omlojjoilaai	FALSE
pfklnfbcnmje	FALSE
pfkmannimmnc	FALSE
aabnffnboekog	TRUE
aacfkikeamecb	TRUE
akbjalgjjpgmd	TRUE
akboalpfepmdm	TRUE
beemmgbldpbab	TRUE
beeoadbhaglng	TRUE
bpmhgbgihekab	TRUE
bpmpdnngdblab	TRUE
ckaneecnpdglb	TRUE
ckbhbkekafemb	TRUE
debginbkkdmab	TRUE
debmpddldpiab	TRUE
dobpdbeilipab	TRUE
docgnnmdmoeab	TRUE
eicdlhknaccab	TRUE
eiciljnjabokh	TRUE
fcbbhabjpbjic	TRUE
fcbgnnlhinnab	TRUE
fmlcpbldgnlab	TRUE
fmlioflcnheab	TRUE
gggingkipocab	TRUE
gghjbamcojjib	TRUE
haeimlkpolkjb	TRUE
haeokfjpbkoel	TRUE
hkaifcjpbpkab	TRUE
hkaledacfkkjb	TRUE
iebbojnfociab	TRUE
iechgmlccopab	TRUE
iognjeiklciab	TRUE
ioidkcciagbca	TRUE
jimaokljilljb	TRUE
jimmpicbjgpab	TRUE
kdjoodemioajb	TRUE
kdkgoledffmab	TRUE
koehikijheiab	TRUE
koehpplbkhcab	TRUE
lilnbdnanjiib	TRUE
lilomdkmijkab	TRUE
mddnfkjagcbbe	TRUE
mdeaeioagmlib	TRUE
mnoohkjdmecab	TRUE
mnpognlamffab	TRUE
niajgblchmdla	TRUE
niaobahpcpbek	TRUE
oboefcgbfchab	TRUE
obomccoihkiab	TRUE
omkbocmjfdoab	TRUE
omkjhmehbggab	TRUE
pgddpehhlcpab	TRUE
pgedkaipmfoib	TRUE
aacnofpmafnck	FALSE
aadfjagpcpgki	FALSE
aklilmghhfkdj	FALSE
akmcgclffdilh	FALSE
bfaimehiggnkm	FALSE
bfejpokcgccah	FALSE
bpgokiiapipdg	FALSE
bpiebjkldjfef	FALSE
cjkpdieacmdkc	FALSE
cjmengdpmghcj	FALSE
deifcmgbplnam	FALSE
deijenhmhoado	FALSE
dpgjedeldjhgo	FALSE
dphmjajapjoci	FALSE
ekbcboiikdmmj	FALSE
ekbgaeahdljkd	FALSE
fdklolmimjeli	FALSE
fdomindpigaji	FALSE
fopbdppjcknkb	FALSE
fpbjpodcahgek	FALSE
ginckenfeoagj	FALSE
gjaekfigllilp	FALSE
hegfnjpokgepa	FALSE
heglokhfhamne	FALSE
holppgdhhheia	FALSE
homahjegfhjai	FALSE
ijcmhofacoahi	FALSE
ijcoiiccbbalm	FALSE
jdecmlfomiceg	FALSE
jdfinlfbkfoli	FALSE
jmmkfigogdfhg	FALSE
jmnaddgnimopl	FALSE
kglbakdplecje	FALSE
kgnnpfhiegndp	FALSE
laoidjpjflghi	FALSE
lapgjdjlkefnd	FALSE
ljlkpnfhhoacj	FALSE
ljlonnfeihaik	FALSE
mdcjfnfjkjfih	FALSE
mddghlafiiiic	FALSE
mnednamimhhon	FALSE
mnegamjjdffii	FALSE
nhpafgpflgffc	FALSE
nhpbgfebpkibe	FALSE
oafpmfolcahod	FALSE
oagcemlpfneho	FALSE
okocaphomcnoj	FALSE
olagdmlcgondj	FALSE
pgknfopbilmmp	FALSE
pgmdoilnjcfce	FALSE
aaaadgccfcnckb	TRUE
aaagofjblogheh	TRUE
akmecpdidocojb	TRUE
akobhcnpihbhlh	TRUE
benfbpilmodhab	TRUE
benkglelggpcab	TRUE
bpdjpnbghdcbab	TRUE
bpehogmaiadcmb	TRUE
ckadnenpphijdb	TRUE
ckbbifnpehdmab	TRUE
dedelimdappihb	TRUE
deflgbhanofdhb	TRUE
dpjenmnmehodab	TRUE
dpjpnkmnpgeeab	TRUE
ejjndihhholpab	TRUE
ejkcijiipmboab	TRUE
fejkjikamdmleb	TRUE
fekinlilppfkab	TRUE
fpjgkjkgabnegg	TRUE
fpkcblihadhnlb	TRUE
gkiedahpabldja	TRUE
gkiihllmfjjakb	TRUE
heffbnpbmndiab	TRUE
hefflfpdmmjiab	TRUE
hokpniogakmhjb	TRUE
holagbojghjfkn	TRUE
ijcbpmlcjdebab	TRUE
ijcjjhanchfnhb	TRUE
jdhjpoeephahgb	TRUE
jdiaialblkecbl	TRUE
jndhpebiakmklb	TRUE
jndkhmmggmpmab	TRUE
kgnjmepnjlmfab	TRUE
kgnkjhhpahkgmb	TRUE
lamakmgdlgbhkf	TRUE
landkblknbjple	TRUE
lkcgbiaihgbmeo	TRUE
lkcgdbcgcnglab	TRUE
mdpipiojmhiagb	TRUE
mdpmnmgfmelakb	TRUE
mofifkohhkgjab	TRUE
mofpbabdkokgen	TRUE
ngkeghcbneidab	TRUE
nglgifmcofapjb	TRUE
oagdjmkbmpenof	TRUE
oagjjnfgoimaib	TRUE
olfngbbagkjchb	TRUE
olgjaljbfcjcch	TRUE
pfoannfdmangab	TRUE
pfoklffphgclab	TRUE
aaccfnndgjeiif	FALSE
aacgdpacknicmd	FALSE
ajglfhnkhnnihh	FALSE
ajhdlnhfoilhao	FALSE
bdfahplgdanpep	FALSE
bdfplcojmkajek	FALSE
boaceakldaanpe	FALSE
boaggkdcppjikl	FALSE
ciknkoeikdlejp	FALSE
cimidkgndfkdln	FALSE
dckpiejmadnmpf	FALSE
dclaapnjleocgi	FALSE
dniiohhpoilelj	FALSE
dninhfceaghegc	FALSE
ejippajmghkjfo	FALSE
ejjjkooalpnpfe	FALSE
fdfnbecagpmchk	FALSE
fdggmdnlocojbd	FALSE
fmfkcjmmodgahf	FALSE
fmghigbpnmdjmn	FALSE
gghpbgjiikhanm	FALSE
ggkocdpcbmanci	FALSE
halkchkegfenho	FALSE
hanfkacpemldko	FALSE
hkhoeobblpgnoh	FALSE
hkjjmppfdhngmf	FALSE
ielmgomcgnfhni	FALSE
ielmhledbnniff	FALSE
ioldhjkpngkmfc	FALSE
iollbcnimakmli	FALSE
jhnmegndbjhjdc	FALSE
jhobkdghoigokl	FALSE
kcdmchembjpbdk	FALSE
kcebkibflglhcb	FALSE
kmjkblbnljondc	FALSE
kmjnjooflclhfb	FALSE
lgonpfhckljckd	FALSE
lgpehedpfanlng	FALSE
mbdligiefdakfe	FALSE
mbhhjjbindjibn	FALSE
mlbilhblfmknfn	FALSE
mlbipfmclckhgh	FALSE
negongaaglpjmn	FALSE
nejaeiljaemdcm	FALSE
npajpcajphkmal	FALSE
npboakihllgkkm	FALSE
ojgadfjnagnlik	FALSE
ojgbbijiepoenc	FALSE
peclhgnigmicmn	FALSE
pecphngiflfmaa	FALSE
aaaiciphjjpokfb	TRUE
aabdfpjbhlbfbem	TRUE
ajdobhljjhmmnpe	TRUE
ajejbmgkpgfeegd	TRUE
bdjdgnpoecafceb	TRUE
bdjgheafnhpadob	TRUE
bnpkdhhcemjggab	TRUE
bnpnkficdfelmab	TRUE
chpgifjmdjmgapb	TRUE
chpieijencmgiab	TRUE
dcpnbnflacdoaib	TRUE
dcppdfeifocmgab	TRUE
dnpofbdgbnfjgab	TRUE
doaohaelhihijlb	TRUE
ejnapkcjmilkmjb	TRUE
ejnkbhiolnjbfab	TRUE
fdfhgohihcaemcb	TRUE
fdgmamlbcjgnnle	TRUE
fmgcccmkmgjiiab	TRUE
fmikedbbdjldkab	TRUE
ghbbadleckfibnj	TRUE
ghbicoiokhnpgab	TRUE
hbbanaoglodddnb	TRUE
hbclknlfgcdjkab	TRUE
hkjoahlgjchijmb	TRUE
hklcdddoedcbalb	TRUE
idinjddijhbmgab	TRUE
idjjlackgkdohkb	TRUE
ipcmjdammnfdllb	TRUE
ipcnonefehjjbab	TRUE
jincajojnocaplb	TRUE
jiojiceomnonlab	TRUE
kcdjpeheffbbnab	TRUE
kcdpmgnbndgobab	TRUE
knijgfjfokehcab	TRUE
knjkekalhkopdob	TRUE
lgnijadbopahgnn	TRUE
lgnokohiaaipnlb	TRUE
mbfcfiecliakiab	TRUE
mbgfljlmpckaefb	TRUE
mlfeoaldmoempeb	TRUE
mlgenangofmnbbh	TRUE
nffjcgmifnnooab	TRUE
nffjigdeiomldab	TRUE
noplbohmgkdclab	TRUE
nopopgdjaajfjeb	TRUE
okaoiikmocncjfb	TRUE
okefmcpgdgmkhab	TRUE
pejcbihjiiebcab	TRUE
peklaikcbaglgoe	TRUE
aaaokpalnlkhjfa	FALSE
aacgopiojndencp	FALSE
akhijpfejicikip	FALSE
akhkjgednolclhl	FALSE
befnmpplfbkmklp	FALSE
begnckjnhbjhpge	FALSE
boljpehjdieicig	FALSE
bonifgcfecbjcaf	FALSE
chjmnhaeeghpncd	FALSE
chkhpcjmanmpdgm	FALSE
dcaiaielnpaccap	FALSE
dcangjmnifadocc	FALSE
dmhopaoigidefgf	FALSE
dminhjanfhggkla	FALSE
egoiiodeijgjlpp	FALSE
ehaeaplfonkihfh	FALSE
fahpkdjkcpcflac	FALSE
faigmgcfakocpai	FALSE
fkbljgcjagaldal	FALSE
fkcahckiclohjpf	FALSE
gdoamlfffajjmpi	FALSE
gdonciebbpndaom	FALSE
gnlejjdlenofhcc	FALSE
gnlpjpjohchdnfd	FALSE
hipgokdomclfnmo	FALSE
hjajhlhkcnmcmpn	FALSE
iehhomcogdikhfo	FALSE
ieiafffneldedpe	FALSE
ipdhjeclkelnlin	FALSE
ipdkkkimbdjnjoh	FALSE
jjcafpnhljmioma	FALSE
jjckaffceahompd	FALSE
kdhafglnfanchjc	FALSE
kdjkafkmpfjecna	FALSE
knofkfjdombfono	FALSE
knojlchnolilcnj	FALSE
lhgajgaociceaki	FALSE
lhgdlnkemhnjmmd	FALSE
mbhfpioebfemnge	FALSE
mbienfdkkcbcobe	FALSE
mlfalpgjfnpjemn	FALSE
mlfnnmeembjdgma	FALSE
nfefogndobdbaji	FALSE
nffaomcmnmcidji	FALSE
oapihdccgkomckk	FALSE
oapkjolmnhidojj	FALSE
olfmalkoindlfmh	FALSE
olgafijegdgdajj	FALSE
pfidhgbkpflmlhg	FALSE
pfjkmebjbbpehgc	FALSE
aabjdnnchgckgjfk	TRUE
aabnebkbhfgpbblm	TRUE
akjcdnakgmljopdb	TRUE
akkbmcflapiipjab	TRUE
belehdbhgoooamdb	TRUE
belepmpgkglnedab	TRUE
bnphjmdkkgcileab	TRUE
bnpmcgoalkbcceao	TRUE
chojhjclkonpbiab	TRUE
chpmbilgbgmphhab	TRUE
dcabjfeaplcangng	TRUE
dcajgdocimdkdigb	TRUE
dmklnibhbhaakkjb	TRUE
dmkpcemgagappjfb	TRUE
egnbmbcimpcgjhab	TRUE
egnmlhhfjckhbcab	TRUE
fapbodkdnkbccohi	TRUE
fapjhgkbbcbomhja	TRUE
fkiaomkdpdeghfab	TRUE
fkilgigmodgnaneb	TRUE
gemlikhhfgiddfab	TRUE
gemnmpikehiccoab	TRUE
gppbakpfjlknemib	TRUE
gppeciangcbajpbd	TRUE
hjlkjjdcglbgdeab	TRUE
hjllhjenadpcdhlb	TRUE
idnkhnmnopcojjab	TRUE
idnmfgkeeagaeaab	TRUE
incpnpfdkefknoab	TRUE
inebkallglfckglb	TRUE
jhmpljjighmpgpab	TRUE
jhndmpmpkpnlnkab	TRUE
kcbopbgpjeijonab	TRUE
kcdmkpnbljpnlfab	TRUE
kmhomkmkkhnpdhab	TRUE
kmjhgjfaanemabgo	TRUE
lgkfamgpgplhlngb	TRUE
lglomdlmioigpkab	TRUE
magfcnadmmodikdb	TRUE
magockaajmebdgla	TRUE
mlmomnmibenjadob	TRUE
mlpahpdchcdmcppb	TRUE
ngjhpinajmbdfaoj	TRUE
ngjnpjcbgdciogab	TRUE
npmkhdiejkcfhcab	TRUE
npmoamnonilgkmfb	TRUE
ojokjgmnmbpdhhab	TRUE
ojpimoijjbbomgab	TRUE
pengpckmbilkmdab	TRUE
penhahoondegnljb	TRUE
aacachoikfpachkj	FALSE
aacajheoipngmkik	FALSE
aknmfmjmfolkhhpc	FALSE
aknmkdnphfmpaged	FALSE
beohbefmggcmljbl	FALSE
beoleiapalfghnjl	FALSE
bodenhopcgeffibe	FALSE
bodlagkjpdkhcajf	FALSE
chmekmpjffjpgpni	FALSE
chmpfpapgfgkjkfa	FALSE
dcmmoibaljmjapfi	FALSE
dcnbodpfphndmaok	FALSE
dmpeggiafjanpmkd	FALSE
dncfmdbljolblkce	FALSE
egljpdglagfcccmn	FALSE
egmenhechadekjcn	FALSE
fakplmcjfogolhgj	FALSE
falmageacalafofa	FALSE
fkohpoaponemcogg	FALSE
fkpeeonklffmpmih	FALSE
gekbfjblfmpmdfmj	FALSE
gekffajiimcmeonf	FALSE
gpokmeogjhkpejgn	FALSE
gppldkfbbclbfaol	FALSE
hjdaglkddpkdlhja	FALSE
hjdifjjdjhgmdlcd	FALSE
iehblpildmgngjgi	FALSE
iehpjfphaaahfmog	FALSE
inecjjkhgcbohdmm	FALSE
ineemeohndjbfcne	FALSE
jhnphblkbgedappl	FALSE
jhonajeeeckimenn	FALSE
kcnkgbahlggcigdk	FALSE
kcocneoebofcafdd	FALSE
kmchbnepjmpfijdb	FALSE
kmchfajldjnmnldm	FALSE
lginiaieihgcljah	FALSE
lglaglgmphagppgi	FALSE
malgimjaiekfeadc	FALSE
mamdjgomfnodfmdf	FALSE
mljimbpgbnknnhoi	FALSE
mljkalimkecfnpmo	FALSE
nflipdpkbbfdinig	FALSE
nfnfccmnholbjcak	FALSE
npilelnnklbfghfa	FALSE
npjcpkahdecadclm	FALSE
okbdcfkjlcagolpd	FALSE
okbnjflbcmidmecl	FALSE
peokogkeanehdcie	FALSE
peondaejnkpgodki	FALSE
aaainoccohfdjlkeb	TRUE
aaaoiplccoifolihb	TRUE
akljkfanbfpeedaba	TRUE
akmhiehokepinjlnb	TRUE
bfbecgioipdgginab	TRUE
bfcajciibdjlkemio	TRUE
cacmbhhjfmmggobhk	TRUE
cadbodfaboloedimh	TRUE
cmbhnblcccfaahofb	TRUE
cmblbojjoaeikappb	TRUE
ddokfmdfkfbbcjcab	TRUE
ddokoigdmllmckbab	TRUE
dofkdbehenpkodkab	TRUE
dofmgpineegmdcfab	TRUE
eibeckcjlhlcnjpab	TRUE
eibephhgdhffiiiab	TRUE
fcoijbefhahjeeiab	TRUE
fcooplideghljpiab	TRUE
fmlfldekigfohmgab	TRUE
fmllhajhbbnfcofnd	TRUE
ggpmfbhobbjpffcab	TRUE
ggpmhbbjpjembhlab	TRUE
hakehdoooojiinlfb	TRUE
hakhhmmibibpldlcg	TRUE
hlhjpbmjchoimjbab	TRUE
hlififjhfdeijecab	TRUE
igeggejmbeefadlbc	TRUE
igekbbiliocdmkaib	TRUE
jakhjfgmpjmhmgefb	TRUE
jakpbnedpmhcdnmma	TRUE
jknjnilfpnmccpnab	TRUE
jknkaoddjgaodlobc	TRUE
kficafmhioekjpmnb	TRUE
kfidcodaocaikhehb	TRUE
komjlidigbfcmafab	TRUE
komjmdkabmfgfceba	TRUE
ljdehkddpglnpolab	TRUE
ljdjambogmdmodppo	TRUE
meanapbmfahcbgidd	TRUE
mebfpmmjkdlocjlab	TRUE
moecemfcafcojkpnb	TRUE
moeeehjmgklpcpeab	TRUE
nhfclpimmpialhjbf	TRUE
nhffbibijaaboihka	TRUE
ocgpegahknebmdcbk	TRUE
ocibejhnklddihbab	TRUE
ongkikefopcdbffab	TRUE
onjgloeamfakfajfb	TRUE
phhbdlmchciabjieg	TRUE
phjddpjkbfahhdabj	TRUE
aaamjiokmhnnkdhej	FALSE
aaccjmelidfpiaknn	FALSE
algcodpmphlgddnlp	FALSE
alhmlgfhaajacnfdp	FALSE
bemmnjcfeopaplmng	FALSE
bfampefhigkmoghem	FALSE
bphblnjhedpipeoik	FALSE
bphokigclbkjncpap	FALSE
cjlnkaiiakdcdkofh	FALSE
cjlpfjoddoigpdljc	FALSE
deaddfaoafadjpeaf	FALSE
deblppeaddgpodefj	FALSE
dpfnfneecbkjblppa	FALSE
dpgecjehenmdaannm	FALSE
eiejbgdmhlnmbcpkl	FALSE
eigienmelnnfbfaaf	FALSE
fdhdnjelgfhlbpbfn	FALSE
fdhohoancogoecocf	FALSE
fmohcmajakkeeonoj	FALSE
fmohmofcnjdhginij	FALSE
ggjahoocpiedaajcl	FALSE
ggjdnlafgpmdaakgi	FALSE
halonccenkecfaloh	FALSE
hamafikahapfdfkfk	FALSE
hkagacoeedeffhjpi	FALSE
hkajcfcngldplneok	FALSE
idngmpdhlbjjophcm	FALSE
idogadaomlkkmofep	FALSE
inbaockalifhpcifa	FALSE
incjdffkjmcpnepij	FALSE
jibbmaeiflhgkleco	FALSE
jidgdammhnfndcflo	FALSE
kdcpnjbohpdkcafja	FALSE
kddfjnokjbgcfemoj	FALSE
kndekipflngkmhokk	FALSE
kngfkjgfmgidhoecf	FALSE
lhefnoeoicechkpce	FALSE
lhelklmiolhbnofem	FALSE
mcaafjjfnlhdidndj	FALSE
mcccdopnbkhifpmlb	FALSE
mmbnejbmcgnlgcoci	FALSE
mmdlhpobmlgobggbn	FALSE
nhkcfjjjhcnmhmfjg	FALSE
nhldgedpmglnelgjd	FALSE
ocaflpogliagadonm	FALSE
ocbcmnpleengcpllf	FALSE
omliibnnmecnhaokk	FALSE
ommbbjkfmiglnooak	FALSE
pgokmmnkclgnhnbbk	FALSE
phacmmhdecleipdma	FALSE
aaafgjhcciopnbmpkp	TRUE
aabalhdkhmolihnjlg	TRUE
akmopfobopfhpgjdbp	TRUE
akncdbihdlmfldpgok	TRUE
beklchjbneacefhbdm	TRUE
bekmbdghcifdppheab	TRUE
bpbcidaagpicjaomlb	TRUE
bpcefljfapcnflbgij	TRUE
cjnclpkniioilfnbab	TRUE
cjpbnlfgbkdlknhnab	TRUE
dedfckglonhojfedab	TRUE
dedlibmocannoelhgb	TRUE
dpfbhmjfflpfppegab	TRUE
dpfmmkngpfdollfeab	TRUE
eikmnanlnehnnmeibb	TRUE
eikpiidkdnfodnfkab	TRUE
fcmggbchncpbojnoab	TRUE
fcmohcnhafmgkdnicb	TRUE
fmmadhhipedlgliogb	TRUE
fmnbojgabjdmhafihk	TRUE
gghdnlibdjnigaipmb	TRUE
gghldilfgapocnhefb	TRUE
haoenpnnhljpejefpb	TRUE
haogdnblbfefjcoidi	TRUE
hkcmhokapdhboancfn	TRUE
hkdddmogoffnonogab	TRUE
idjebgijcchlojjbab	TRUE
idliancoggnhkhdjlb	TRUE
imkofemgjngbbkhpab	TRUE
immbffdonfhnhoglab	TRUE
jiiibpikfmplpjkeab	TRUE
jiipdlhjhcnllcbgab	TRUE
kdcmpedfoknedokoab	TRUE
kddlbjejdbeiiejjab	TRUE
kninfcbgchoblmkdab	TRUE
knjknihimkhaijnhhb	TRUE
lhkjalmiigkoghlfmb	TRUE
lhlofkoeinjbcfnkab	TRUE
mcaembebefenjeigho	TRUE
mcamncljpdgmbdaiec	TRUE
mmlkeenpiffjnecakb	TRUE
mmnclbedoglnajmnnb	TRUE
nhgjcmjgikebpghiab	TRUE
nhiodlcldhpknlmfab	TRUE
oblideiljdonbgolab	TRUE
obmdkahkpdiopodcfb	TRUE
ompmoagndbhoalkpmk	TRUE
onapafpbdpnfnmgnfb	TRUE
pgopfnfmclfchjokab	TRUE
phagalickaapdolboj	TRUE
aaaiffhmmidpahgkon	FALSE
aaaoamikhckegjjkmh	FALSE
akeomahjholgfohind	FALSE
akfhjhiagffpjoikgm	FALSE
bebahfcoenlcijaepm	FALSE
becicpmmoekgbihgdg	FALSE
bnmhlpcnilfdkpkchp	FALSE
bnmhmckbeojccnghkh	FALSE
cihemfmpllioojjoma	FALSE
ciiglbgebaplnhnfpj	FALSE
dcdhdcdfchiindlelh	FALSE
dceahdgncfgnfhgmpi	FALSE
dmilnlgkcpmmiaoaol	FALSE
dmjmidoeebgkepdcaj	FALSE
eiaangilleggllgjgh	FALSE
eiblpaciidfieefcno	FALSE
fbdbmeolcgbohjlkoh	FALSE
fbdlepaoincpocjkjl	FALSE
fliphffbpghfbobgbb	FALSE
fljddjncmhmkpehhdp	FALSE
gfigncfihhnfihcbnb	FALSE
gfjamopdhfmpmjadil	FALSE
gpkodgfklccobiniln	FALSE
gplahoepokoiaklikk	FALSE
hkmaeigmefjolhkjoe	FALSE
hkmghdmkdmdeogaolk	FALSE
ifgngfbgnbmkbgefed	FALSE
ifgpkolninlihjlbdb	FALSE
jahlapkopdideamkim	FALSE
jajdlknhpgjhilalga	FALSE
jkfmbkdblfinfancfe	FALSE
jkgfhhogpbfogdkcjp	FALSE
kekflfnlpolfhemhno	FALSE
kekhjnihoibjddoodn	FALSE
knoodflckpbdiajdgn	FALSE
knpccojafklpgngeld	FALSE
lifcdekcoeclpinebg	FALSE
lihhdbjhnkgmhjhppc	FALSE
mcipcbehdokilaagik	FALSE
mcjidmijbadlmaidak	FALSE
mnefmijjgbflebeahp	FALSE
mnfhbkoaaocjlhhknp	FALSE
ngmckaoaimmhpndeac	FALSE
ngnkbgpbfhlaccdmak	FALSE
oanmdpicodolfkcodj	FALSE
oanmngkmfhckfphmnn	FALSE
omccamignmkmnnppen	FALSE
omdeadconnampnjmja	FALSE
pgjapikmchdenpcogp	FALSE
pgjdlafihmjhldnphn	FALSE
aabaplimmildajhdemh	TRUE
aabbajefeiaecpainbo	TRUE
alcnjihjmnbecanhceg	TRUE
aldgincemgdkaigdncb	TRUE
bfjaiaadhpebgnfemfn	TRUE
bfjgpmgonjmcjhifhab	TRUE
bphhhildlmpmpileiab	TRUE
bphiakbdbmknlmbdlbg	TRUE
cihjnoagmojeneefnkb	TRUE
cihogjkagbapgnlpkjf	TRUE
dcfldbnbellejnghnab	TRUE
dcgjmiebgdibpjanbnk	TRUE
dllggnlbkdmjpfgclab	TRUE
dlmjaikdlkohbbcjoho	TRUE
ehdoafipkbdmclomhlb	TRUE
eheakhicobeiifonjjb	TRUE
fbklofbcaohojaklhdb	TRUE
fblbfhmebohnmedbbab	TRUE
fkldjochgnkibdlikab	TRUE
fkmcnmganjdmipengfb	TRUE
gfcelejlmfnglgkkfab	TRUE
gfckammcmdlcfakoajb	TRUE
gojjaojbkdfefjfinbj	TRUE
gokbfgbmmkckhogooab	TRUE
hifekahkdkjlbilofpp	TRUE
higmhkccdilimlhilab	TRUE
idbdikeponielgfddab	TRUE
idbfchldhocnheaaegb	TRUE
incgcpednelikkcaobf	TRUE
indeaiheflfbkdemjni	TRUE
jhmlhgiclepjmeemafb	TRUE
jhmmnchgjjpbmopebab	TRUE
kcenkhmgncjlgkcllab	TRUE
kcgcimjjnpoglimmaab	TRUE
klefocdboehooofflab	TRUE
klegoepkehdcanpofjb	TRUE
lgjddbppgphndaojnkb	TRUE
lgjolfkbgeongklplab	TRUE
maknpnphknamliagcfb	TRUE
malmfaadgbdodnlminc	TRUE
mkhpohhgmfojaagiakb	TRUE
mkiajigajlfipdglmlb	TRUE
nfjobcjejkjkffahogb	TRUE
nfkhckjijjhhhggpgab	TRUE
nplggbajngoboojilio	TRUE
npmbiolkodimglommab	TRUE
oleanclmedhmlclfdfb	TRUE
olfanbcedjjhffbhoeh	TRUE
pfcfnmgoiaamjlcegnb	TRUE
pfdcpjbpjhpkbkjkpab	TRUE
aacfcmakgiicjlnigkj	FALSE
aacgafcdfkdlcpfccjc	FALSE
ajmhdfliclhihhampdh	FALSE
ajmnkpjgpjkogedgkjn	FALSE
bendhfnhcggpbdadmja	FALSE
beoeeaeecpaddjeadho	FALSE
cakapggmpikooinhmal	FALSE
calahgdigknmmnhcgmh	FALSE
ckffglmndakgephhcpn	FALSE
ckfmbdgkfnklbnmjdho	FALSE
dfbceehflaejgfjlgkc	FALSE
dfcioibibipehkmhceb	FALSE
dpdhdhbfngfolfehili	FALSE
dpdmladhlnhdaninofn	FALSE
eifebknbeoemmijjcoh	FALSE
eifhgggamimfkockdjn	FALSE
fbfpmdknaadadhpgpmf	FALSE
fbghijdnjjbgimlhgln	FALSE
fldpfolbdmbicphfhho	FALSE
flfkcjindlipnidjceh	FALSE
gfdfpjdjphbhpcdphld	FALSE
gfdhaaphgmffgpnpfop	FALSE
gpnhcpflfgpnnpmelhj	FALSE
gpnigfefmgicldcadna	FALSE
hjcffkpnpgkebeaahnk	FALSE
hjdiegjnpdlgfdfhfna	FALSE
icjlkedgkkpoaijeggk	FALSE
icochkjpbdjbcapmmnd	FALSE
imcgpacgfhcadcjihlm	FALSE
imcidfnflgaipfognaj	FALSE
jfmplfmgilhkljaellj	FALSE
jfncmnflhooillphbcf	FALSE
jppmedgmfglihebldca	FALSE
kaaefkofhlfhlichkgk	FALSE
kjommimhifgdeibpcgb	FALSE
kjpanplhopelphcfina	FALSE
ldhaecjhlgaedpkankc	FALSE
ldikcoajfafoenhmfoj	FALSE
lpjfpgfeoolbldeahdi	FALSE
lpjplmdaoedpcihdoka	FALSE
mkbgfaphjlmoepjnfhn	FALSE
mkbldecfkpkbgccfbcj	FALSE
nfalglpikdjhigkmcej	FALSE
nfbbbaolndiefjdckca	FALSE
obanmhmmcpjnecefjld	FALSE
obbhkaognfjajedfgln	FALSE
okpokloemonekipodac	FALSE
olbfhidbhibncfnhcbe	FALSE
pfbnpmialjicnpciccp	FALSE
pfdhlconmkghmphfbhb	FALSE
