aaaonafbab	TRUE
aabcnnbfab	TRUE
akdpaikbab	TRUE
akfbdgfiab	TRUE
beamancbab	TRUE
bebkpmabab	TRUE
bopiniabab	TRUE
bpbjbaobab	TRUE
ckhlkiabab	TRUE
ckinacpbab	TRUE
ddkgbgabab	TRUE
ddnnahjbab	TRUE
doopkgabab	TRUE
dpacamkbab	TRUE
eiogbjabab	TRUE
eipencabab	TRUE
fdbnllabab	TRUE
fdbpelabab	TRUE
fnahkcpbab	TRUE
fnajjhgbab	TRUE
gggalgabab	TRUE
gggejkabab	TRUE
hakbgpkiab	TRUE
hakkaicbab	TRUE
hkokgfabab	TRUE
hkplgmabab	TRUE
igembfabab	TRUE
igfidpabab	TRUE
iojcgoabab	TRUE
iokgldabab	TRUE
jhbhghabab	TRUE
jhcebfabab	TRUE
kcclleabab	TRUE
kcdamefbab	TRUE
kmopkakbab	TRUE
kmpmihabab	TRUE
lipodiabab	TRUE
ljaiklnbab	TRUE
mdamhkdbab	TRUE
mdaobhadnb	TRUE
mnecocabab	TRUE
mnepanjbab	TRUE
nhdohiabab	TRUE
nhelgagbab	TRUE
obebdlabab	TRUE
obedppabab	TRUE
okjlibabab	TRUE
okkdgiabab	TRUE
pgcfjpabab	TRUE
pgcgidabab	TRUE
aabbjbonmh	FALSE
aacbjjdmid	FALSE
ajjmgbaake	FALSE
ajlellfeml	FALSE
bejjljdhdi	FALSE
beldpgfjek	FALSE
bpngjjedgd	FALSE
bpojognfch	FALSE
ckehioniko	FALSE
ckfeopkfgn	FALSE
debbilemil	FALSE
debjkmjkif	FALSE
dojneapklj	FALSE
dokghgapfj	FALSE
ehppbjhcll	FALSE
eibpgkglal	FALSE
fcejgeeodm	FALSE
fcemlefllc	FALSE
fmjnakffgd	FALSE
fmkcdleocf	FALSE
ggbfcnimfk	FALSE
ggddnejnle	FALSE
hbgphnpcbj	FALSE
hbgplbpeeo	FALSE
hkoolccjhc	FALSE
hkpdggholm	FALSE
ifdelpbgff	FALSE
iffkdbeknf	FALSE
jacfekehde	FALSE
jacnakhomm	FALSE
jjmognaejm	FALSE
jjmpodmnhp	FALSE
kejoaodbag	FALSE
kejpmefknb	FALSE
kokomnlnan	FALSE
kolaphhmoe	FALSE
lhkmngajep	FALSE
lhldifddec	FALSE
mcogepljgf	FALSE
mcoikgeadh	FALSE
mngcnhohfb	FALSE
mnhjfhncmp	FALSE
ngkdkekpbk	FALSE
ngkehficfp	FALSE
npmefddgem	FALSE
npnmfldamb	FALSE
okcocdpomo	FALSE
okcofifeik	FALSE
pfifgadjpl	FALSE
pfjnedhigo	FALSE
aabbjbonmab	TRUE
aacbhjjdmab	TRUE
ajojfhjkbab	TRUE
ajoooliebab	TRUE
beomekgabab	TRUE
bephefiabab	TRUE
bpibmgjabab	TRUE
bpnanejpbab	TRUE
ckbenmgabab	TRUE
ckceoimabab	TRUE
ddppndcabab	TRUE
deaajpdabab	TRUE
dopfbihabab	TRUE
dpacpaeabab	TRUE
eigecnbabab	TRUE
eigfjlhabab	TRUE
fcannmlabab	TRUE
fcaoldmebab	TRUE
flnjddbabab	TRUE
flnnkegabab	TRUE
ghajjclobab	TRUE
ghbmappdbab	TRUE
hbkhpimabab	TRUE
hbmadpgnbab	TRUE
hlkddjlabab	TRUE
hlkjflbabab	TRUE
ifbgfddabab	TRUE
ifcbhdbabab	TRUE
jacagjajbab	TRUE
jacedjgmbab	TRUE
jjphkjgabab	TRUE
jjpmedoabab	TRUE
kehgjhmabab	TRUE
kejoehkabab	TRUE
konjnahbmab	TRUE
konljcdabab	TRUE
lhpnaheebab	TRUE
libbdoeabab	TRUE
mckafdfkbab	TRUE
mckoblpabab	TRUE
mnfofafcbab	TRUE
mnhkacgibab	TRUE
ngaadhdjbab	TRUE
ngafpdmmbab	TRUE
npnebdjabab	TRUE
npnpgklabab	TRUE
okmoiooabab	TRUE
oknbmidabab	TRUE
pfgkaadibab	TRUE
pfhoopgabab	TRUE
aabbjbonmhb	FALSE
aacgjdmidin	FALSE
ajlbojnogoa	FALSE
ajlgfelhejb	FALSE
befdmikckcb	FALSE
befdobcihol	FALSE
bpjjgjjefda	FALSE
bpleidogfak	FALSE
cjiaiddkmbc	FALSE
cjobpfhohem	FALSE
dedcfgbcepa	FALSE
degcbmcjicb	FALSE
dojiidaghlm	FALSE
dojkepelhdo	FALSE
eilmbeioehm	FALSE
einbclekhgf	FALSE
fccdpfaleob	FALSE
fcgchmhpbog	FALSE
flkfjllimok	FALSE
flkghklckfg	FALSE
ggkdnfcinbe	FALSE
ggkjdojeklm	FALSE
hbmklflcbfn	FALSE
hbnegnknnlg	FALSE
hlkkomofggk	FALSE
hlledgagfbm	FALSE
iehjhnkpfio	FALSE
ieijmcibbnj	FALSE
jadhccpfalf	FALSE
jadlijpfnkl	FALSE
jjmcikpbipa	FALSE
jjnniegolkp	FALSE
kdoblanllff	FALSE
kdpmibdgmom	FALSE
kolbdpnphcl	FALSE
kolckifmkgb	FALSE
lihdhahknop	FALSE
lihfoilhpkf	FALSE
mdcelopdogc	FALSE
mddaipjbfil	FALSE
mmodbbgobcg	FALSE
mmofcdbmnef	FALSE
ngjhoaegoka	FALSE
ngjjmjdbofd	FALSE
nppenaphjce	FALSE
nppkcijbebc	FALSE
okfiiadbfbe	FALSE
okhjpeofglc	FALSE
pfiknklflmp	FALSE
pfjpbfdkgkg	FALSE
aaaedmepgbab	TRUE
aabbcfkklhab	TRUE
akmlibfamlpb	TRUE
alagfjdiibab	TRUE
bffodnpeabab	TRUE
bfgfbellabab	TRUE
bphilplgabab	TRUE
bphledfkabab	TRUE
cikffaohpbab	TRUE
cikibpmacbab	TRUE
dbjjoaiagbab	TRUE
dbjlfgofabab	TRUE
dmhnhcdcabab	TRUE
dmhpcahikbab	TRUE
egaaejcombab	TRUE
egalbibooajb	TRUE
faldbbafemob	TRUE
fambpgchmnab	TRUE
flcgejfapbab	TRUE
flfkaohdhbab	TRUE
ggaedemnobab	TRUE
ggbainlcebab	TRUE
hampihiaebab	TRUE
haockapjlbab	TRUE
hkfnigjlabab	TRUE
hkgiokhdabab	TRUE
iefgmijjabab	TRUE
iehcdjhhabab	TRUE
iobbglejabab	TRUE
iocoddnoabab	TRUE
jibaimlklbab	TRUE
jidopmonabab	TRUE
kchocjohabab	TRUE
kcihoaccebab	TRUE
kodikbcgabab	TRUE
kodonjmnabab	TRUE
lhmkeeglabab	TRUE
lhniahafjbab	TRUE
mcofljknabab	TRUE
mdaomopmgbab	TRUE
momelcajbgab	TRUE
momgggmmabab	TRUE
njljdfdgabab	TRUE
njmfkbibabab	TRUE
ockajegmhbab	TRUE
ocmjadhilbab	TRUE
omilaiblegab	TRUE
omjangmjmbab	TRUE
pgcpdjniabab	TRUE
pgdpadgnpbab	TRUE
aaaedmepgibn	FALSE
aabcklhfnaef	FALSE
akplekpljlao	FALSE
alabdamgdedk	FALSE
bfhoginnnlbf	FALSE
bfidkjjecmdn	FALSE
bpldbhbenopp	FALSE
bpldccfjfckb	FALSE
ciikecmcgnma	FALSE
cijdmjndicaj	FALSE
dbhjmchagnof	FALSE
dbiflhdgcbgm	FALSE
dmdemmfkepgg	FALSE
dmdpihkbnhnm	FALSE
egbbblfhjhli	FALSE
egbhoccmdjcn	FALSE
fahjelelfjbi	FALSE
faiaelonpodn	FALSE
fldhanmohjfd	FALSE
fliajbjamiif	FALSE
ggajpmlepjgk	FALSE
ggbjbdchijod	FALSE
haighccgeffb	FALSE
hajmajpbllhj	FALSE
hlihadbcnolm	FALSE
hlihaglalene	FALSE
iekdboaajail	FALSE
iekndlolnpga	FALSE
iobkdoomflfe	FALSE
iobpkbfkjdel	FALSE
jhniibicbhee	FALSE
jhondojdjjib	FALSE
kcfdoipgcokh	FALSE
kcgbfioedgda	FALSE
knloecmkildg	FALSE
knlofljbobdd	FALSE
lhjgibnfaeoh	FALSE
lhjlpdejahoa	FALSE
mcobkfgcjngl	FALSE
mcolgphallmb	FALSE
mokpodfdgoem	FALSE
moneafihgpgh	FALSE
njdnholgglgi	FALSE
njeekfcoecee	FALSE
oddddipeaoad	FALSE
oddfaeoamllg	FALSE
omhjffhjlkhb	FALSE
omhlddmicgdj	FALSE
pgdjmgnhjhcd	FALSE
pgeffgldnnla	FALSE
aaacdddemnbab	TRUE
aaadeddljfbab	TRUE
aikgmjlbcfoab	TRUE
aikhpnnllblab	TRUE
bdnfpibghabab	TRUE
bdnoboefcabab	TRUE
bnokagjhenbab	TRUE
boaimkikbjdab	TRUE
chjkgckafibab	TRUE
chlfkmmafkbab	TRUE
dbekpnihlabab	TRUE
dbglkchenabab	TRUE
dmfmbmgoiabab	TRUE
dmhiifoklabab	TRUE
eglcfaekcobab	TRUE
eglfgcpdjabab	TRUE
faljbgmgdnpab	TRUE
fanolonnkcbab	TRUE
fkkodjinkabab	TRUE
fkmceacadlbab	TRUE
gfclnkdbhabab	TRUE
gfeajlfkpdbab	TRUE
gpgnpmdlnabab	TRUE
gphapodankbab	TRUE
hijciliaehbab	TRUE
hijfffbmiabab	TRUE
idhlhpoflabab	TRUE
idiahfdoipbab	TRUE
ineicibkeabab	TRUE
infabbjcindab	TRUE
jhijghileabab	TRUE
jhilkhfkiabab	TRUE
kccldijhmabab	TRUE
kccodmiefabab	TRUE
klkedjjjjabab	TRUE
kllnfcddkabab	TRUE
lgcapcfkjabab	TRUE
lgdndeolnabab	TRUE
machfjfjnobab	TRUE
macobfajlcddb	TRUE
mkjlinjccabab	TRUE
mkkkljejoabab	TRUE
nfnbnaeoakbab	TRUE
nfnghofhlabab	TRUE
oaaghfmaigbab	TRUE
oaaibbooghdab	TRUE
oldedofjiabab	TRUE
oldkhpdabafjb	TRUE
pekhddedfabab	TRUE
pemcdonleabab	TRUE
aaacdddemnedd	FALSE
aaadljfjgbeog	FALSE
aikfjkllnjoob	FALSE
aikkanodiigdp	FALSE
bcimikglfcnao	FALSE
bcjcfdhidadgj	FALSE
bndmmmihghaje	FALSE
bnefealoacnho	FALSE
cgoineagioddp	FALSE
cgoipcflcejbh	FALSE
dbjoaolljaogm	FALSE
dbkijgchlahdh	FALSE
dlgcpgpjodfag	FALSE
dlgjejneblmnf	FALSE
eggfclidfkina	FALSE
egigambfadjkf	FALSE
fajflhhhipakm	FALSE
fajmjefacaegp	FALSE
flcpbinfmpcag	FALSE
fldkaipofkoek	FALSE
gemgbhmhdkppj	FALSE
gemidihbkofka	FALSE
gpbjjgiecjpge	FALSE
gpegpffbgjncb	FALSE
hjhegncpejljg	FALSE
hjhfanoecefbk	FALSE
idiabakgfgfie	FALSE
idijbddmlojbe	FALSE
inbmdhnibfclm	FALSE
incedebkcjekm	FALSE
jiandpoiflmdp	FALSE
jibkpknkfgedm	FALSE
kboclmpgeffnn	FALSE
kbpllahmpgonh	FALSE
kndlplenhgmfp	FALSE
knehdcelagcpn	FALSE
lgkikoacpobhp	FALSE
lgmdepjfnlndb	FALSE
maieaipcmgidf	FALSE
maiebijoojpgk	FALSE
mlijoeoenflng	FALSE
mlilipccdpkfn	FALSE
nfekemgnjeakd	FALSE
nfemloijcoekp	FALSE
oabcpaphfjhag	FALSE
oachodfajmgkp	FALSE
okghdapkkifeo	FALSE
okghhchbdhhpi	FALSE
pempjhdjoahck	FALSE
peoaglmokmlme	FALSE
aaacgimdfdabab	TRUE
aaaecebckemnab	TRUE
ainlphpmncebab	TRUE
aipjlmeikmebab	TRUE
bdcglajhndcbab	TRUE
bddgjplodmabab	TRUE
bmlebmebofabab	TRUE
bmlhjeokldabab	TRUE
cibdbnclpfabab	TRUE
cibddkejabobab	TRUE
dcfeonlkhmabab	TRUE
dcfkfllakilbab	TRUE
dmbnmeejnkabab	TRUE
dmcdfioijdabab	TRUE
efaphcjknobmab	TRUE
efbkpopgdlabab	TRUE
epbmacigmidbab	TRUE
epckpehbmnabab	TRUE
fjalojooeolbab	TRUE
fjbahpceamlbab	TRUE
gdebhjmiijabab	TRUE
gdegdnmkglabab	TRUE
gncoebdnlmabab	TRUE
gndohhnejdabab	TRUE
hgjeigfhahebab	TRUE
hgjlbegbjlabab	TRUE
icepogkbmlabab	TRUE
icfagafboancib	TRUE
injdbnadcbcgab	TRUE
injiejplahlbab	TRUE
jifpkdidclabab	TRUE
jigjodhgfeabab	TRUE
kcckgnomhpabab	TRUE
kcdaneibilffab	TRUE
kmmheijcinabab	TRUE
kmnhimalhbllab	TRUE
lfljaimbogglab	TRUE
lfnafhdlbbnfab	TRUE
lploelgedhabab	TRUE
lpmceplelcabab	TRUE
mkkcaeadhfibab	TRUE
mkkfhkkclalbab	TRUE
ngdeadjoapjbab	TRUE
ngdljicajpkbab	TRUE
ocacgadicklbab	TRUE
ocaeipilpffbab	TRUE
olmkjjbipdabab	TRUE
olmmgeappdlbab	TRUE
pgbnafmhepfbab	TRUE
pgcacodhogpbab	TRUE
aaacgimdfdaceb	FALSE
aaaeckemnhffom	FALSE
aiojdohoclcmla	FALSE
aipchpohfjngdc	FALSE
bcpofhhaeogabf	FALSE
bdabkddghonioj	FALSE
bnbcncmffiholg	FALSE
bnbljembppgdmf	FALSE
chcoaadmlnejki	FALSE
chdapjdpnjkpcc	FALSE
dbpafikgnicoad	FALSE
dbpcpnaphkjhpj	FALSE
dlipblpmacigmi	FALSE
dlkdkpehbmnhei	FALSE
efocgchegfbaba	FALSE
efpiiimhjkndpj	FALSE
epkonnpioajinh	FALSE
eplaillmhipgnh	FALSE
fjfhbpbfmhlclh	FALSE
fjgbpndccckkfj	FALSE
gdfabfmkkichbg	FALSE
gdffgpjijbicme	FALSE
gnhlbnhdnaieoa	FALSE
gnifofbiheleck	FALSE
hiejljjofodboe	FALSE
hiekfpbnfkloel	FALSE
ibobkecabmgmgl	FALSE
ibonhclobmelee	FALSE
injaklhnojmian	FALSE
injcclpioldkaj	FALSE
jhiomjggblaabn	FALSE
jhjdnkbkkeepij	FALSE
kckkjdaahpkcde	FALSE
kcllekeemogalh	FALSE
kmmehjakbckigc	FALSE
kmmjaijdfbopck	FALSE
lgadioahogpece	FALSE
lgbcldgfjoeefl	FALSE
lpmaecgbanhkal	FALSE
lpmgmadphggmho	FALSE
mlichadhgnmjca	FALSE
mljggennednhmo	FALSE
ngppiggododopa	FALSE
nhaepooplbkkoe	FALSE
ochnfknlanpaff	FALSE
ocigneognjifdi	FALSE
olpapokfekgdkg	FALSE
olplbcelcabnfj	FALSE
pfjdliljlmokhd	FALSE
pfjehnnlnjkmjf	FALSE
aaajdelncchdbab	TRUE
aabehfimjggbkab	TRUE
akpoopaolobdnab	TRUE
alaomlhmfldobab	TRUE
belebmeggboabab	TRUE
belhbjgnkfdabab	TRUE
bopbbmfodinabab	TRUE
bopncoadnnjibab	TRUE
cjfggehkhkbabab	TRUE
cjfmbdbfemiabab	TRUE
ddfpdimmamhebab	TRUE
ddglnjeadelnbab	TRUE
dmbpmheklnlabab	TRUE
dmdphppjobnabab	TRUE
ehiocfjpbmdabab	TRUE
ehjajifafleabab	TRUE
fbhhfmgehkiabab	TRUE
fbigpjalebhkagb	TRUE
flfhebjhijpabab	TRUE
flhkakcnohlabab	TRUE
gffhclmmncjabab	TRUE
gfhicdknhniabab	TRUE
gpbbkldgalogbab	TRUE
gpbhfllbkjkabab	TRUE
hjndljbhgenabab	TRUE
hjnocgkfkkmabab	TRUE
iegfgfgdnlhabab	TRUE
ieghphjajpablab	TRUE
iojdmegghenabab	TRUE
iojkicnmcjkabab	TRUE
jjnjdohkmcnabab	TRUE
jjojoemalhkcbab	TRUE
kdppggojdbiabab	TRUE
keabmocjbjmghab	TRUE
knhlbdpcgojabab	TRUE
knhlbiigngcabab	TRUE
lhkdkjghmeoabab	TRUE
lhkkgfeepplabab	TRUE
mbjefolnnmnabab	TRUE
mbjeholheepabab	TRUE
mkjphkjdiboabab	TRUE
mkkckkeogknabab	TRUE
nenkehednfpabab	TRUE
neocdekhfgkabab	TRUE
nonobabpcokfjab	TRUE
npakoagfcidlbab	TRUE
okieoiocnngabab	TRUE
okioiapjhdglbab	TRUE
pfcndfdhfmbabab	TRUE
pfdfkijaojibnab	TRUE
aaajdelncchdmne	FALSE
aabfmjggbkicojh	FALSE
akpemndhglkalfl	FALSE
alajimphjeblmhj	FALSE
begnnjmbiooeafo	FALSE
behejaphimppdhg	FALSE
bollcmcblahkela	FALSE
bolpobhmefainim	FALSE
cjjlckdhplcijdj	FALSE
cjkdedjepgnelbj	FALSE
ddogeflhnkkmjno	FALSE
ddpbiganlgkidfc	FALSE
dmgcagjnjcflebk	FALSE
dmgdmbellaihdha	FALSE
ehncphamgolmngl	FALSE
ehndebnhgnijjco	FALSE
fblhaohmojcfgga	FALSE
fbmdkkfjhmopenf	FALSE
floahkjbojbjpcb	FALSE
flpjbmancfpghlk	FALSE
gfiaoalbincjpgj	FALSE
gficmdnfcdnenme	FALSE
gpaagldbbchkdjj	FALSE
gpafpmjnplakenn	FALSE
hjffcepejjnpegl	FALSE
hjghcnbeiibnink	FALSE
ieceaigipfliogo	FALSE
ieckmhbpeldjkag	FALSE
ionbiolbjeikjcc	FALSE
ionpmdnbjpcggno	FALSE
jjlfejdlaohhokl	FALSE
jjlogmjbdjncbfo	FALSE
kebhdccbghcognn	FALSE
kebnobncnibhpgl	FALSE
knmpodhhdaaggfl	FALSE
knnckicfgjoghkg	FALSE
lgmbjkdpkkegili	FALSE
lgmophobmgbogng	FALSE
mbleidkakmleano	FALSE
mblpmiembiebpji	FALSE
mlajgbboaegpelc	FALSE
mlakokpbdlkbhih	FALSE
nfkgclekgmkehlp	FALSE
nfknabahippffnj	FALSE
npbmnolcfknpbni	FALSE
npdhmjcbgobecnj	FALSE
olglnemmfbdehca	FALSE
olgogkajlikngip	FALSE
pfnajiopodeaopa	FALSE
pfnfnpehffieini	FALSE
aaafpphjifplkbab	TRUE
aacbnibmpfkldhab	TRUE
alejeaokdcmpebab	TRUE
alejlbgfhhlcdapb	TRUE
bekdopfdfgheabab	TRUE
bemlokelbcciabab	TRUE
boildkmpakiicbab	TRUE
boioillfflfiabab	TRUE
cjlfcoecfdhpabab	TRUE
cjmbagmocempebab	TRUE
degedofocnlfabab	TRUE
degpilkpdahambab	TRUE
doigigfpgnanjbab	TRUE
doiidngojbeapbab	TRUE
ejhlglkmdmegabab	TRUE
ejjciceifhbiabab	TRUE
fdomfekdjncnabab	TRUE
feagcendblplpeab	TRUE
focmjbfkocpanbab	TRUE
fodbnplbmmelabab	TRUE
ghlinlhlhbhfabab	TRUE
ghllmgecichbabab	TRUE
halgdacdgemhhbab	TRUE
halpeokpbcdioeab	TRUE
hlfoknbbblfkabab	TRUE
hlfpnbmdoicpabab	TRUE
igilikdlipdfabab	TRUE
igkcibmfgneiabab	TRUE
jbombedmhjhiabab	TRUE
jbonmalpjnpodbab	TRUE
jlnaglopnefagbab	TRUE
jlncfofhckeoabab	TRUE
kfnnglpejgblabab	TRUE
kfochjdbnoajfbab	TRUE
laapgjnilagpfbab	TRUE
labcmhbblghkimab	TRUE
ljgagplgijanfbab	TRUE
ljgpjdiahodfbcab	TRUE
mebppgnodmeiabab	TRUE
mecinndeplldabab	TRUE
mopmmodliieanbab	TRUE
mpagogbpckhgoiab	TRUE
nigdimaiipkambab	TRUE
nighfeclneenabab	TRUE
obpmmjjmngjbabab	TRUE
obppbdeebcilabab	TRUE
omfchpkoloaeboab	TRUE
omfkcdlbijgdabab	TRUE
pglgpolpkdloabab	TRUE
pglnafofehpbkkab	TRUE
aaajlhmgipejmfek	FALSE
aabfkjgilihgbkhn	FALSE
ajjciklmhndolbga	FALSE
ajjlhclmmfngogen	FALSE
bdehaglnmkblnkak	FALSE
bdfabfdhdmmmodgo	FALSE
bmmikbdeckkakbjj	FALSE
bmmildndepdcokog	FALSE
cgohegkkfofpcfng	FALSE
cgojpmcgagjgcidl	FALSE
dbhjodfkgmkkjagg	FALSE
dbidblmnbapjjbfj	FALSE
dmbodaddljfmkmdp	FALSE
dmchlppdpbipmbeo	FALSE
efcbpmielpdaacao	FALSE
efcehokkpncikilg	FALSE
eploffbadappaifa	FALSE
epmhllnkhjafgomg	FALSE
fkhaonoliokckgcn	FALSE
fkhcpbpfdhpmddog	FALSE
geeflhbnnjlbcona	FALSE
geekjhkfflljolbo	FALSE
gnnjkhblhggkpplm	FALSE
gnomejfjgmgljiln	FALSE
hhjcdbndificbaje	FALSE
hhkcncjnpdkgdpac	FALSE
iccppcdpadbjfkki	FALSE
icdkpdjngglnempb	FALSE
ilglhdolehjckjjm	FALSE
ilhbpeabfacpichf	FALSE
jffehdkkpfnfekhp	FALSE
jffgopgamfkjlijo	FALSE
jpfehlchphpieplj	FALSE
jpffinmiknipdaee	FALSE
kjiehbkmackljiel	FALSE
kjifofgbdeldaahf	FALSE
ldhdokoanncimpoi	FALSE
ldhjmgfbkphodmag	FALSE
loghagaloeanbbja	FALSE
lognpjgmiklfafko	FALSE
mjdhokeelhldiheh	FALSE
mjenccjaallkdiib	FALSE
neolpcpnnboobjbm	FALSE
nepcnhpgndannife	FALSE
npejfkkfpofmglgg	FALSE
npfldchbnobobpik	FALSE
ojncclapaiehkehk	FALSE
ojnefkbdlhjpcboo	FALSE
pfkhincifkhdgnem	FALSE
pfklaljbfceilbbj	FALSE
aaajlhmgipejmfbab	TRUE
aabekfkjgilihgbab	TRUE
ajhpmhodndbopchab	TRUE
ajikgkbigfemkcoab	TRUE
bdaniapcdjilbnmab	TRUE
bdbbllfbhdcfdabab	TRUE
bmbofgapaceefpbab	TRUE
bmclpleghjobiabab	TRUE
cggkhoojapihhjbab	TRUE
cghfcimbhcmmnabab	TRUE
dbkkkajhghemimbab	TRUE
dblkpogcfklblabab	TRUE
dkpmlofncjkgbabab	TRUE
dlafdglhbfccgkfab	TRUE
efgcfkfjdepflabab	TRUE
efgmcoikkpoigabab	TRUE
epbdelpgnhlepabab	TRUE
epdmlclhcabhnekab	TRUE
fkdnefpffphanbmab	TRUE
fkdnkfjfcddmeabab	TRUE
gdhbhdlfidlnoabab	TRUE
gdhdgfedldmkmabab	TRUE
gnaffmnpgeabppgab	TRUE
gnaiopihefpialbab	TRUE
hhkhdkepbjkdiabab	TRUE
hhkibndcchenjabab	TRUE
ibkdhmkhnfdhjabab	TRUE
ibmjifidggajedbab	TRUE
ilckhinkklbjfabab	TRUE
ilcpgnapjmlhepbab	TRUE
jfmdmgjlnoknaobab	TRUE
jfnaciegkchanlbab	TRUE
jpknnoobhneahjbab	TRUE
jpkoimenobjmmabab	TRUE
kkfkfpflmfoaeabab	TRUE
kkghoiiggmphjabab	TRUE
leapkockkfgkilbab	TRUE
lebcdgjjkiejlabab	TRUE
lodjeekijpfklabab	TRUE
loephhkmidnghabab	TRUE
mjoeoknkndkfiabab	TRUE
mjopkiamnhgcpibab	TRUE
nebpmngjcpiboabab	TRUE
neekffpcknmnfabab	TRUE
npkocoimmmijaebab	TRUE
nplebeadbcdjmfnab	TRUE
ojnaghhdljcckebab	TRUE
ojnmipfoecfmpabab	TRUE
penmdlbkminmhabab	TRUE
peoodkkomoiajibab	TRUE
aaafmnbaapnpfajln	FALSE
aaafoncfkfkciklah	FALSE
alfmndkfcpddgodng	FALSE
algbifglhhdcpmodh	FALSE
bepkpifnjmidhnigd	FALSE
bepojoknoabdffocj	FALSE
bnoekcfoceeckolgf	FALSE
bnoepjbmceieiodjo	FALSE
cidekkfdagcjnmpif	FALSE
cieccffphflipbnnk	FALSE
ddmgnehdbdgnbdilj	FALSE
ddmlioaihgpdjmfpi	FALSE
dnfacjkdfkcfodbmf	FALSE
dnfphkfjgkcnmabpd	FALSE
eihnobkdjhhcnkomc	FALSE
eijlboppljnjeackp	FALSE
fcnmpbegmigmhlfao	FALSE
fcoajhjfjfofanojp	FALSE
fncachcjkkkmkdjbg	FALSE
fndlbdmfoajmfejgm	FALSE
ghlldahhkjdmonfep	FALSE
ghmcmjkcclnaenfmk	FALSE
heapbekbnnnmbpcpn	FALSE
hednnobfkdphamoik	FALSE
hofiagojchmleccie	FALSE
hogcbpoahiicggllc	FALSE
ihocndjapijhihkil	FALSE
ihodmmfemobgkfmle	FALSE
jcjnijnajhfllabpf	FALSE
jclmbdelmmehcdlfo	FALSE
jmdnccgebcfdmfhpf	FALSE
jmecdmbkammfgahjb	FALSE
kghkplnkmgcimgpbn	FALSE
kghlceohdajahhflm	FALSE
laiicijkodoiojila	FALSE
laiobheenjkkgadkh	FALSE
lkdkgnfmifbcceidl	FALSE
lkdlhfkafccekcmgf	FALSE
mfbeofgipkknomodi	FALSE
mfdpkhjmbjeonjidp	FALSE
mpammaahnaaeejijh	FALSE
mpcdaecjjbchekhlb	FALSE
niljfnikgmcikjgec	FALSE
nimjipegdeldcbojk	FALSE
oclgpechgajdegcgf	FALSE
ocmaihkbbdcklkmmg	FALSE
omglmgihpgcifmkbf	FALSE
omhkpmfdepckljmea	FALSE
pgdiemgnphjhamffh	FALSE
pgfcbjmcjfhhnmkdc	FALSE
aabgeliaelmplekknb	TRUE
aacegpgmfmkpokobab	TRUE
ajhbkggikhncfgdnab	TRUE
ajhggbfkbbiloagnjb	TRUE
befjgbpnacbnehjkab	TRUE
behnicjoiffhknabab	TRUE
boglkngfojfhbbabab	TRUE
bohknlpfcieddajbab	TRUE
cioigopphjlgnnabab	TRUE
cipdmibgheoffmabab	TRUE
dcoacbephbaogkfdmb	TRUE
dcomejkcojapgkobab	TRUE
dndaaceiegjlijfbab	TRUE
dnfgidmmhdhecjabab	TRUE
egnbpidlelejgeabab	TRUE
egngkjdcfpgagacbab	TRUE
fbaafocaibnkgohiab	TRUE
fbafkphphlacclkbab	TRUE
flmljidcnfjabidamb	TRUE
flnajhejnflbajahab	TRUE
ggmmnnmfpnaoddabab	TRUE
ggnelicjkmdijgabab	TRUE
hbahblpnimgnbhkdab	TRUE
hbahboknfbhohogjab	TRUE
hkhnpmbpnjpihiabab	TRUE
hkhogoolgeikkgabab	TRUE
iffdiliocmnplgabab	TRUE
iffpgmhlbpggaknbab	TRUE
ipflfccljofnidabab	TRUE
ipggomkpfofiieabab	TRUE
jjjlijhijekladabab	TRUE
jjlgmpmklgpjehabab	TRUE
kdgenidhnihjopabab	TRUE
kdghjelojpdfigabab	TRUE
knamldoecijbjhdnab	TRUE
kncemaddbfpjpjjkab	TRUE
lidijnelfjemflabab	TRUE
lidolokgfikamelbab	TRUE
mcmhpfgigphhhlabab	TRUE
mcmnbcgdehhamimbab	TRUE
mmoibjjbjmcpbbabab	TRUE
mmpbckhgfiilegabab	TRUE
nglomblhfmemgkabab	TRUE
ngmfkaffeninoboeab	TRUE
oamjckgdndbccjnjab	TRUE
oamjnfepbeiblhbafb	TRUE
okplodeaongdmfnbab	TRUE
okpphemapanjgoibab	TRUE
pfcaihbmmiponkegab	TRUE
pfdbjkolpdkoifabab	TRUE
aabgeliafmnmfllokp	FALSE
aacegmfmkpokoodafa	FALSE
ajidgipbhjibimchli	FALSE
ajjeefjccadjllgcgg	FALSE
bdkjkclndddgclbpak	FALSE
bdkllkmaphakmlhmbi	FALSE
bpbficcnfmaoknbjon	FALSE
bpckiangidgfingbjb	FALSE
cjimcnibmhlnlhpgkd	FALSE
cjjpmcgbejfgibbggh	FALSE
dckedmpoamobpiccei	FALSE
dckeeakjgmmgkdbkhc	FALSE
dnacckihonempnhmkf	FALSE
dnaempjpkjlmipeglm	FALSE
egjinnpflnnfeciplm	FALSE
egjlbgalfonkiadcfi	FALSE
fajggjlfjgdibmelad	FALSE
fajglfognikhnngldh	FALSE
fmceghiglolfggnjpk	FALSE
fmcnjhmlfdncdkblci	FALSE
gghkakgpehikkgoiam	FALSE
ggickmjpffoddfjboc	FALSE
haikfakpegcdbcgedb	FALSE
hajdpdjgialanimmfp	FALSE
hkhokcanikehleholo	FALSE
hkiidilapcogchacok	FALSE
ifehjhklkghjggfiij	FALSE
ifemfnecdilnjhjgpp	FALSE
ipjeemonnmeckmmhee	FALSE
ipjkelakhcfadmimgc	FALSE
jkfgpbponcoekkjfah	FALSE
jkfhpbabpmffmlhcoh	FALSE
keofgfhkhehbnlnfgd	FALSE
kepeakbkldpanhihpp	FALSE
knmedbdmpdnkmdbidh	FALSE
knmilhgfodlblbiele	FALSE
lholkenccocnhamhdp	FALSE
lhpkapnldfngplbbdb	FALSE
mcglejlahcdecikhhg	FALSE
mchfjhjnjopibpjegl	FALSE
mnafmplpkegfkgbaok	FALSE
mnbplemdcilkgoankf	FALSE
nhhhfneiafiindmeeb	FALSE
nhiejkphfmpgfhgigf	FALSE
oapfghjnofigobhekb	FALSE
oapgnhohccdgildcea	FALSE
ojlinkgaaliofkffjj	FALSE
ojmoknbmmmmknjicaf	FALSE
pfgghhfffhkcolijln	FALSE
pfhpbnnlodpjhelmbn	FALSE
aabogepdgpbfdofbgab	TRUE
aadildenaneegkdabab	TRUE
akimoiabapfopcpekpb	TRUE
akioafcpebhibolehab	TRUE
bemdonnmjjjgbocabab	TRUE
bemlcmgpmnonpmmabab	TRUE
bofijbaafpbmcblaegb	TRUE
bofmibdhaajnahnebab	TRUE
cigbebimddgofpjabab	TRUE
ciicohmeojonhkoabab	TRUE
dcgblcdafephhoalbab	TRUE
dchgcpmildahlocibab	TRUE
dmihhaplfpbngpomjab	TRUE
dmjefkhlccipgclabab	TRUE
ehfdmgcfhopmdppabab	TRUE
ehfecihcikaoclgcbab	TRUE
famkceebgghdgcjidab	TRUE
famkhalpgicolipjbab	TRUE
fkngigdegbnibnnabab	TRUE
fkocihdmceboednabab	TRUE
gfeijlbpjohflldabab	TRUE
gfgdjgdcgcldafiebab	TRUE
gpcfhbnpbiamapimbab	TRUE
gpcmlebldhppmkahbab	TRUE
hjjlebddfpghooiabab	TRUE
hjlbcggamhdopmdibab	TRUE
iehgemokeffghlmabab	TRUE
iehjlkdgknegignabab	TRUE
ipafiekjiajpjjlfbab	TRUE
ipalkhmlenncddhhbab	TRUE
jjkmgdankbdhcfjmcab	TRUE
jjmchjmhdjniielabab	TRUE
kclfljfiopainlmnbab	TRUE
kclopdmlkjgcgdpabab	TRUE
knnamblejcfloelgbab	TRUE
knnbpjakolpljgdnbab	TRUE
lhnaodhcfecljgeibab	TRUE
lhneljjenolcignabab	TRUE
mcgmgdjfigpidiafbab	TRUE
mcgnjdooihpmognabab	TRUE
mmdgglhflofookjabab	TRUE
mmdkaikplbhknkiaopb	TRUE
nfkhiigmbiccbglabab	TRUE
nfkommnnindpbkapbab	TRUE
npklkbpgfoifahfpbab	TRUE
npllfibfnigihmmabab	TRUE
okpekeljgkbdbpkabab	TRUE
okpggbkmfhlmakkcbab	TRUE
pflnjjggebgobnjabab	TRUE
pfmonjjppddomdjabab	TRUE
aaaiihcppfpdcbniode	FALSE
aaajbkbjfickohmhfkd	FALSE
akdkbafafnhcpaepjod	FALSE
akdlafbiclmljgjcjdk	FALSE
beiejihnelfnfmnoicc	FALSE
beijlalbfgnoflfhakg	FALSE
bonpbcnfbkbnkejhgij	FALSE
bpadicghbhjcadpmgaj	FALSE
cjdfnkmohmanhpjanoh	FALSE
cjemakeajfgamhlhach	FALSE
ddgmphkcaiiaolbocpn	FALSE
ddgpfnfijningdfmefp	FALSE
dnmdidbcgpjeoepiemp	FALSE
dnmgccbcdgaliiebbkd	FALSE
ejecidnhkfognljofam	FALSE
ejhdeodpbpmpknigkdg	FALSE
fdghiffhdbcmcnbjhde	FALSE
fdhlfficaphollegheh	FALSE
fmnojkfkcfpmcjobbdd	FALSE
fmpfpjmckgenhfcbgni	FALSE
ggihfejmjboecfehkkb	FALSE
ggiklbdnglnacoolnah	FALSE
hapokomcmenkopafbin	FALSE
hbaccnfgaljbomcjpph	FALSE
hkkbfdonpkelbkfcfmb	FALSE
hklcbipficfobjkkecj	FALSE
iffcbfpoghknmapgldd	FALSE
iffpicobhmpaolomaka	FALSE
jaanmjgkccijefddhgg	FALSE
jacpmhoplfjpklmjohn	FALSE
jkbdediacgnhodpgpnk	FALSE
jkbdndbojpmfejijdpm	FALSE
kdngobkmbamegaohchf	FALSE
kdpnmlninabcjmdpgpp	FALSE
koejjmpkgijggfieafp	FALSE
kofdchfmngnkglajlnk	FALSE
lidegjfjoecgeceadab	FALSE
lidegjphonflopoeadh	FALSE
mdkepfdolgbhgfigidm	FALSE
mdldclbgagblbophlek	FALSE
mnllbencmdpnpbjhffb	FALSE
mnmcbabinoofnijfjno	FALSE
niekmgienoifpdgdedb	FALSE
nihopjepcaioehgiiek	FALSE
odglpegghhaeookjiho	FALSE
odhdijfacdmbhgjkjmd	FALSE
omlniagcalijnpikfkn	FALSE
omlpnddbagbiaeklgck	FALSE
pgggkhdjhngffloeepg	FALSE
pghgdkbnahenklaedia	FALSE
