aaabpjhbcd	TRUE
aaadnliajl	TRUE
akejhpikfb	TRUE
akenmnmdnk	TRUE
beajoidmea	TRUE
bealpicbma	TRUE
bolhbljagp	TRUE
boljakaofe	TRUE
ciefbhfcgc	TRUE
cifhkllpnf	TRUE
dcioemgdcl	TRUE
dcjbdkmppp	TRUE
dnamepahig	TRUE
dncfpekplj	TRUE
ehlcpechpd	TRUE
ehlfflgmgo	TRUE
fcjcjelnnn	TRUE
fcjhnglnoe	TRUE
flmdmeddio	TRUE
flnaahgifd	TRUE
gihhkbkcpd	TRUE
gikfeahbpb	TRUE
hccabmdfcd	TRUE
hcchoglllo	TRUE
hmpppbidag	TRUE
hnaclcgkbb	TRUE
igpdcddjab	TRUE
igpgmpkmpl	TRUE
jbbfojdcap	TRUE
jbbjidpfeg	TRUE
jmikdjfgcc	TRUE
jmikpnapen	TRUE
kglnmdbkah	TRUE
kgmjpebokd	TRUE
laiddeefgi	TRUE
laifmelfoj	TRUE
ljialccdab	TRUE
ljjbfobfeh	TRUE
mcmgbmeobi	TRUE
mcmmddjeni	TRUE
mmckaghlpa	TRUE
mmdaagppgl	TRUE
nfnmbkajgo	TRUE
nfnmkmmadp	TRUE
oamhhjjpgo	TRUE
oamhjoopme	TRUE
olagmmahnl	TRUE
olbgdhdoap	TRUE
pgalbnfade	TRUE
pgchkldfep	TRUE
aaabpjhbnl	FALSE
aaadiailab	FALSE
akclopkacd	FALSE
akdbhpljab	FALSE
beboilofcd	FALSE
beelegfjcd	FALSE
bocadohhab	FALSE
bocofgajcd	FALSE
cjennfjjab	FALSE
cjfgmkklcd	FALSE
dcpdbmgfab	FALSE
dcpmlnalab	FALSE
dnfhjnkbab	FALSE
dnhckimdab	FALSE
eiobkjmocd	FALSE
eioobfjmab	FALSE
fcjagpnhab	FALSE
fcjkdadpab	FALSE
fneamdidab	FALSE
fnepeecdnl	FALSE
ghkeddglcd	FALSE
ghmbponncd	FALSE
hcofkdmkcd	FALSE
hcopjkjjcd	FALSE
hnbcndpbcd	FALSE
hnbhkiijab	FALSE
igjkmnojcd	FALSE
igmmebjdcd	FALSE
jbkelalabp	FALSE
jbkogknlab	FALSE
jmgcdpecfl	FALSE
jmhafncccd	FALSE
kgkehfhicd	FALSE
kglfklgocd	FALSE
lalnpogbab	FALSE
lamdiliccd	FALSE
ljjpmgfpcd	FALSE
ljoblaliab	FALSE
mdhndjoecd	FALSE
mdifeanmab	FALSE
mmcjndiccd	FALSE
mmdpedigab	FALSE
nfllphmdab	FALSE
nfmhkoficd	FALSE
obcfclbmcd	FALSE
obejgpnfab	FALSE
oljngmggab	FALSE
ollhocpocd	FALSE
pfkpdkanab	FALSE
pfkpohdpcd	FALSE
aaabpjhbncd	TRUE
aaadliailgh	TRUE
akbkbabbmcd	TRUE
akcgihmfccb	TRUE
bebgcdlamab	TRUE
bedidacjgfa	TRUE
booiipmkkie	TRUE
boojlfolkkj	TRUE
cihnjiohegc	TRUE
ciipjnhjlmi	TRUE
ddbhobkckjb	TRUE
ddcbbkfljil	TRUE
dnodppfpmfm	TRUE
dnpjdlhjfcp	TRUE
ehdabjjnjcd	TRUE
ehdelaehlmh	TRUE
fcckdgpimea	TRUE
fcddldgcdab	TRUE
fmplegilona	TRUE
fnabfoemgcd	TRUE
ghkncbaleba	TRUE
ghmfmioejgl	TRUE
hceghbokkog	TRUE
hcfjmophhnc	TRUE
hmoiknbkjil	TRUE
hmojjebjccc	TRUE
igpecbfmddj	TRUE
igpegcjflcn	TRUE
jbnhjikanee	TRUE
jbpmpdkojnn	TRUE
jlnbpdngocj	TRUE
jlojnaoelpc	TRUE
kgigceopbbk	TRUE
kgilkfmdiak	TRUE
lagndnialig	TRUE
laheoejdepj	TRUE
lkcfmicende	TRUE
lkchgokaghl	TRUE
mclofbgllmd	TRUE
mcmfblleepe	TRUE
mmbhkjcnehe	TRUE
mmbjkilgmkh	TRUE
nghnhokhibp	TRUE
ngicleidmae	TRUE
obhinjglagn	TRUE
obicembkifo	TRUE
omihfmjpdcp	TRUE
omjamgedggg	TRUE
pgkkkdjhamb	TRUE
pgkpggnnppd	TRUE
aaajjmelbcd	FALSE
aaaomfkpiab	FALSE
akhjidmolcd	FALSE
akidghfnkab	FALSE
beajhgbodab	FALSE
beajjeglcdl	FALSE
bobggknfcdj	FALSE
bobhmeemicd	FALSE
chkoikcmhab	FALSE
chlfflgeicd	FALSE
dbmkpegblab	FALSE
dbmpeogllab	FALSE
dlhcpmkeoab	FALSE
dlikdoibgab	FALSE
egfnplbpjcd	FALSE
eghonbpfdab	FALSE
fabonpchbhj	FALSE
faeddjldpab	FALSE
fkllpaligab	FALSE
fkmdmnjphcd	FALSE
gfpmkdhlbcd	FALSE
gfpokfmakab	FALSE
hamndhnlmab	FALSE
hampdambnab	FALSE
hlmeepogecd	FALSE
hlmfmochmcd	FALSE
igffibdomab	FALSE
iggabjocifh	FALSE
jabiggdompi	FALSE
jacdjnhaadl	FALSE
jlfgeodcdfo	FALSE
jlgognlmicd	FALSE
kfinolkieab	FALSE
kfkgbnhgnab	FALSE
lbccpaibocd	FALSE
lbckkfkancd	FALSE
llcljmjlbcd	FALSE
lldegijbdab	FALSE
memkkpkknab	FALSE
menmcmpekcd	FALSE
moknjkheicd	FALSE
monleakigab	FALSE
nijgbkoeccd	FALSE
nikniajnabc	FALSE
ociagfehkcd	FALSE
ociljgcbjcd	FALSE
omoedplldab	FALSE
ompfgdkilcd	FALSE
pgkikmcggab	FALSE
pgnglhfkkcd	FALSE
aaajjmelbnmf	TRUE
aaaokpiecalc	TRUE
akgpokhgghal	TRUE
akhdghncfdop	TRUE
beblebhaehmf	TRUE
becihiecefnj	TRUE
boanefonnpmd	TRUE
bobeamfhimga	TRUE
ciaaaomdmhaj	TRUE
ciamlidbckfa	TRUE
dbkdjpbnonam	TRUE
dblegdibkimo	TRUE
dlmhlmpfmccc	TRUE
dlndjikbkgcf	TRUE
eflgnoamiooe	TRUE
efllojddeklo	TRUE
fabnagcklkcd	TRUE
faekahhpifkk	TRUE
flcjfnmkmkic	TRUE
flebcgaiggio	TRUE
ggagfpcebmmn	TRUE
ggaifajobjdj	TRUE
hannoddaelel	TRUE
haogccgileon	TRUE
hlijaedlpjif	TRUE
hljimfjgjcgc	TRUE
igfmbkeielmo	TRUE
igggfolhlpmo	TRUE
jaccgiabnkcd	TRUE
jadiaollleha	TRUE
jlafpppaocll	TRUE
jlalaibedpok	TRUE
kgkmbljhbkkp	TRUE
kgkokkngmcnp	TRUE
lbekenfhdbbe	TRUE
lbemmcdhfeab	TRUE
lknindfdlaii	TRUE
lkoccgknldfb	TRUE
memhhbkhmicp	TRUE
memppfobknkg	TRUE
mojipmbmdppa	TRUE
mokdfmahnnhk	TRUE
nihgjhklkhlj	TRUE
niicmmcflici	TRUE
ocoaieljoihj	TRUE
ocojlgclhigm	TRUE
ommjaiamkbfn	TRUE
ommkbmjibahe	TRUE
pgblkfigfkib	TRUE
pgcabgiabpcd	TRUE
aaacbmdlhgab	FALSE
aabcecgnlelk	FALSE
ajoojhepjfcd	FALSE
ajpcnpclgnab	FALSE
beealmnkpgcd	FALSE
begkijgnpdcd	FALSE
bohgmphohdcd	FALSE
boijjofaadab	FALSE
cicagojmgecd	FALSE
cicgihjndccd	FALSE
dcikmiigloab	FALSE
dckecdbeljhh	FALSE
dmjjmljpidcd	FALSE
dmkjaheocdng	FALSE
egfhpcklffcd	FALSE
eghheahhaaab	FALSE
fajnepdgpncd	FALSE
famgnfijcmcd	FALSE
fkjofbodclab	FALSE
fkmchocjlecd	FALSE
gehdapdelfcd	FALSE
gejblihgebcd	FALSE
goeccnockpab	FALSE
goecnlbngkcd	FALSE
hinnadcnckab	FALSE
hinnjlhcldcd	FALSE
idkjgfodcfcd	FALSE
idlpmaojnlcd	FALSE
iogghicdnicm	FALSE
iogjabcekbed	FALSE
jjbfjkigbfab	FALSE
jjbmliiaencd	FALSE
kdolimncaecd	FALSE
kdpjlmfglicd	FALSE
kojpceopinab	FALSE
koncmojhaoab	FALSE
ljjdbfbdcgab	FALSE
ljjhlcjeifab	FALSE
mdeccdnknodj	FALSE
mdflahfpkpcd	FALSE
mmpgpkneijab	FALSE
mnaglgoeilab	FALSE
ngonjheggfcd	FALSE
ngpfefnkceab	FALSE
oakaimoiohab	FALSE
oakdfngdfkcd	FALSE
okojgnkaddcd	FALSE
okopcelkofab	FALSE
pfkodggnmfcd	FALSE
pfmbkmacfhab	FALSE
aaacbmdlhgcce	TRUE
aabcfnlelkhcd	TRUE
ajpkhpanonaci	TRUE
ajpkpggppjaoe	TRUE
bdmpacldlaekf	TRUE
bdnejkjkahmpl	TRUE
bohcbagjlical	TRUE
bohdbckbeoigj	TRUE
cjcepinkjommg	TRUE
cjcpgjdkehkda	TRUE
dcfhljkcmgihp	TRUE
dcgafgigffmjp	TRUE
dlncjchkgpckj	TRUE
dlneplpodihmf	TRUE
egbebobdfhgpi	TRUE
egcoopkapcmpc	TRUE
faminhhoppijf	TRUE
famkedjgndpoo	TRUE
fkgngahdhgkfa	TRUE
fkgoehckcnhfk	TRUE
geapmbcpehlpe	TRUE
gebefhhafnlcn	TRUE
goeafdhbkomgi	TRUE
goeeepjdkgldk	TRUE
hidgajkmcadmn	TRUE
hidiagjdfaidg	TRUE
ieenbhbjpjlih	TRUE
iegegmnnedebn	TRUE
ioijpfjkjibkl	TRUE
ioiofladlkdcj	TRUE
jienhococmjdd	TRUE
jiflphdoehppo	TRUE
kdchkedlahbii	TRUE
kdcnljieadldn	TRUE
konbejojmbhol	TRUE
kondembfmpboc	TRUE
lifemnpbfioim	TRUE
lihjkonhbhaoa	TRUE
mcdicmfklljab	TRUE
mcelgpeabhdcd	TRUE
mmghopkklbfdc	TRUE
mmhbhiacfhmfc	TRUE
nghndmfpfhkae	TRUE
nghpolejbadep	TRUE
oakdhnmelicbo	TRUE
oakjfokbckpco	TRUE
oldmoelbilfjb	TRUE
olfanlmookgoj	TRUE
pghecidabdfcd	TRUE
pghfeclhjppje	TRUE
aaajhkpdaefcd	FALSE
aaalefnhnpkab	FALSE
aknlnajhohkcd	FALSE
akoikkfepfhcd	FALSE
bfcbedilklecd	FALSE
bfcpgmmlificd	FALSE
camannggdancd	FALSE
camngkegohcdi	FALSE
cmjhnboidffab	FALSE
cmkeicebhlgcd	FALSE
dhmckhedjoicd	FALSE
dhmenibkdopcd	FALSE
econfcgmboacd	FALSE
ecopebbnjfbab	FALSE
enhncajcpeccd	FALSE
enioaongpmgab	FALSE
fheiaageecdbc	FALSE
fhgggkodakacd	FALSE
gaogedcainfcd	FALSE
gaoljfloeciab	FALSE
gkknmclenbjcd	FALSE
gknjjgmiiepcd	FALSE
hehlkimnhboab	FALSE
hehplepdbplcd	FALSE
hoiipdjnojlab	FALSE
hojmpacbfjhab	FALSE
ijbicaaiggjcd	FALSE
ijdfgjempgkab	FALSE
jckokjbgbpeab	FALSE
jcmkpofjfbicd	FALSE
jnakegnfifcab	FALSE
jnanefboggfab	FALSE
kgjkaonmbggcd	FALSE
kgjpbfkohhlcd	FALSE
kpjfobocohhcd	FALSE
kpjnplgpebaab	FALSE
lkhmbppagmocd	FALSE
lkibookpkgdcd	FALSE
mehkmcnahnpab	FALSE
mehlbajenincd	FALSE
mohdimpingcab	FALSE
mohicdlmakeba	FALSE
njpcfphigfcab	FALSE
nkacnkfmeldcd	FALSE
oddbelcdopnlf	FALSE
odfgmeimmddcd	FALSE
omlhbhfjnfmcd	FALSE
omlpaapbjhfcd	FALSE
pgfhijoeabnlf	FALSE
pgfjggjmdaeab	FALSE
aaajhkpdaefpef	TRUE
aaalnhnpkglfgj	TRUE
akihgeehmiblio	TRUE
akjaejnbhmnmnp	TRUE
bepfoaoccifopl	TRUE
bfaokagnkdoafi	TRUE
cakamigabbamcd	TRUE
cakbgbdhplfikp	TRUE
cmooihegiigjap	TRUE
cmopmfldenibdc	TRUE
dhnabpblidfncd	TRUE
dhndkmjflfijfh	TRUE
ecgfccabiilncd	TRUE
echbgikjldbmja	TRUE
enhbhipejbfbmc	TRUE
enheeejabhjccd	TRUE
fhjbdgfkglfiad	TRUE
fhjcpfbngjdmba	TRUE
gbclpmecfednki	TRUE
gbcmoapedmfghd	TRUE
gkopmchodmheno	TRUE
glajlfkbamlgif	TRUE
hekadcdbfndeab	TRUE
helkoedabbgpcd	TRUE
hpfpiimoalbleg	TRUE
hpggiaakedkigb	TRUE
ijeccmjmpbomaf	TRUE
ijgjmdogfjaknk	TRUE
jcpdchlhhcheoa	TRUE
jdblnbaclpfohm	TRUE
jngbmdchghmbnn	TRUE
jngdoobnckaeip	TRUE
kgcalihkneafoj	TRUE
kgcgjfleoaapdb	TRUE
kpnaadaiojbcpd	TRUE
kpnfmhpmonnokg	TRUE
lkeancphamjijd	TRUE
lkepchdjgiiopa	TRUE
megopgeacmlfko	TRUE
mehajloimilbhp	TRUE
monhmgbfojgjoa	TRUE
mopoilmjgifkpb	TRUE
nidomccefmaegf	TRUE
niffafhgcliclp	TRUE
odnjgcnghgmhnj	TRUE
odocmdmcmljcij	TRUE
ompoioibgbjdgi	TRUE
onakljnkdkhdne	TRUE
pfnpejpepilmjf	TRUE
pfofgjhkodncbl	TRUE
aaaogfmbbjbkab	FALSE
aabegpkimfnjoa	FALSE
akibhglcikfbcd	FALSE
akijbamkbahmab	FALSE
bfbjclgghblbcd	FALSE
bfcploaghdopab	FALSE
bojbjaaecfancd	FALSE
bojigdpadhfabc	FALSE
cilpbiokemlpab	FALSE
cimcpfjoaffcab	FALSE
ddoommbkehcnab	FALSE
ddoopadnbaikcd	FALSE
doeheafkapnfcd	FALSE
doekfbjgmhcfcd	FALSE
eighifbaeejicd	FALSE
eigkmpnhhiemcd	FALSE
fccbdgidnegdab	FALSE
fcclgckcmigcdo	FALSE
fmeiindlkndnab	FALSE
fmgbmfldmagmab	FALSE
ggpamobfkcdlhb	FALSE
ggpgfikolagiab	FALSE
hblgnoanjghfcd	FALSE
hbmibgiifbikab	FALSE
hlladhnmmlblab	FALSE
hlmkhhnaneidcd	FALSE
igcdgjbdbheibh	FALSE
igdbloafmfbicd	FALSE
jabobomjkiejng	FALSE
jacedlghfmpncd	FALSE
jjmoiijedkkkcd	FALSE
jjnjiibopjoncd	FALSE
kfhoimclkldicd	FALSE
kfjgcnnfgobicd	FALSE
kpjaphoeompmab	FALSE
kpjejlojffjlcd	FALSE
ljdoblhianeccd	FALSE
ljelpmopfegncd	FALSE
mekfnkejhdlgcd	FALSE
melcolobnplhcd	FALSE
moejjcjmiiffcd	FALSE
mohbmccibkoacd	FALSE
niflbknmbbkgab	FALSE
nigecngjjekgab	FALSE
oakfdfemdlbmab	FALSE
oaknlohldlhnab	FALSE
olechadgmgpoab	FALSE
olffhbfcogbmab	FALSE
pfacgjhjmoihab	FALSE
pfalmomlkdieab	FALSE
aaaogfmbbjbkieg	TRUE
aabpkimfnjoahcd	TRUE
akjiabgemekhccd	TRUE
aklhamnnnflnlei	TRUE
becakhininnkkci	TRUE
bedaanmefnlhell	TRUE
boiikchnhdfkpgm	TRUE
boiikihjogecjel	TRUE
cjgemiggckldimc	TRUE
cjhdaedhnhcjbce	TRUE
dckjfdamcekiefp	TRUE
dcldpgbgadkmpko	TRUE
dnefadfdaaeeglf	TRUE
dngcbmaffomacma	TRUE
ehlblcbhkeeedpm	TRUE
ehlpideagiheglf	TRUE
fccnolaajbiaoho	TRUE
fcdckjoocohglab	TRUE
fljdbijkkhmmkkp	TRUE
fljgkllpoeapffb	TRUE
ggjhahonpmkbaap	TRUE
ggjpknipjbgdfle	TRUE
hbnaibaflndipji	TRUE
hbnmhcbdnehdcpf	TRUE
hmagkdjdnofdpmh	TRUE
hmaooelmnnhfepb	TRUE
ifpccegphckbldf	TRUE
igbacimlodamlgh	TRUE
jafmghjmonejilb	TRUE
jahaljpgndjbfpl	TRUE
jkonhabjjaoaecd	TRUE
jkpbndfdenpmbmc	TRUE
kfokilpoldphljd	TRUE
kfpjdhfnabjfecd	TRUE
kpdgokmiahbfcmc	TRUE
kpegaihdkhngjdl	TRUE
ljmehhimagjhaik	TRUE
ljodfjophhnglgc	TRUE
mefdenlklfjneid	TRUE
mefdnjlodkjmakk	TRUE
molklgiepcahbpg	TRUE
mompgbobgmcejle	TRUE
ngojlcmflemdmpn	TRUE
ngpkhokhoiihbij	TRUE
obcefmkdaicdaab	TRUE
obcekananggknka	TRUE
olgclhpoaieflfb	TRUE
olgpfneolbajmjk	TRUE
pfjmgflliabpdcd	TRUE
pfkjciafpofmbme	TRUE
aabhehdahafpbjm	FALSE
aacdejmalliopin	FALSE
akbiamiffndkkab	FALSE
akcappcikobmlcd	FALSE
bfgdfhcjdhlhecd	FALSE
bfglokgdcnapeab	FALSE
boogkdpaegpncab	FALSE
booonnnfcgmhmcd	FALSE
cjelbbobipoablo	FALSE
cjenbhkffgnaaab	FALSE
deaiebealaioicd	FALSE
deaofdkbhblkpab	FALSE
dmpcejclifbpecd	FALSE
dnaijlogepcheab	FALSE
eheonbcpblekcdh	FALSE
ehgapcojlmljicd	FALSE
fdaldfmodgnfocd	FALSE
fdbhamcpdlfloab	FALSE
fnmfbjagkjkacdl	FALSE
fnmjopiijckkcab	FALSE
ggobpieajdhjpcd	FALSE
ggppflmpbgkjcab	FALSE
hbbgibdmkilmlab	FALSE
hbbinonjgjijccd	FALSE
hlmdjdcadidkaab	FALSE
hlmdnbfkeaedhab	FALSE
igjaedbddkodaab	FALSE
igjbkghfcgkdaab	FALSE
japaeofonoiidcd	FALSE
jbanlnafheonnab	FALSE
jleokpoknbjjnab	FALSE
jlfidlfedlegcdb	FALSE
keookomidpglmcd	FALSE
kfamgpnhggmedcd	FALSE
kpjibfianbhilab	FALSE
kpjjgjfaalhgpab	FALSE
limpdimjeoohkab	FALSE
lindcbdgccmpgab	FALSE
mdmgdigmlghkiab	FALSE
mdndkndodngooab	FALSE
mojmipadboemgcd	FALSE
mokbnlhlaedgmcd	FALSE
nihdiielbaldfab	FALSE
nihfjmnpnjbclcd	FALSE
ocogblkfmelkncd	FALSE
ocpbnjmplgdpdab	FALSE
onlleajboidikab	FALSE
onmkicmmgfcmmab	FALSE
pgabeeminlaiedm	FALSE
pgabijdocoopama	FALSE
aabhehdahafpbjcd	TRUE
aacmdejmakliopin	TRUE
akbmnbpmddnhefap	TRUE
akccooloblnnbbhj	TRUE
befopkhlhmplkmjl	TRUE
beijpemhoepnjbme	TRUE
bokdkkdbkkpahdkn	TRUE
bolaknbbchpnfmbf	TRUE
cjgpkhchkcgnfffp	TRUE
cjhoifclckdfomln	TRUE
dddmanfbadggpopo	TRUE
ddffdelghoakjlie	TRUE
dmgmenclgdomgnmh	TRUE
dmhhoofbepehejjd	TRUE
ehgpkflecjmiaokg	TRUE
ehjagnkbomcnkfng	TRUE
fcigohbpfogbacan	TRUE
fciihbngglcinnei	TRUE
fmlefjibohjjajmc	TRUE
fmlphdolobmbgepj	TRUE
ggoiebknnpdgobmj	TRUE
ggpinpbpobhcgakb	TRUE
hbcjdbkoaoahiclm	TRUE
hbeogdfbfeamapil	TRUE
hlggnbddljeeippe	TRUE
hlgpbmgiokgbakac	TRUE
igmfaalaggehgjnj	TRUE
igmfkkliphkckjmn	TRUE
janmmpkeaioomekc	TRUE
jaojbahhooigjjae	TRUE
jlbmojjfladelejn	TRUE
jlcaabpjmjhlogcd	TRUE
kfffeimhghnlfakf	TRUE
kfffhpgohckhibii	TRUE
kpdolbeakefjalkh	TRUE
kpekedhabkebjfcd	TRUE
ljghlhgfgplafach	TRUE
ljhgcamjoenliadp	TRUE
mdknlijaafooaapg	TRUE
mdllmgnfliapkgae	TRUE
moieioajdkgajgfj	TRUE
mojpmmkgoflnfhem	TRUE
nholcfkipdonmhlp	TRUE
nhpfoficakgaemki	TRUE
odalmlnejpglhbhf	TRUE
odbbfpikpjiiogmj	TRUE
onfnmehcodlnkpfp	TRUE
ongaggicelcpjdpf	TRUE
phfkfkchebjpdefa	TRUE
phfmkjhhekkpfkdj	TRUE
aaaenbiodmaijeab	FALSE
aaafdeoimflblfab	FALSE
ajplbnfpbkbfilcd	FALSE
akampjodadlhepab	FALSE
bejpdjhnagepefab	FALSE
bekbknoeflmfgecd	FALSE
bpjepbmlckgmpecd	FALSE
bpjjpnimmnfmnpab	FALSE
cjnoooilajddkeab	FALSE
cjofpnpocnjfdbab	FALSE
dehddfhfmgbkcacd	FALSE
dehibjcdkpbigjkp	FALSE
doanpgbeeimdmbab	FALSE
dobbobdfcfpggeab	FALSE
eiifbhoffbpjfecd	FALSE
eijaiigllaginkcd	FALSE
fdlccpnmenpmkpcd	FALSE
fdlmeholpaidmmcd	FALSE
fnmhelhoofdjcbab	FALSE
fnngmboegjkfnccd	FALSE
gjadkkfmedoedkab	FALSE
gjajlmookjmdcecd	FALSE
hcmfnlamipgoobcd	FALSE
hcnbbkcpdphmincd	FALSE
hncgpgkihgkoafab	FALSE
hndeihcjanoanpab	FALSE
ihgoenlikgfbincd	FALSE
ihhbbodggoadkoab	FALSE
jbfdepipbicpgkcd	FALSE
jbgcalppeibogocd	FALSE
jldoppnmekicdekl	FALSE
jleegghcmpcngnab	FALSE
kemhgicmdhnnpdab	FALSE
kemhgopojkjaanab	FALSE
kofdohkdjkdjiiab	FALSE
kofkgfffddijckcd	FALSE
ljjeeflpjdjenncd	FALSE
ljkmkfijiomhbfcd	FALSE
meciodpaflgmpkab	FALSE
medpablpjknmille	FALSE
mnlepmnkhfeabmdn	FALSE
mnmaoikbipioclab	FALSE
nicpeikaagckmabh	FALSE
niddampaigdphfcd	FALSE
obhigcdjkfkfjeph	FALSE
obidbckeddhlcecd	FALSE
ollijmmfpcboegcd	FALSE
olmlllmcnbcdcdcd	FALSE
pgcfafebbbclkhab	FALSE
pgcmkmobenlmgfab	FALSE
aaabdmbimefpjebcd	TRUE
aabbpelghifnbbgcd	TRUE
ajibpfmalmkpnbmod	TRUE
ajjjihkbfgeefcnin	TRUE
bdlljaeiblclenilk	TRUE
bdloppkchdfpjdhpp	TRUE
bnpngjopddgodelop	TRUE
bobfibklffggkoiih	TRUE
ciklfhieahkpppgdl	TRUE
cilfnobmdlanglngn	TRUE
dceiiahplflkbeafc	TRUE
dcfgbnljemlgjfajk	TRUE
dmkbjefnichjjfpie	TRUE
dmmgnfiofcnbepeja	TRUE
egbampocdfkpeddab	TRUE
egbbjfachngfchcip	TRUE
faibplmpmgcdfhhab	TRUE
faimkmpafcgegphoa	TRUE
fkeeblabaljckancd	TRUE
fkegcdaghhkfddhab	TRUE
gdjbbkhckadnkbpfb	TRUE
gdjdmnenjkgadkopj	TRUE
gnkieaapahohjlfcn	TRUE
gnlikhgldlhnebpil	TRUE
hijlphddmeglfclgg	TRUE
hilhaofjgdiogmkeh	TRUE
idknoahdkppgohmme	TRUE
idofncmoioidngppo	TRUE
iodbcnoajooaoklbk	TRUE
iodnbehfjcpkhnjcf	TRUE
jiackcnjiejdefhlk	TRUE
jiainjbnalanjlkhg	TRUE
kccanpbhincicbfnj	TRUE
kcdbmagenebmocoab	TRUE
klifjdledlpglpppm	TRUE
klilffceimmfhomhe	TRUE
lglgfkigojaafggmn	TRUE
lglmfdmbpeebbafek	TRUE
mapbkgokjcdohhnab	TRUE
mbbdejdhiebihddml	TRUE
mmhgbpgbnhciadnbi	TRUE
mmhgjmkhonhgmnpck	TRUE
nhcbmoefpnceohkdn	TRUE
nhcgddldecckmgkfc	TRUE
obbgdpnbdhmfdkfcp	TRUE
obbgffflkeeheghco	TRUE
oliofnchnpigkljek	TRUE
oljgekcgmifghmble	TRUE
pgaehnojpgalolckh	TRUE
pgafaljkmffhmdmef	TRUE
aaabdmbimefpjebpb	FALSE
aabelghifnbbgmibk	FALSE
ajkcggekdlgdemmcd	FALSE
ajklbepfkgclnpaab	FALSE
bdonibihlggmnklcd	FALSE
bdopkokcacahddnab	FALSE
boepngkofcmjoohcd	FALSE
bofckjdnffjdgjpab	FALSE
cikobeggegceocfab	FALSE
cimdoneaajckampcd	FALSE
ddgackabhmimjcigm	FALSE
ddhabmmmijhgckhie	FALSE
dndkfmfgjjcmfecdo	FALSE
dnejicikecdnbkocf	FALSE
egbggenciegaboimj	FALSE
egcnhjejbjajilcdb	FALSE
fachkmolhdljhmeab	FALSE
fadmhkjkdojdgaaab	FALSE
fkdlgckebkepbbiab	FALSE
fkfeaeidgiagfkfcd	FALSE
geblghdekggdngbab	FALSE
gefaideblnkebjfab	FALSE
godjceilaodhkfaab	FALSE
goehmplaphmemaaab	FALSE
hipbfofhliaanjlab	FALSE
hiplkjgdpldgegaab	FALSE
idpikgnbmbjlaheab	FALSE
idpjjfmffhkfpjjcd	FALSE
iohmacoamajojmacd	FALSE
ioiaainonkchopbab	FALSE
jiaeoeicfciljgdab	FALSE
jicndkldkgdagilab	FALSE
kbpfjbhpndmejfeab	FALSE
kbpifampfaooefnab	FALSE
klokjcpmjdgjgdnab	FALSE
klpkfnghigpgjfecd	FALSE
lgghajngedgjfefcd	FALSE
lggmobpfmiheakbcd	FALSE
maojpjhojjbnabmgg	FALSE
mapefjbhkhgpohdab	FALSE
mmhdppbhcbfmldocd	FALSE
mmicanfdmgfhlplcd	FALSE
ngdkmboefelibgacd	FALSE
ngdlmgikfcgfbfhcd	FALSE
obmlhmnjjkonmenab	FALSE
obofopjiidfficcab	FALSE
olihodgemfmmeeocd	FALSE
oljmohjokabkiacbm	FALSE
pgipfacfcilfhdbcd	FALSE
pgjkfnbonppjpbgcd	FALSE
aabdjblngipjekcicd	TRUE
aadbljkajiddecikik	TRUE
ajifoaadnpemhmgapo	TRUE
ajjiebmjngclfigikn	TRUE
bdhgflbhnlnikmjecj	TRUE
bdhnficpiiokpkfcfh	TRUE
bnfdkfafiokagjgchh	TRUE
bnfhhknmgmbcnipkkf	TRUE
cibicbbkioigbijchc	TRUE
cibjbonbmddiapdndi	TRUE
dbokjclggdahpaelal	TRUE
dbphflpoepidknhgfp	TRUE
dmgcgdanmdoepjokfj	TRUE
dmhnemgkdohodgfgbd	TRUE
ehiegbcecihimgooci	TRUE
ehjgmghdfcnnfcidpa	TRUE
fcnkambjiolaeikklg	TRUE
fcnoplfacengidmoog	TRUE
fnhaojlgadicpbokdc	TRUE
fnhbhfeebgpceddipf	TRUE
giilafjnnbbjjaklli	TRUE
gijdibfcpaneibkkjl	TRUE
hcjidpgkefjbjaojaf	TRUE
hckgmkbboajgggbink	TRUE
hmlclpnnbbegjcjiji	TRUE
hmlhlhgigodohbicae	TRUE
igdkakglkndflnekmj	TRUE
igegfphgdbbedihiko	TRUE
jamifkjecfapmdabcd	TRUE
jamillaifhedfejdjb	TRUE
jldggcbealmjmacdab	TRUE
jleojaedkflpflbaef	TRUE
keopagganepcfkommd	TRUE
keplfbmkpmaangjeoo	TRUE
kojednbiabfhgbphcd	TRUE
koklomabkgdblopgcd	TRUE
ljcdajdicmphjmjabp	TRUE
ljcinafgfheoiocfli	TRUE
mdjnokfoamggiiaemg	TRUE
mdnhmgflniloopnmee	TRUE
mnbhpildgjopofhekh	TRUE
mnbmodfhahkmhabbcd	TRUE
ngdnakjcmdohipmblk	TRUE
ngekemdakkahkkeeah	TRUE
obcbeommoehbogajep	TRUE
obdkilkpineomlfejd	TRUE
oknlfjjmfajhokimaa	TRUE
oknljpnplfhkmpcdab	TRUE
pgbhalegdeiinbdeli	TRUE
pgcgfgbekognoieaip	TRUE
aaaohfpmfdhbcghicd	FALSE
aacdgmlahionagagbk	FALSE
alfhphkpoihcpglocd	FALSE
algfojfipckimjnpcd	FALSE
bfldkonkfemgaafbab	FALSE
bfmbghofhnkchnalcd	FALSE
bonefgllhojmcmogcd	FALSE
bonfcmhiimfakgdpab	FALSE
cilikefodmkelkkhcd	FALSE
cimclmbfkjjeaamdcd	FALSE
dbncjnpejgfjnipacd	FALSE
dbndliaeabmjedpneb	FALSE
dnknkolcnkfgpehocd	FALSE
dnmgbdjedjoeamfjab	FALSE
ehpjcnhjfkbdgcjkab	FALSE
ehpojhlcbggjmjfmcd	FALSE
fbfkgmjocecoinnpcd	FALSE
fbihinngfdngfhilcd	FALSE
flilmaooebnkokjiab	FALSE
flkfmlmdhmhjjahocd	FALSE
gfgloeinjcokjimhab	FALSE
gfhanfjmgggjiebocd	FALSE
haggidkgaaphnmahab	FALSE
haigjfmomngglelocd	FALSE
hkgnlifbbaobnidjcd	FALSE
hkhlnilkjhgfckjfab	FALSE
iegnejbjgjgdcaolab	FALSE
iehpklpnebkbafdmab	FALSE
iplgcfhpdckajbjgcd	FALSE
ipmehhhoelmmlkneab	FALSE
jjdpoafakkoohioicd	FALSE
jjehcddbhpdjgdmdin	FALSE
kecoabnidmbckofkga	FALSE
kefkejfebhgifhnkcd	FALSE
kpdkeedllilbcpicdk	FALSE
kpelmocmlilibafpcd	FALSE
ljjpnfagaflijahmcd	FALSE
ljkbpnfffhmgkjjnab	FALSE
mehdkknojjlpkdjdab	FALSE
meidlkjlblkfmnpmab	FALSE
moehaikbdlfhnhedcd	FALSE
moehpjgmmeflhafecd	FALSE
nhdlfagmhkkabchmak	FALSE
nhegmfchjpnjbkmkab	FALSE
ocbdmnlodemekjmjcd	FALSE
oceaecfdggefenjdab	FALSE
olpgnijfjmcogflecd	FALSE
olppdijbgmacmaekcd	FALSE
pgicdnpanfbbhkhlfd	FALSE
pgifehhlanjhkdoccd	FALSE
aaapeppgaiebaeckakl	TRUE
aabfafhahiocajnoncd	TRUE
akaijehdgicfipapomd	TRUE
akajfgcpigmbloapncp	TRUE
bfadegncppmnpdhhgon	TRUE
bfbdgmapbhjiejfflij	TRUE
bpncaeokpkfppojbkbi	TRUE
bpnlemmkfgmajbgfiib	TRUE
ckbpcpnodnaokoocbic	TRUE
ckdmpikmbljpgmcacai	TRUE
dfgfpjpaedffdebjida	TRUE
dfhkcdapfaajlmfpabc	TRUE
dpcgfadidelnadbgfin	TRUE
dpclchoigcjpjcdigab	TRUE
ejdcpmpfodcogkodhdj	TRUE
ejdheekigoelmknkipj	TRUE
feehakpclojcncomdnd	TRUE
feeiadgipplhfbjpepd	TRUE
fpfmaipoehfoekfbldo	TRUE
fpfmcnpmedadnfdiigo	TRUE
gjdjaffepdflcpfoacl	TRUE
gjdmkehfppnnoidlllc	TRUE
hdomegelnmapjdpkhfp	TRUE
hdoppmafmobpigmbkln	TRUE
hnlfeinobkfgbidkojc	TRUE
hnliilnebchgonbimga	TRUE
ihppgmpminbfnepjmdf	TRUE
iiaaicceemnfhgddele	TRUE
jcakljaamfojpjpdjng	TRUE
jcdblbmllcngapekhab	TRUE
jllhcmpennekidmobpj	TRUE
jlmdmionlkmdcjkjphn	TRUE
kfihabndgklheddbdcd	TRUE
kfjapfhcnpcnapkdeak	TRUE
kpmadmhmenokeolkkhe	TRUE
kpmdmocbhbeaopmonjg	TRUE
ljhjhjnidpcihnhobph	TRUE
ljimoladeohikdpogbh	TRUE
mepfenceeookpcajehi	TRUE
mfbeihfghjjelofihgd	TRUE
mompfbenehcgkkdccpb	TRUE
mongbmalbgpoojfgcag	TRUE
njabgnomcpdeddfhicd	TRUE
njbnkeboehfipdagfda	TRUE
odnlillhjhcfnemcafn	TRUE
ododadekdgglmghdicl	TRUE
ooglhmdciehkfiefbcp	TRUE
oogmjhkmcdjmdpffhab	TRUE
pgmmcejpgckhcjjfnen	TRUE
pgolfidmejcbdeodgpk	TRUE
aaapeppgaiebaeckabl	FALSE
aabfafhahiocajnonko	FALSE
akbhgjckfkocghhjncd	FALSE
akcghmicephfacgeacd	FALSE
bekdponimpmkdmhkbcd	FALSE
belbajloldcjcgjabee	FALSE
bpoimeeelbndomcdkkh	FALSE
bpokgchgglpmipefkab	FALSE
cjlbbijlfbagkhkhecd	FALSE
cjmjkcgccjcdfbcofgc	FALSE
dfaidikllejknhcoccd	FALSE
dfbfopogpohlfnijhab	FALSE
dpfhmkjddojddchagab	FALSE
dphbemcnodeakgfnbcd	FALSE
eiokdgiamnkleiihcab	FALSE
eipcbcdeeonhnlmgpio	FALSE
fejjfabhpjmiaonmbaf	FALSE
feneojmdcbconciigab	FALSE
fonfkjohkbbflbjdpcd	FALSE
fpadamlcjnefbodnkcd	FALSE
gjkjajkpgeimpndaacd	FALSE
gjknjpiecbiejpgnhab	FALSE
hdlojdmfdldogalhlcd	FALSE
hdmhdfppjiifdppeaab	FALSE
hniamdkmpldmlkplmab	FALSE
hnidnjgefdggofmbkab	FALSE
iicgdobhhblfjjbjdab	FALSE
iiegbekjkklnbkmhcdl	FALSE
jblmfnlgegafobpijab	FALSE
jbmhlaageeijgiepjcd	FALSE
jkifhgoehfgkjgeigab	FALSE
jkihalddneedjfaddab	FALSE
kgeigfibmlaglinhiab	FALSE
kgeihkfjfiogbopfnab	FALSE
kpjeiiojialohcdkjcc	FALSE
kpjhpkcoogghidfncdn	FALSE
ljmegbgfbfgoplfgocd	FALSE
ljndkgoaipejcfmincd	FALSE
mfchjgohjeljfgcifab	FALSE
mfcigjaogkbkoknnnab	FALSE
mompnifahiblcjcgfcd	FALSE
monkngnbnfmobhmgoab	FALSE
njjldppenejimonmecd	FALSE
njkiohcfhmbiochjiab	FALSE
odmdagbpbaocbcfohcd	FALSE
odnfhdojdaelgjbgocd	FALSE
onjdemljcjhddkjeicd	FALSE
onkdhahcghcoleediab	FALSE
pgjilafphckfpboipcd	FALSE
pgkgebefdldpllngicd	FALSE
