aaajdoafab	TRUE
aaboghgidm	TRUE
aldehebpbl	TRUE
aldhmnendh	TRUE
bgldkmcmlh	TRUE
bglfajbmal	TRUE
caijgkcflf	TRUE
cailjinihd	TRUE
cjdnahgfoc	TRUE
cjedaldjgj	TRUE
dbpgnkbdih	TRUE
dbplkcfega	TRUE
dlmmioohin	TRUE
dlodchiaek	TRUE
egeaicpmgh	TRUE
egednaioon	TRUE
fabhibfgle	TRUE
facfebhchn	TRUE
fkccoamhgc	TRUE
fkclkhmagb	TRUE
gdplhbacml	TRUE
geaepfodep	TRUE
gpgjfnhiee	TRUE
gphemlhdce	TRUE
hjnfnlopjc	TRUE
hjnhihdcbl	TRUE
ifgpclhefd	TRUE
ificnpmagn	TRUE
ioakdkiepl	TRUE
ioanhdonif	TRUE
jibbfgdcmg	TRUE
jidgaeoace	TRUE
keeeppbbmp	TRUE
keeiikgbao	TRUE
kphdgkjaab	TRUE
kphgjcjopb	TRUE
ljhcmlchnb	TRUE
ljifpbcdoa	TRUE
mchfdgehon	TRUE
mcihhnlgmp	TRUE
mnfhjoaeeh	TRUE
mnfnhnejnh	TRUE
nhhbocojlo	TRUE
nhieamejeo	TRUE
obnbabkjgb	TRUE
obobhincfe	TRUE
omlkjfjhbe	TRUE
omllphkhbo	TRUE
pgmjndjffh	TRUE
pgncnhpehk	TRUE
aaaceodokm	FALSE
aaajlienph	FALSE
alnhkjhpaa	FALSE
alnpepbmaa	FALSE
bfnhhjpnaa	FALSE
bfoeblfbaa	FALSE
cagflfamaa	FALSE
cagonemjaa	FALSE
cjkmbeigaa	FALSE
cjnhaallnf	FALSE
dcdppehnaa	FALSE
dcgiikjoaa	FALSE
dmdkahbgaa	FALSE
dmdomnpdaa	FALSE
egbcllmkaa	FALSE
egcoobgeaa	FALSE
fafpbdgoaa	FALSE
fagimljkaa	FALSE
fjgiblbhaa	FALSE
fjgjcmldaa	FALSE
gecakpllaa	FALSE
gedfbgadaa	FALSE
goolhehkaa	FALSE
gpahhahjaa	FALSE
hkackfghaa	FALSE
hkaefdjlaa	FALSE
iejifpeeaa	FALSE
iekdileeaa	FALSE
ioemkmbjaa	FALSE
iofciggmaa	FALSE
jiflghcfaa	FALSE
jigegcffaa	FALSE
kdpaefjaan	FALSE
kdplejgfaa	FALSE
koponjkfaa	FALSE
kpaijlloaa	FALSE
ljelhjmgaa	FALSE
ljeljfcbaa	FALSE
mdcamjojaa	FALSE
mdcocedaaf	FALSE
mndclakbaa	FALSE
mnemijdpaa	FALSE
nhimbemlaa	FALSE
nhjiddcdaa	FALSE
ocidgjlaag	FALSE
ocjmcbfjaa	FALSE
omiognkkaa	FALSE
omiphcgoaa	FALSE
pgmonmpjaa	FALSE
pgobinnbaa	FALSE
aaajdoafoab	TRUE
aabghgidmdk	TRUE
aldokmedbmg	TRUE
alegbphpkkk	TRUE
bflicdlfgmb	TRUE
bflkmmbodco	TRUE
cadjhioacgl	TRUE
caeiolddljc	TRUE
cimgoigofml	TRUE
cimkeefhpgi	TRUE
dchihcaooff	TRUE
dciaappinab	TRUE
dmfhldfmjik	TRUE
dmgddmgegcc	TRUE
egmemgfooil	TRUE
egmifnblmdj	TRUE
fagagbdbjcm	TRUE
fagmbbpkkpp	TRUE
fkginlnldbk	TRUE
fkhhihoodbm	TRUE
gegnihfiamm	TRUE
gegphoikmfg	TRUE
gpefcinkoep	TRUE
gpejadoadeg	TRUE
hkelhcdbfmd	TRUE
hkfnnhfcnnk	TRUE
ifblmfankbo	TRUE
ifcadegmjch	TRUE
iojcalddmce	TRUE
iojknkmkjog	TRUE
jihppnalfih	TRUE
jiinanpphoj	TRUE
kclomfcmfjf	TRUE
kcmljfpfdba	TRUE
koojpepkfhd	TRUE
koolfkfiold	TRUE
likbakmgcom	TRUE
lilbgeelfkf	TRUE
mcphlfcdmnp	TRUE
mdalgadpgmm	TRUE
mmnbpefbahh	TRUE
mmnenndnfpk	TRUE
nhpaljcaoje	TRUE
nhpecfhhcce	TRUE
odfpmocgemm	TRUE
odghhgbieeb	TRUE
onigdlngbkh	TRUE
oninfnkfapl	TRUE
pgociigkccf	TRUE
pgokhgioibo	TRUE
aaafekmpngj	FALSE
aaagdpbgdmb	FALSE
albboknodaa	FALSE
albeknhmfaa	FALSE
bejffipiaac	FALSE
belhimpchaa	FALSE
bofmdlbdeaa	FALSE
bokbojkkaao	FALSE
cihfoejjhaa	FALSE
cihhagkadaa	FALSE
ddahmmibeaa	FALSE
ddambaaimna	FALSE
dmnahgmomaa	FALSE
dmnidlaefaa	FALSE
egnlhemafaa	FALSE
egnnnjpkiaa	FALSE
fbapmakppaa	FALSE
fbbcnlkifaa	FALSE
flpcbhejhaa	FALSE
flpckjdjkaa	FALSE
ggklfkhlcaa	FALSE
ggknkcllaao	FALSE
hahajmaomaa	FALSE
hahjkhamgaa	FALSE
hknkchomhaa	FALSE
hkoajbeolaa	FALSE
ifgaeihjgaa	FALSE
ifganchifaa	FALSE
ipeghffcnaa	FALSE
ipepgmefhaa	FALSE
jjaoimbidaa	FALSE
jjcdapciiaa	FALSE
kciihkfboaa	FALSE
kcjijcfeoaa	FALSE
knjiknihiaa	FALSE
knknolaiaan	FALSE
linlmgimgaa	FALSE
liohklbhfaa	FALSE
mdchipmnlaa	FALSE
mdcnaajbdjo	FALSE
mmnbalhoaai	FALSE
mmpdjodpiaa	FALSE
nfonphflpaa	FALSE
nfplefmbiaa	FALSE
npcdddcdiaa	FALSE
npdpmefgoaa	FALSE
okoogepmlaa	FALSE
okpmhiimoaa	FALSE
pgeeoghagaa	FALSE
pgeifiianaa	FALSE
aabgokkabblo	TRUE
aabnikfapdpj	TRUE
akggcdmgjjdm	TRUE
akhdlegnchmg	TRUE
becjgkkalbif	TRUE
bedkgafiikfn	TRUE
bolghepiblgk	TRUE
boncpccmekeg	TRUE
cjehefhaemnl	TRUE
cjejijcnmkic	TRUE
ddapefknllgh	TRUE
ddbfbheemopp	TRUE
dmmjhgoiffgh	TRUE
dmnfnbkochmh	TRUE
ehaocoelpplk	TRUE
ehapjaakddab	TRUE
fbddmjmfafhj	TRUE
fbdlhcgllgdg	TRUE
flmoiogpfpoj	TRUE
flnhbaojbklm	TRUE
gghghkncaemh	TRUE
ggicdallpanc	TRUE
hacfbnmblaee	TRUE
hacjakpmjpod	TRUE
hklojaknpfol	TRUE
hkmdahefgmih	TRUE
ifbhmkhjgaho	TRUE
ifbidmibmhmo	TRUE
ipaglgabjjei	TRUE
ipboongdofko	TRUE
jjdilbopofja	TRUE
jjengpjojind	TRUE
kcnempocngge	TRUE
kcnfndfinnnj	TRUE
kmodbfmakiia	TRUE
kmojkfflnkdf	TRUE
lhnhihnpehbc	TRUE
lhofjkicgmjb	TRUE
mcohgoaloegm	TRUE
mcolchahdine	TRUE
mmimnangdhbo	TRUE
mmjcidekpapc	TRUE
nfijkbkakeib	TRUE
nfjogcmmdgic	TRUE
npjenfhhhkda	TRUE
npkcegipjgcg	TRUE
olejfhaacmab	TRUE
olfbhcelgcpm	TRUE
pfjjkbiebfek	TRUE
pfmmdghecfai	TRUE
aaalomoachjl	FALSE
aaanljipjjoa	FALSE
ajjlgapjkdaa	FALSE
ajjlmmicagaa	FALSE
bdphnidmaoaa	FALSE
beceielcdmaa	FALSE
bnonmfgahoaa	FALSE
boacbglgnaal	FALSE
cifgjnekgiaa	FALSE
cifoioimkeaa	FALSE
ddbenagnfnaa	FALSE
ddcbmmjmcdaa	FALSE
dnjacgkmmbaa	FALSE
dnjgbfldmoaa	FALSE
egngoofhpaac	FALSE
egpbdgnmkfaa	FALSE
faplneblobaa	FALSE
fbbmmjjlmnaa	FALSE
fledhanlldaa	FALSE
flehclmcamaa	FALSE
ggbpeelafnaa	FALSE
ggcaeldfdgaa	FALSE
hbimioockoaa	FALSE
hbinkkodmkaa	FALSE
hmggmkicneaa	FALSE
hmhaefmlffaa	FALSE
ihajalbcaeaa	FALSE
ihcbpjhhjpaa	FALSE
ipookbhganaa	FALSE
ippcbknpphaa	FALSE
jkdniifdfpaa	FALSE
jkfbopigkbaa	FALSE
kdblkfffpbaa	FALSE
kdcmdakfcbaa	FALSE
kmhcjlmghbaa	FALSE
kmhockoalkaa	FALSE
lgpmjkomapaa	FALSE
lhahhijlcbaa	FALSE
mbdjeedjlhaa	FALSE
mbedpaelieaa	FALSE
mmiaooodiaaf	FALSE
mmiienhbpbaa	FALSE
nhnnffopngaa	FALSE
nhnpgnbnibaa	FALSE
obiapkmjheaa	FALSE
obimoidhliaa	FALSE
olpgjbflbjaa	FALSE
olpkmljhcpaa	FALSE
pgalmhelhiaa	FALSE
pgbdighbceaa	FALSE
aaagcfipejmab	TRUE
aaaljmanlcdab	TRUE
ajbhamhobndie	TRUE
ajbilggnomkpm	TRUE
befopfbelmaoa	TRUE
befpfgidelkie	TRUE
bobokgpomckod	TRUE
bocdfpjcdfobf	TRUE
cibbnhiaghcjh	TRUE
cibclpoafikei	TRUE
dchpnijhkoepp	TRUE
dcidffklphjkn	TRUE
dmnnnnbicjahh	TRUE
dmooeebilcmfo	TRUE
ehelphkjbllhl	TRUE
ehenpolmkbdkc	TRUE
fapiioibobnek	TRUE
fbadjbmgnokbd	TRUE
flhibhbhdonfe	TRUE
flhpjbgoedmom	TRUE
ggjmofhapfnic	TRUE
ggklnlgladhib	TRUE
hapldflemphoi	TRUE
hbblfadcpgcel	TRUE
hmdcedmbgeclk	TRUE
hmdpejncojeoi	TRUE
igboblghfhkpl	TRUE
igelolljgieid	TRUE
ipohadiimbmpb	TRUE
ipollhmfkpdmp	TRUE
jjcmpojdijkdl	TRUE
jjfnmjebdfijd	TRUE
kciblkbmjdimp	TRUE
kcifnoalopmmp	TRUE
kmldhlihlmpdd	TRUE
kmlioheamknjb	TRUE
lghlidddhhjle	TRUE
lghnegmodgabn	TRUE
mbkioeicnklaj	TRUE
mbmifddgpipad	TRUE
mmgjhalbjopld	TRUE
mmidelhacgabn	TRUE
nhfaoihgijpgm	TRUE
nhfcmkoenbcko	TRUE
obljebecjikhl	TRUE
obmdodnieohbe	TRUE
olhbnekffebjl	TRUE
olhjfhhakgccj	TRUE
pgaacincpblab	TRUE
pgapfaaanocab	TRUE
aaaelffjpadnh	FALSE
aacbmcafbkeld	FALSE
ajpcldgamcgaa	FALSE
ajpidmmdlhiaa	FALSE
bdicicbbgmeaa	FALSE
bdklkocadjmaa	FALSE
bobaemamjjjaa	FALSE
boblgaodanlaa	FALSE
cijoncelppgaa	FALSE
ciojhmlonoiaa	FALSE
dceofmffhkoaa	FALSE
dckadbencacaa	FALSE
dnfmpebnhdhaa	FALSE
dngbpcbgbbkaa	FALSE
ehlddcklikkaa	FALSE
ehofcenkpmnaa	FALSE
fbkjmajlmagaa	FALSE
fblbecndeokaa	FALSE
fliknkijnncaa	FALSE
fljgcdlefbeaa	FALSE
ggcdjnmpfjgaa	FALSE
ggddedkobohaa	FALSE
hbflmecemgkaa	FALSE
hbghfgjhgjnaa	FALSE
hmmgbfffdolaa	FALSE
hmmkgcpdhhjaa	FALSE
ijhnlegglajaa	FALSE
ijifncdjojoaa	FALSE
jcpfnjiplccaa	FALSE
jdadgcogimfaa	FALSE
jlhkocnpmecaa	FALSE
jlibocdcehoaa	FALSE
kfgdplcdebhaa	FALSE
kfghgnmelaiaa	FALSE
koifioelihpaa	FALSE
kokapcankjfaa	FALSE
limohkmobgfaa	FALSE
linccfaehipaa	FALSE
mecijmnlgmaae	FALSE
mecpkfohhpeaa	FALSE
mnhhddmajnmaa	FALSE
mnijkdclnneaa	FALSE
nhilcofepilaa	FALSE
nhipfodolobaa	FALSE
obopoaaemiiho	FALSE
ocafdbimciaap	FALSE
olplfoncpopaa	FALSE
omcaihfffccaa	FALSE
pgbihlpnlmdaa	FALSE
pgcdjlafcniaa	FALSE
aaafbgdkemafab	TRUE
aabgnbedobjmbh	TRUE
ajgickbddonbjl	TRUE
ajgopghdpbhobf	TRUE
bdmfnbcgifcgce	TRUE
bdmkbpdojjmpac	TRUE
boealfkaeialbc	TRUE
boednoblnibgnl	TRUE
cimgdajbikijeg	TRUE
cimmfekfgmhjbl	TRUE
dcjhidfpeppkpa	TRUE
dckimmiomhadbp	TRUE
dnfflppgacalpj	TRUE
dngcacbkcecmnc	TRUE
eheilcmjjabljj	TRUE
eheminjclnjfgp	TRUE
fbnbjochipgpfe	TRUE
fbnmkaaeeiccab	TRUE
flenfnmelfbnpb	TRUE
flfbocompoahle	TRUE
ggbldomklidjkj	TRUE
ggboghpgbdkemj	TRUE
hbmgnaljlomoed	TRUE
hboidalilpjihd	TRUE
hmfgkglichcdnd	TRUE
hmgbodafmjploi	TRUE
iiadjldckeaojl	TRUE
iiafbdabapamji	TRUE
jclmhgdikhgjfb	TRUE
jclogdikomkkkc	TRUE
jmkbifejjbdokm	TRUE
jmkmlacacigcnp	TRUE
kfpppjipgdaglc	TRUE
kgajnphgkdagmf	TRUE
konhkojkopilil	TRUE
kookfikcfaljop	TRUE
lilamnldfjlepk	TRUE
lilmcgjbmpbnln	TRUE
mdgbegkibaajab	TRUE
mdgblnafekegpb	TRUE
mnlhmopjcjobah	TRUE
mnljmnilnbnefj	TRUE
nhhaeeppcipfdn	TRUE
nhhafcbgdgnmbc	TRUE
obpbppephekfdb	TRUE
ocahgjekdbgofm	TRUE
oljknmnjnfnclo	TRUE
olkdhapakoocef	TRUE
pffmjlgcgidbho	TRUE
pfghlcgodlfhaj	TRUE
aaccfkdnanldnl	FALSE
aadjinmbeoiimd	FALSE
ajnimbihcppaan	FALSE
ajogipijbajcaa	FALSE
bdkfgbllnjipaa	FALSE
bdkkhmbomedeaa	FALSE
bnkkogmpneldaa	FALSE
bnkkopkagdonaa	FALSE
cikpcoaegegfaa	FALSE
cilbagkhpjepaa	FALSE
ddmcpmakkddcaa	FALSE
ddmejinhoaanch	FALSE
dmphjcehkpdhaa	FALSE
dnaacfemaacekf	FALSE
ehmhcbiadapnaa	FALSE
ehnaimfpdhboaa	FALSE
fcbmaadjmdicje	FALSE
fccfgghkmjebaa	FALSE
fmhemnmhfdopaa	FALSE
fmhlgofgmkmnaa	FALSE
ggaapofcmlmjic	FALSE
ggaebgmfpgdiaa	FALSE
hafkfepmnjagaa	FALSE
haflddljbicoaa	FALSE
hlohjhiifgjfaa	FALSE
hmbbgkhbdccmaa	FALSE
igafegfkjpnoaa	FALSE
igagdailpjepaa	FALSE
jaahdeemgddfel	FALSE
jachinjbfjpmaa	FALSE
jjcemckjepneaa	FALSE
jjcjflfffnioaa	FALSE
kegcogblejbiaa	FALSE
kegejidfbpgdaa	FALSE
koangdlgkdkbaa	FALSE
kobknhfnfmlbaa	FALSE
lidekcboknjdaa	FALSE
lifcbjeinljnaa	FALSE
mccambidemieaa	FALSE
mcckcmmojljkaa	FALSE
mlfenljfcfpgaa	FALSE
mlfhkmiikjoeaa	FALSE
ngdmcbcafjpoaa	FALSE
ngecmdipnhgeaa	FALSE
obeihjjllihaah	FALSE
obejnmkpkdeeaa	FALSE
olmbikapnogoaa	FALSE
olmfbhhefgakaa	FALSE
pgfgcbkibldnaa	FALSE
pgfobmhafcfiaa	FALSE
aachoelhglohfab	TRUE
aaddofmcjhbhhab	TRUE
ajmoinbbjkojbdg	TRUE
ajnfckhaamodbab	TRUE
bebickabnhfhmek	TRUE
becnbnenendpgdi	TRUE
bnjinlfbdagmdii	TRUE
bnkigflemgnkpdp	TRUE
cihcbdbpojpjcnm	TRUE
cijcmelndogghgp	TRUE
ddcebjifnplnhbn	TRUE
dddndhaiepcgpej	TRUE
dnapipogphmpecd	TRUE
dnbkcbfancdjkjh	TRUE
ehlcodhlbbkddin	TRUE
ehnanlghedlcbdj	TRUE
fcncnkljncciffm	TRUE
fcndjjjhmfnmkic	TRUE
fmenbocallfnhag	TRUE
fmfkjfoglambofi	TRUE
gfkgmceacdomaab	TRUE
gfkoagihpjmhmbm	TRUE
hakanfgamknjjdf	TRUE
hakmpkilefjamad	TRUE
hljllafdeaneoin	TRUE
hlkffaelecjhjna	TRUE
igiknpheonfklfa	TRUE
igindbbhhfmlghn	TRUE
jaagbcigjjnhbab	TRUE
jaapecmjpdkonab	TRUE
jjmhnnkfffghaab	TRUE
jjmpjanigfahdjd	TRUE
kebjocflgfecfcd	TRUE
kecgfpgopappojn	TRUE
knenhmgmcejoacp	TRUE
knfmkgmeggnmkec	TRUE
lhjnkjkegdppidp	TRUE
lhjobnikbogojfn	TRUE
mbgpdjgchabpkmh	TRUE
mbigejpjkkemenb	TRUE
mliaookkhdbfaig	TRUE
mlibmlheeijogdm	TRUE
nghnbcooghfapcl	TRUE
ngkklljbgkagnjk	TRUE
ocaepmhiiamjjoe	TRUE
ocamejneocokhfp	TRUE
omagklgpfbbgcde	TRUE
omcidnflipgggca	TRUE
pfipmjbkkphelcp	TRUE
pfjailbbcfjbmfk	TRUE
aaaffkcmhklokco	FALSE
aaaoodikhjgplco	FALSE
akemdgmlgbbafaa	FALSE
akfhdnjkooaodaa	FALSE
bcnmjeggmaennaa	FALSE
bdaakmmgblkmphd	FALSE
bmlijbijlmfloaa	FALSE
bmofdecegopihaa	FALSE
cgmcnffbobdegaa	FALSE
cgmmigaaeelbfpo	FALSE
cpoohhlbkpeokaa	FALSE
cppgdccgmihpiaa	FALSE
dkdfhhdbodbcoaa	FALSE
dkehgfnhhhkplaa	FALSE
eeefflibmbhpaae	FALSE
eeenodhnekopnaa	FALSE
eoeeffekigbjmaa	FALSE
eoemmkhdhemmoaa	FALSE
fjnbjiodlgdbdaa	FALSE
fjnofiakffaegaa	FALSE
gcmfjfapckampaa	FALSE
gcnaacnonpejaep	FALSE
gnhafodcgehidaa	FALSE
gnigapbbmhfbfaa	FALSE
hignhofbjoiefaa	FALSE
hikbceopgmpiiaa	FALSE
idpafbfmpnlngaa	FALSE
ieefafdhfoaajhb	FALSE
iomoggmihfmkeaa	FALSE
ioodjckiglgpdaa	FALSE
jiapaeedikndoaa	FALSE
jibahoiianhnjaa	FALSE
kbcjeeoeeebggaa	FALSE
kbdlgldcnfhpcaa	FALSE
kmgigchgdegheaa	FALSE
kmhdeibgilopeaa	FALSE
lggcboaphklmjaa	FALSE
lggimhldoggffaa	FALSE
lpkoilcccmmdiaa	FALSE
lplikkhkgpdlkaa	FALSE
mjbpnapcjcellaa	FALSE
mjeanmpbnccnlaa	FALSE
nfaenpnnohmckaa	FALSE
nfampbbejkandaa	FALSE
noojaogndhilfaa	FALSE
noppjgeaekkipaa	FALSE
ojehdkjlneipdaa	FALSE
ojembjofnmpdmaa	FALSE
pfaffenjojkgnaa	FALSE
pfbjjeecincocaa	FALSE
aaadpihgbdbkofab	TRUE
aabeplagbamahbod	TRUE
akfedpjdokmlnmkn	TRUE
akfiacmpecfifkcb	TRUE
begaefblelkndgbb	TRUE
begmlmfeicknbibl	TRUE
bonpdinnlbhoopnn	TRUE
boohnhbmmdncjhdn	TRUE
cjcgcblcjpbhlkpn	TRUE
cjdfpamceedcfekc	TRUE
dddhimkcfnaljeog	TRUE
ddedmpgkmifgajng	TRUE
dnlhhpgdfpchmple	TRUE
dnlmcmickopbfebf	TRUE
ehoaknbiagicbpmp	TRUE
ehodnacncemkifkb	TRUE
fbnidcfgkknefomb	TRUE
fbnkhglohnndegem	TRUE
fkpldblphpifejlp	TRUE
flafobiaccohbkhf	TRUE
gefhkhoiaijodakb	TRUE
gehkmgllhjkncfle	TRUE
gpeonepgfplnlaog	TRUE
gpfcipljhfeihejf	TRUE
hjmkgjcglpjklofd	TRUE
hjnbgipgamnpfgfp	TRUE
idonjfneipccbmna	TRUE
idopmdhlheldlpic	TRUE
iokkpidehjjemaoh	TRUE
iomkejjldnbfdgdk	TRUE
jicdhaiffjibjfbl	TRUE
jicmhlmgflahhafb	TRUE
kcjcbklhgnbefgmb	TRUE
kckdciejhhicgkid	TRUE
koakgbijanohmkcp	TRUE
kobcgfgfapajfadl	TRUE
lhhcppeolcppbbhl	TRUE
lhldibpnmljicmen	TRUE
mchbachimipaodko	TRUE
mcimflajbkobdpoa	TRUE
mnghhgeplklghhfp	TRUE
mnhiopjllkciiejo	TRUE
ngpjkcjnoldhakog	TRUE
ngppifkidknanhhm	TRUE
ocbcholknmlpbdgn	TRUE
ocbcnkeknbihnebp	TRUE
omekfoelopjdnnil	TRUE
omfmelkhkgejdfgp	TRUE
pgjjpjnlkpbhcdoc	TRUE
pgjllepagncoeggg	TRUE
aaaekfgojkpdhecm	FALSE
aaapdmlfcpaeheoa	FALSE
aknamikafpfmbfaa	FALSE
akndbaokkoggdaac	FALSE
bepcklklibhnbgaa	FALSE
bfahcejnppomodaa	FALSE
boofmobolfmmnlaa	FALSE
bpaccjfkemgikaaa	FALSE
cimplmclccfeecaa	FALSE
cinijeppbjhlfaan	FALSE
ddjgoddchfdfigaa	FALSE
ddjmidnckdchijaa	FALSE
dniphebajfhljjaa	FALSE
dnippbgejifkgoaa	FALSE
ehiliddlgeghnkaa	FALSE
ehjehpnjpnbikoaa	FALSE
fbghgijicfehbcaa	FALSE
fbghndcempegdfaa	FALSE
fjolcbajkmcnpeaa	FALSE
fkbiiokfgmaigcaa	FALSE
gfkfkahonobiigaa	FALSE
gfkkgcmiohifgdaa	FALSE
gpekgnfdlccgaiaa	FALSE
gphbicehghedodaa	FALSE
hjbcakmlacmhcmaa	FALSE
hjbfiaeflopkenaa	FALSE
idkanfpppgmmjhaa	FALSE
idldppplpfemdfaa	FALSE
iohjgbcjbdeaihaa	FALSE
iohmlejgkjjbgaah	FALSE
jiimkponopjbanaa	FALSE
jinojfpnmbnchaap	FALSE
kcojphjpaipoefaa	FALSE
kcpjjmckkngadcaa	FALSE
knffejbpakkahnaa	FALSE
kngagjcmnnacjcaa	FALSE
lhimjmjpjpbkmaak	FALSE
lhkencmljpnnmlaa	FALSE
mcbfmlaacbdnnkpf	FALSE
mcbmgeeiegddgdaa	FALSE
mndaeffeanegflaa	FALSE
mndflkodkmlimaah	FALSE
niciljekfcikekaa	FALSE
nicogfghcfbmbfaa	FALSE
ocemdblipaapkado	FALSE
ocfddmgcmiakodaa	FALSE
omhmlaahlcdndpha	FALSE
omjapnkpfobjlpaa	FALSE
pgfbfghohcooknaa	FALSE
pgiechaaiffpafnb	FALSE
aaahncgbfdpcfclab	TRUE
aablabkoocjllpkfl	TRUE
ajjcdffpdjbemlcde	TRUE
ajjdfcdemnjoipjif	TRUE
bfepenmmglflbodgi	TRUE
bfhgpkkafkhmgfmlg	TRUE
caaocmpbmicjlhbab	TRUE
cabajlcglknknkomn	TRUE
ckmfednhfnldacckn	TRUE
ckmmipedbcgmppgpb	TRUE
dgfgiopchaenipbeg	TRUE
dgfhkakplpcfpaoca	TRUE
eajgjdahkcmdjjomc	TRUE
eajjnagoeodbmpghb	TRUE
ekeimhnjpcplcchjl	TRUE
ekfpcpkdmpblaagab	TRUE
fdmacpnmgeaocinoo	TRUE
fdnigfplkjphjoacj	TRUE
fobfonnimopfjimih	TRUE
fobkhjfanpdncagbn	TRUE
gjdncnflepilogmpj	TRUE
gjenaabmjphfngkpf	TRUE
hdfklkijmjleigjoj	TRUE
hdgfmgbepdfajoaii	TRUE
hnjeloakkepnimbha	TRUE
hnmjbgjpgppipnebe	TRUE
ihmacdigpejjbkaee	TRUE
ihmfaefcdbblnipgm	TRUE
jbmjcnmeanflfiken	TRUE
jbnbodlpbcdjfpigi	TRUE
jlhcbogakepigceka	TRUE
jlhkbknfgbmgbolem	TRUE
kgfnbphibfgiiioeh	TRUE
kggnjjnjlpdelegao	TRUE
lakdednlbneikekog	TRUE
lakeiglfhiofmpobn	TRUE
lkodiianjhmnaapab	TRUE
lkohphbcahpdapime	TRUE
mfgaihckmmnjmnmdh	TRUE
mfgifaefhkbgncfkc	TRUE
mpdmbbgjijflfkfoj	TRUE
mpeiabmedhaklgaic	TRUE
nipgabbpfbfhenkne	TRUE
nipjakbdmgakimgbo	TRUE
oceiggfnjoeiaecmm	TRUE
ocenljmlhangkhidf	TRUE
olloohglefecmnamg	TRUE
olmgghifbdnlfjbgm	TRUE
pgikofminklfildcg	TRUE
pginknchlegmcfdbh	TRUE
aaaakifjpgghngmfi	FALSE
aaacpindjnihlcegp	FALSE
akekdlgafojcmbjaa	FALSE
akfenamdjhkdlpbaa	FALSE
bfajkebpdikpobhaa	FALSE
bfbkapmdbkipffhaa	FALSE
cajjnacgeiglcapaa	FALSE
cajnfdepkekjcpiaa	FALSE
clfenoaafmkhhnjge	FALSE
clflkgefhanlnbkaa	FALSE
dflnlfcdckindlpaa	FALSE
dflopkiihdonpnhaa	FALSE
dpneclcnghdlamcaa	FALSE
dpogcfnnbbiindcaa	FALSE
ekghfgcjdbieblmaa	FALSE
ekhfgagdlafbdfbaa	FALSE
fdfemckbkaknpgkaa	FALSE
fdgoedpajlgcdbaak	FALSE
fnahgkhcelpnddjaa	FALSE
fncelnfhfpikkddaa	FALSE
ghfddagnjnicbamaa	FALSE
ghggmbaedkokhejaa	FALSE
haflbehglbbmdljaa	FALSE
hagaidbefdocokbaa	FALSE
hkkgadicbjnicmnaa	FALSE
hkkkkilmjcgadhfaa	FALSE
ieciddebdiepklfaa	FALSE
iecnbbphonagneeaa	FALSE
iojoghddlfkdihoaa	FALSE
iojojlfkjdgjhjcaa	FALSE
jjjpfcofeimkedaaa	FALSE
jjlchkfkehgicmgaa	FALSE
keidheegbdjnmgfaa	FALSE
keiennkmhklfaogaa	FALSE
kpcjgghdomhniilaa	FALSE
kpckcbecahbeoljaa	FALSE
ljgmfihaildaiipaa	FALSE
ljgofeiffkglmgpaa	FALSE
mdlpogifghinobeaa	FALSE
mdmndpdglpihfphaa	FALSE
mnemcjiglmdpjgoaa	FALSE
mnepjibmblkmlodaa	FALSE
nhhfmhdcocagjckaa	FALSE
nhimeopfhljmcafaa	FALSE
oakkdppmjhlpnchaa	FALSE
oamipdmpodmklcaal	FALSE
olphajicmackidcaa	FALSE
olpiacmmjegaiccaa	FALSE
pgcfejocimkklnaap	FALSE
pgdhdgnlgmooglaag	FALSE
aabbmhoaakmophblpa	TRUE
aabdnnmbapgjifjpgg	TRUE
ajohpleklbgmopjkif	TRUE
ajoplnphkcalgjbnhd	TRUE
bfhbmahehlefekkkih	TRUE
bfhecebbcclfhfpgbg	TRUE
cagciigahfnnfgddlf	TRUE
cagkjngnellbbcmpej	TRUE
ckpdleibpbglfgdkgf	TRUE
ckpgdigmnanfkogojn	TRUE
dfebckjlnoenkeclcn	TRUE
dfeighdlalcgcfnnbb	TRUE
dpjmdgiblgffkojonf	TRUE
dpliinhiplciiihokj	TRUE
ejodlolfldggchjpfc	TRUE
ejojjbpndoieebmjfg	TRUE
fdpjnlkekplpkndgbj	TRUE
fdpmhmfjhkojdnemkj	TRUE
fngonfohomjpmkfndn	TRUE
fnhdepgmhepdhhccfd	TRUE
ggomfbbflaofaofbmd	TRUE
ghahjboonhdamialpg	TRUE
haefoglmmlaapndbab	TRUE
haejbbepigjligkhfh	TRUE
hjpbjjgaahcbohdoab	TRUE
hjppbaiiipfpidnlac	TRUE
iedandcihenkjegnpm	TRUE
iediejcmnkjafbbibi	TRUE
iojadeaajohahchoab	TRUE
iojomhphlifhpfkagh	TRUE
jkaoccefhiemkhiebn	TRUE
jkbffaclfceiipmadc	TRUE
kfloglpihfphaihbmp	TRUE
kfmbgginkejecoohld	TRUE
kpjlncbdmdligdilbc	TRUE
kpjodpbhpjeaimionj	TRUE
ljlaapanibmhpkpdab	TRUE
ljlkegkhcaeekcojpf	TRUE
mdnokamiiancdckage	TRUE
meaaeaeimbphmkacab	TRUE
mmobnelkjefhoblaph	TRUE
mmpdbdkaldjponeokf	TRUE
nhbkgammdcpjckmfap	TRUE
nhblhkapdpmjececma	TRUE
obgdgijaooocpafnnj	TRUE
obhfifcdclgmhpkfog	TRUE
omcbnbhmlaefaoklgc	TRUE
omcfjhjkodngfephok	TRUE
pfoffbhjddpcdkcmop	TRUE
pfondnlglikncmadkn	TRUE
aacgilplbfekfnpdda	FALSE
aacgkamkgpkjapkclm	FALSE
akhkdmfikefaeaflaa	FALSE
akiiiddmbjjmeobmaa	FALSE
benmndfkkibpoecmaa	FALSE
beoiebjmbipmpfbfaa	FALSE
bpdcnjpmjfmegapiaa	FALSE
bpdkgjhbpdkolobeaa	FALSE
ckdfgodbgmpipbpbaa	FALSE
ckgdcohdlmhmlodbaa	FALSE
dddpboelpgegcecmaa	FALSE
ddekhcanegfbmmmlaa	FALSE
dmjlcnfbdmnemlhoaa	FALSE
dmkobcmbjblnifhbaa	FALSE
eggpnlnjkokmnjgcaa	FALSE
eghgddkinbdkbggjaa	FALSE
fafjlmcjacelpmnlaa	FALSE
fahldagmgjnkgcolaa	FALSE
fkiepeilhoflgjheaa	FALSE
fkilnpdjknoloacbaa	FALSE
gfcmgigaafjpbfkjmd	FALSE
gfdcgpmncalgdpgfaa	FALSE
hakibhlojgaghhapaa	FALSE
hakodbkfnmnjhicjaa	FALSE
hkhpipjgpcciandaap	FALSE
hkijgkedmnfcfecfaa	FALSE
ifhikkjdhebhmjfhaa	FALSE
ifhnnokohfbobohdaa	FALSE
ipbbkgfacjbmhiooaa	FALSE
ipdnfpaadgpbifiape	FALSE
jjgjcencgiplcajkaa	FALSE
jjidhmcnlimkhillaa	FALSE
kcphbjfgcaeipopkaa	FALSE
kdammfapbpgpgbndaa	FALSE
kmhkigokfnimljbjaa	FALSE
kmjkholdlnjejgopaa	FALSE
lgcbbmanaefebjjfaa	FALSE
lgcdmmlihckhmkkmaa	FALSE
majmdiaobhdifbcjaa	FALSE
makmgepcfcdhpolcaa	FALSE
mlgpnopehmdlcgncaa	FALSE
mlhbeekobddfpohnaa	FALSE
ngeamephpnlehdkdaa	FALSE
ngeghbghaopbgchpaa	FALSE
oaakgefdcodgcihcfe	FALSE
oacfhoeebejgnkgaap	FALSE
okepclhaiimgcmkpaa	FALSE
okgciahlkhibllnkaa	FALSE
pekbeogpggccnmkfaa	FALSE
pelghlljfkbfmilhaa	FALSE
aacembpdjeekhckcpab	TRUE
aacjiphdmpghneohaab	TRUE
ajmgmdmeojbpphdncga	TRUE
ajmhffnlfiffbdfhdob	TRUE
bdiignakbgfdijjkjgk	TRUE
bdmcmaomcgmbflfjbdl	TRUE
bmmldeblghhecdbliad	TRUE
bmngcgipijkbcbholhi	TRUE
cgibefifplcpafobfgb	TRUE
cgkpigpaekgpodliebc	TRUE
dcfhbedmcbjndihckgf	TRUE
dcgiecocpepgfonakcg	TRUE
dnlcbnaeopifiegpjop	TRUE
dnlmihglgnkkceohhne	TRUE
ejbmoceagppcmanclgm	TRUE
ejcnjegafohgcmnhela	TRUE
fdpedceppnpneanimgf	TRUE
fdpkjhaaippjieekiab	TRUE
fmmldodefjkjigdcfkp	TRUE
fmngnhknckelniebhbg	TRUE
ghfebccekngcjigfnap	TRUE
ghfjgggljlgclhekjgn	TRUE
hbbhobamkocdboaeiem	TRUE
hbdikcihlgoiappabfe	TRUE
hldmeadfbjjdebdlccn	TRUE
hldoiefpgojgeogkbpg	TRUE
ifhpbfoclaiebibgnbm	TRUE
ifibgihlmaahdcipdab	TRUE
iphdoejmpkoalcaanab	TRUE
iphhlngkkodpmadkbag	TRUE
jjodaikbdenfoeabnbd	TRUE
jjohfpokdnlfbgbfoia	TRUE
kecpdfphgkipcjeapoi	TRUE
kedagncfblnfnenkmlh	TRUE
koafmdnakfgbjpikebk	TRUE
kodcljfmhebhejcbofb	TRUE
limmbbbmnkhpebfjohl	TRUE
limpmdjpaogecajklck	TRUE
mcaaciekaannmmhghab	TRUE
mcbbhcodcgipnkmhcnk	TRUE
mndifcdbdjdpcgfladp	TRUE
mnehkhlajkefhblmkgh	TRUE
nihclbmbiggahmplgdm	TRUE
nihihcjknbajhmaiibc	TRUE
ocfddnobehogfhnflmc	TRUE
ocflagbmnbedkobemlf	TRUE
onahjfgfndaabhlpdmj	TRUE
onaiaidpmklegnieebm	TRUE
phcnmaokoaegeebmgdd	TRUE
phdkndecjiefojcicdk	TRUE
aaaalpcdndfdjpkgbhm	FALSE
aaaclheadbojigglnhg	FALSE
ajkjndedlkbkmcgpbaa	FALSE
ajlhdmeakfnmpjlljaa	FALSE
beblaidbhdjfdhplfaa	FALSE
beblcjhnbolhlahkcaa	FALSE
bnkeonkcibikahmafaa	FALSE
bnkfkanmjkghpjajbaa	FALSE
chmgafkehbepageieaa	FALSE
chnlgbmcgooilaefeaa	FALSE
ddddkikdoafhmdnhbaa	FALSE
dddmmhhmcmghammmpaa	FALSE
dmibmlcimbmccmbnmaa	FALSE
dmilppklaaopnngbnpp	FALSE
efojkpbgbhapmfiffaa	FALSE
efokbalkoajdgogaahh	FALSE
epchbjheobgkncpnaah	FALSE
epdfjddlpahehgmcpaa	FALSE
fkhjlcfiobdlhicchaa	FALSE
fkiefopphdfbkdpdoaa	FALSE
gdliildaeecgccnchaa	FALSE
gdlimcdljimgnijbkaa	FALSE
gnclbckiakdiokmehaa	FALSE
gndchfmpfalnpnmpoaa	FALSE
hhnkdaadelbnobpknbh	FALSE
hhnobbekgahkkfdniaa	FALSE
ickepgbkdmfcjadimaa	FALSE
ickjdikbhcolepdmmaa	FALSE
iojahaibejebnomidaa	FALSE
ioklmilplpeafnfolaa	FALSE
jjieijhnhheaigoebaa	FALSE
jjiigajhehhjbmbehaa	FALSE
kdimmdbjppckjehahaa	FALSE
kdjaamlcplfegccodij	FALSE
knfbfgadjndcodolfaa	FALSE
kngakhjpcfkcdlcleaa	FALSE
lhoilmjhjlicadamjaa	FALSE
lholhlacnkcmkdedhaa	FALSE
mchjnmcjkeehongjfaa	FALSE
mchpfdgpojcahdlbdaa	FALSE
mnbkbkdkdbjmapcifaa	FALSE
mndkbmdoiinlaibjlaa	FALSE
nhgngijchdeaaognocm	FALSE
nhhmfgccbkloidigbaa	FALSE
ocfcmoalnpdocohjjaa	FALSE
ocgpahennkmjpndakaa	FALSE
omhgcijfhcpdhcgnnaa	FALSE
omimdokgjbjjjkkjhaa	FALSE
pgphfomapoiolakijaa	FALSE
pgphnbkbcindejojhaa	FALSE
