aabogieibb	TRUE
aacalmhgbb	TRUE
alaklmfblo	TRUE
albdjfnkjg	TRUE
bfhdiebhip	TRUE
bfibhiahbi	TRUE
bpdccmdepm	TRUE
bpeglpbhpb	TRUE
cjcddmpmdf	TRUE
cjdnkdgpfl	TRUE
ddhakmlmbm	TRUE
ddhdhjhdcf	TRUE
dnbkpmaeci	TRUE
dnbnkdiooi	TRUE
ehgddfnefo	TRUE
ehibkoenfe	TRUE
fbjfjnpoha	TRUE
fbjiboggho	TRUE
fkmiblflfe	TRUE
fkooghnijn	TRUE
gfgkbhfilb	TRUE
gfhkdiinbp	TRUE
hbfimjfida	TRUE
hbfmelhkne	TRUE
hnclnagjfl	TRUE
hndioolfjj	TRUE
ihifaadhbb	TRUE
ihinllhkad	TRUE
jbhpbiionj	TRUE
jbiilobclb	TRUE
jlhgchcpln	TRUE
jligflmane	TRUE
kepcdcanbd	TRUE
kepjkjdigk	TRUE
labdnempej	TRUE
labeagbfgc	TRUE
ljpeanofmk	TRUE
lkabcnngec	TRUE
mdahnpjgoj	TRUE
mdclmdhapl	TRUE
mndhfigidp	TRUE
mndocekcof	TRUE
nhdehgmlgc	TRUE
nhejndnmci	TRUE
oampjklcbd	TRUE
oaobiilghc	TRUE
okfedoggmb	TRUE
okfppneddm	TRUE
pdpikfnahb	TRUE
pebhcdcnof	TRUE
aaadaiagfg	FALSE
aadckfhajj	FALSE
ajjfipnkaa	FALSE
ajjilgbobb	FALSE
bepocfmfaa	FALSE
bfbjnflibb	FALSE
bpgccichbb	FALSE
bpibgogebb	FALSE
cjldhicbbd	FALSE
cjmggcpdbb	FALSE
deenclopaa	FALSE
deflkojobb	FALSE
dnfjleeabb	FALSE
dngafgebaa	FALSE
eipfodilaa	FALSE
ejakihncbb	FALSE
fcgflmmpbb	FALSE
fcglflpmaa	FALSE
fncjpolmaa	FALSE
fndeodfeaa	FALSE
ggepnocobb	FALSE
ggfmpjeobb	FALSE
gpfjidniaa	FALSE
gphagbbjfd	FALSE
hjloknhnbb	FALSE
hjmcdlgmbb	FALSE
idmgbikpaa	FALSE
idmjflmgbb	FALSE
ioahlhgabb	FALSE
iocjnmmhbb	FALSE
jijcmddeaa	FALSE
jijeafljbb	FALSE
kdfcdakcbb	FALSE
kdfhkdgkbb	FALSE
kmpdcipkbb	FALSE
kmpocgaoaa	FALSE
lhjiacofbb	FALSE
lhjlconpbb	FALSE
mblgidnjaa	FALSE
mblhiokdbb	FALSE
mloeeclnaa	FALSE
mlogfcdhaa	FALSE
ngcgcoeaal	FALSE
ngfiajjfbb	FALSE
npfdefmmaa	FALSE
npfjaiceaa	FALSE
ojffhoefaa	FALSE
ojfjhecfbb	FALSE
pfbjjehhbb	FALSE
pfcejcojbb	FALSE
aaadaiagfbb	TRUE
aadgcfhajbb	TRUE
ajhfjbiangd	TRUE
ajikgmagpaj	TRUE
beonjidmnjp	TRUE
bfaignglced	TRUE
bpibghkpdhn	TRUE
bpjbkofjjmk	TRUE
cjpjmmjiokg	TRUE
cjpmgnbejll	TRUE
ddbhbfkkdgb	TRUE
ddbkcpjmolk	TRUE
dnfcjpefomp	TRUE
dnfjkmlkfae	TRUE
ehjdjienhio	TRUE
ehkoegafhfh	TRUE
fcflggdlhli	TRUE
fchailfpgjl	TRUE
fmkcanmjpjh	TRUE
fmldhbcccmj	TRUE
gflpohkdlkg	TRUE
gfmhdmfjifa	TRUE
gpcmfhknfll	TRUE
gpdghgdejdo	TRUE
hjoahokfhib	TRUE
hjokpdfohkg	TRUE
idoldogbfgf	TRUE
idpjeoblloo	TRUE
inpcekbpehd	TRUE
iobicbakjef	TRUE
jingnocjdmo	TRUE
jinngmmlnmd	TRUE
kdfedjgpjbk	TRUE
kdffgpdiika	TRUE
kmpebfhelnn	TRUE
kmpklpelgeb	TRUE
lhemeilclpp	TRUE
lhfenhoijmn	TRUE
mbfiliadgbf	TRUE
mbgeljicbcg	TRUE
mliadinliib	TRUE
mliilpmkili	TRUE
nenekldnobg	TRUE
neoogenjlba	TRUE
npekdhdomin	TRUE
npgehodjfcf	TRUE
ojnnbiemfof	TRUE
ojocnjeibac	TRUE
peppgdcbope	TRUE
pfamopibcda	TRUE
aaalpnhgkla	FALSE
aaanbjdikjd	FALSE
ajpmihcaaol	FALSE
akahobibcbb	FALSE
bdpopdimcbb	FALSE
beaejeieebb	FALSE
bodnpbjaaon	FALSE
boedadicpbb	FALSE
chcjojdkabb	FALSE
chedaeiheaa	FALSE
dapieipfpbb	FALSE
dbbmohijbkk	FALSE
dlokephhjaa	FALSE
dlpiamlkkaa	FALSE
egblfdehpaa	FALSE
egcdgggcibb	FALSE
eplalkbchaa	FALSE
eploadomlbb	FALSE
fkmmnfejkaa	FALSE
fknccaknbbb	FALSE
gedlakoocbb	FALSE
gednfolddbb	FALSE
goohkllchaa	FALSE
goojblbhjbb	FALSE
hifnjcihjaa	FALSE
higmbcfmcaa	FALSE
idedpjieebb	FALSE
idfanoacgbb	FALSE
iokdboekebb	FALSE
iombanilobb	FALSE
jjncnchhaaj	FALSE
jjocdliigbb	FALSE
kdpjjidcfbb	FALSE
keangmfelbb	FALSE
kpffeopjgaa	FALSE
kpfkdoijcaa	FALSE
ljlmngamlaa	FALSE
ljmbbmlmhcp	FALSE
mdhepelalaa	FALSE
mdijoldbmaa	FALSE
mofcdichkbb	FALSE
mofkoinedaa	FALSE
nhmfbajokaa	FALSE
nhmoafblgaa	FALSE
ocipepigmaa	FALSE
ockcijljdbb	FALSE
onepklkmpaa	FALSE
onfeegalgaa	FALSE
pgfbllihkbb	FALSE
pggfibbpndd	FALSE
aaalpnhgklbb	TRUE
aaanabidikbb	TRUE
ajolbhekjjgi	TRUE
akbfaaecdjbb	TRUE
bdnefcphkanh	TRUE
bdpljociphia	TRUE
bocnlnmceeig	TRUE
bocolafcgjoa	TRUE
cildekobdmde	TRUE
cilgeokkdklo	TRUE
dbaehlgffkie	TRUE
dbafblffpooj	TRUE
dmaodjjafmgg	TRUE
dmbhogfkeegi	TRUE
egffapddpdgn	TRUE
egffmgllokib	TRUE
epkglgbdpcfh	TRUE
epllnpebfdnp	TRUE
fkajnlbfblol	TRUE
fkbaalpndmbb	TRUE
gfnhdnecodjm	TRUE
gfobfhcphpoc	TRUE
gpdoelncenoa	TRUE
gpepmcjcppfo	TRUE
hiohfncajbgh	TRUE
hionpppgfjpm	TRUE
iclplddfkagd	TRUE
icmceeongicm	TRUE
iofcbgllgjhg	TRUE
iofcgddppola	TRUE
jjhljeabngfl	TRUE
jjjlolkojban	TRUE
keeicafmaled	TRUE
keeigejlmakn	TRUE
kphkkcgjkkof	TRUE
kpifeifghcmb	TRUE
ljkndldhdcfm	TRUE
ljmpjjgnompk	TRUE
meanpandgfdo	TRUE
mebdploijpig	TRUE
mogfjmifkcoo	TRUE
mogfpblilmma	TRUE
nighnhifpdfi	TRUE
nigknacfnjkg	TRUE
oceobacicdkg	TRUE
ocfgeakphpca	TRUE
onbnbjgnnenj	TRUE
onckjhmlmaok	TRUE
pgppbfjbihgb	TRUE
phabjlhfockh	TRUE
aaabolieaijg	FALSE
aaadokaehapb	FALSE
ajjcnmkeembb	FALSE
ajjiojbcebbg	FALSE
bebnegiaimaa	FALSE
becogcjofcbb	FALSE
bnjboiampmaa	FALSE
bnjfgcllldbb	FALSE
cimhoekjlkaa	FALSE
cinpbjnnlpbb	FALSE
dcioionfolbb	FALSE
dckeckjlplbb	FALSE
dngcapbcmgbb	FALSE
dngjklnkkhbb	FALSE
ehbmhllbhkaa	FALSE
ehdbajgeinbb	FALSE
fbbkpchhbonk	FALSE
fbbnfilncmod	FALSE
fliohocflcbb	FALSE
fljjpihnplbb	FALSE
gfeolhfheobb	FALSE
gfflggehecaa	FALSE
goomfhilieaa	FALSE
goonoemodhbb	FALSE
hjpenlakhnaa	FALSE
hjpolgikiobb	FALSE
ifppedmchiaa	FALSE
igbgnnbcecaa	FALSE
ipkdaokdjdbb	FALSE
iplfonblpibb	FALSE
jjelabcdcebb	FALSE
jjfifkkenibb	FALSE
kdffhkbjghbb	FALSE
kdhenclcphaa	FALSE
koabijalcaap	FALSE
koabkiaflabb	FALSE
liknndadnmbb	FALSE
lilkacbghnbb	FALSE
mccbcciiglbb	FALSE
mccolibligaa	FALSE
mmdmplkkjaac	FALSE
mmfjemhcnebb	FALSE
nhkfloljbebb	FALSE
nhlkfefldfbb	FALSE
ocbpecdincbb	FALSE
occkafabajbb	FALSE
omhngbjghgbb	FALSE
omhpigbijibb	FALSE
pgcipegiimaa	FALSE
pgcpokmbeebb	FALSE
aaabjkdmnnabb	TRUE
aadkgpblicjbb	TRUE
akimplggakpeh	TRUE
akjagpoinjkmk	TRUE
beldkgojmohnc	TRUE
belifcpppjiep	TRUE
bocahhcdebabc	TRUE
bockjlomplede	TRUE
ciijcdpfdanjf	TRUE
ciipcmkjhlgll	TRUE
dcojobhhcimpf	TRUE
dcoknkijahoal	TRUE
dnpnndifmpaje	TRUE
doacccecokdlh	TRUE
ehicepdhohdbg	TRUE
ehimakflaanbb	TRUE
fbnaddnbebckl	TRUE
fbnnakjhmlgld	TRUE
flokoagfooloa	TRUE
floniomkcedph	TRUE
gfmcpkcncjeca	TRUE
gfmgkmpbhdlnf	TRUE
gpfakckpnkmbp	TRUE
gpgomkdgjiebj	TRUE
hjnplaobmgohl	TRUE
hjoccgblpoiem	TRUE
idobjoifnonge	TRUE
idogfngmneind	TRUE
imngcomenmhoo	TRUE
imnkdhfeknceg	TRUE
jgfafaklplflh	TRUE
jgfppaflcoimj	TRUE
kblgholggkolh	TRUE
kbmbblfbfddaa	TRUE
klolcacnfpakb	TRUE
klpjgpkcabbaa	TRUE
lhdkdoeijiaga	TRUE
lhdnacghnmjij	TRUE
mbbgopeoahmaa	TRUE
mbdailanlagmj	TRUE
mnbfihiepahio	TRUE
mnceilfanfkhm	TRUE
njdbkkpmaijfp	TRUE
njembgdooaldb	TRUE
odhiplanmgcna	TRUE
odipdhidlhdoa	TRUE
omhdngbfmgjfb	TRUE
omhiefjenbagc	TRUE
pgjjcbfpkgfpd	TRUE
pgjmkgoahbdbm	TRUE
aaabkkdmnnakg	FALSE
aadpbmicjlmde	FALSE
akiapennkkpaa	FALSE
akjndkhfmgiaa	FALSE
beelnbieneoaa	FALSE
beemiabnonlbb	FALSE
bnkkkmookjibb	FALSE
bnlgclmjeaapf	FALSE
cimioodidblaa	FALSE
cipbmcmjfgnaa	FALSE
ddcgfmbmeknbb	FALSE
ddecbpgibgobb	FALSE
dnfpimhcnomaa	FALSE
dngiccmdochaa	FALSE
ehoiifpmdmobb	FALSE
eiagibaglanaa	FALSE
fblghneegbibb	FALSE
fbobempbjaebb	FALSE
fllhecibnfbaa	FALSE
flojbdjdmlgbb	FALSE
gfjgcbmficjaa	FALSE
gfjieeibkfpbb	FALSE
gphpkjmbenobb	FALSE
gpjhbmmpcpjaa	FALSE
hkebnanmgcnbb	FALSE
hkenapajpplbb	FALSE
idlmoomknimbb	FALSE
idmdaffdghaah	FALSE
inajlljhhhcbb	FALSE
inannjhkjkdbb	FALSE
jgjnaphmincbb	FALSE
jgkdbledibhaa	FALSE
kbkdokdcmgjaa	FALSE
kbknefibamhaa	FALSE
klejlnphkaebb	FALSE
klfcjaifnjpaa	FALSE
lgenoifdgklbb	FALSE
lgfkonemdpnaa	FALSE
mbhecgdlakdaa	FALSE
mbiaolmccdobb	FALSE
mnfbnfjlnpgaa	FALSE
mnfhafnlnfibb	FALSE
nhmlnhehkpjbb	FALSE
nhngcmenlegaa	FALSE
odifegkkmijbb	FALSE
odkeofefkjbaa	FALSE
omolnpiiodeaa	FALSE
ompblakmbnabb	FALSE
pfljcjfdgmbaa	FALSE
pfnnfdamokjaa	FALSE
aaammgoggimgbb	TRUE
aablgaceeggibb	TRUE
ajmaeehnehgkai	TRUE
ajmfjaldngckgg	TRUE
beabbmnelnlfaa	TRUE
beadlpmceibkdl	TRUE
boacdagkjmdnib	TRUE
bobcdbpkimmkka	TRUE
cjakoddoibbbaa	TRUE
cjbgjejodagllc	TRUE
dcpngmobindacm	TRUE
ddahdaiegpddem	TRUE
dmflonnialdkla	TRUE
dmfminaikilenm	TRUE
egfbpdbnmalanp	TRUE
eghafcbgoaafbb	TRUE
faemafjleccahj	TRUE
faemmmlnefdcoe	TRUE
fjpphejpmildbo	TRUE
fkbolajmfdgkdj	TRUE
geoffpobankamn	TRUE
geopbokcihjicb	TRUE
haghacmlcklild	TRUE
hagpghfihlcloh	TRUE
hlmofofclogfll	TRUE
hlnhbgdldcoehe	TRUE
ifkfmhkgmiblgn	TRUE
ifkkmkodlibhbd	TRUE
ionpcllmmnmfgd	TRUE
ioonjabinfomdk	TRUE
jjlfnbbdllphaa	TRUE
jjlkiaebclehih	TRUE
kdfoejfbnfjnga	TRUE
kdgbbfpncbhjaa	TRUE
knlklmdlfgbnno	TRUE
knmbhacmdjjhfm	TRUE
lipagkfafhglbp	TRUE
lipamphjjolgnb	TRUE
mcpkjgiahmcpmo	TRUE
mdbobnncdfgldp	TRUE
mojmmmbkbgfado	TRUE
moklllpedbolif	TRUE
nipjcefmbacpnc	TRUE
nipjhholgiofcl	TRUE
ocmkmffanombim	TRUE
ocnboeopanbfae	TRUE
onjlpmodhnmcga	TRUE
onkdeajggjglec	TRUE
pggaemngjegido	TRUE
pgjbgjgobmdjmg	TRUE
aabfmhppibnoin	FALSE
aafdnkgkhojljf	FALSE
ajimfhdgcchgbb	FALSE
ajjbnjlcjlheaa	FALSE
bdkcfglppjkjbb	FALSE
bdkmgllboflgaa	FALSE
bnbikldeoogmbb	FALSE
bncekajbfebgbb	FALSE
cgclamnflcomaa	FALSE
cgdkmbplcbddaa	FALSE
dbadagpedadhaa	FALSE
dbbpndolidmpkd	FALSE
dlaldnjejdoaag	FALSE
dlaodjbhoboebb	FALSE
efbmkeblhdlpaa	FALSE
efbnkjombaioaa	FALSE
faacghgohoagoj	FALSE
faadfinppiolei	FALSE
fkoelhedkpdcbb	FALSE
fkojbgmjnlnlbb	FALSE
gfbkgiopdggcbb	FALSE
gfcclkidhlkfbb	FALSE
gohppfnjljikbb	FALSE
goijapohiamdbb	FALSE
hifojopikdahbb	FALSE
hiiahmpodohebb	FALSE
icglekmamkjkaa	FALSE
icgpmiflhladbb	FALSE
imomanlinapgbb	FALSE
impakmadppgoaa	FALSE
jhiegeiiodhkbb	FALSE
jhieheocfbjgbb	FALSE
kcdaipfamlanaa	FALSE
kcdhpdjmhfeebb	FALSE
kmpmncpnopohaa	FALSE
knaekihoddcdaa	FALSE
lgignedojfjkbb	FALSE
lgjankhfnjgkaa	FALSE
mccjpfdebimfaa	FALSE
mccpbanhfbbjbg	FALSE
mmjehfgcgkgkbb	FALSE
mmjjakjfgdfebb	FALSE
ngogoejhhggabb	FALSE
ngpkopnodaoobb	FALSE
oaikpoipfdmmbb	FALSE
oailonhcflhlaa	FALSE
ollgbohkgcjdbb	FALSE
olmimehjglelbb	FALSE
pggehihnhfjcbb	FALSE
pggjfljblabdbb	FALSE
aabemhppibmoibb	TRUE
aafndnkgkhojlbb	TRUE
ajgjgfcnclbofgc	TRUE
ajhpanepnlfmjdl	TRUE
bdmohpigplpgpha	TRUE
bdnjjekpcjiaihj	TRUE
bnijjedadpaadbb	TRUE
bnimolkpjpnngil	TRUE
chpbpabklicobco	TRUE
chpclaobemldlip	TRUE
dbgncbcaplkfmil	TRUE
dbgplfmkbncoahp	TRUE
dkjfjlnnnenambe	TRUE
dkkclihnadafkce	TRUE
efckldepfgdcpci	TRUE
efclfinkhbngmie	TRUE
faaghbjhnbkfibb	TRUE
faahmcbbnbkobdm	TRUE
flhdcbnipgehoic	TRUE
flibhlfecbelepf	TRUE
gfcbidpdpmbefdh	TRUE
gfdanjdbjeonioo	TRUE
gogdhhgagfnhcmb	TRUE
gogibeflgddicia	TRUE
hhmkljfdjmolcao	TRUE
hhmnfbmlmbddnbc	TRUE
idalejanceclpcp	TRUE
idbjegecmnihhhk	TRUE
impcmmmdeocldkj	TRUE
inafghhhcfjhigo	TRUE
jiabhpdmafgboop	TRUE
jiagemjkeofknhi	TRUE
kciifoinnmnagbi	TRUE
kcjajlmbfnnlceb	TRUE
kmgmajlejhpnami	TRUE
kmgmianobmokhnm	TRUE
liacponmeeekkbf	TRUE
liaddcfolfbegdo	TRUE
mbjgadpmejfjklm	TRUE
mbjgpgklefbnaji	TRUE
mlogjikageabfob	TRUE
mmadichlloalfma	TRUE
nghmgnjkkkpeepd	TRUE
ngiajlhagnmnkmd	TRUE
oappabpognlelmm	TRUE
obanaogfnoabpcc	TRUE
ombiikbbpmapkaa	TRUE
ombkijhknfbjajf	TRUE
pfjinnopjajlinn	TRUE
pfjjkimflbgipkh	TRUE
aaaadcecclpcace	FALSE
aacbjekjoplmhdh	FALSE
ajikjglaomkahaa	FALSE
ajjibbablfcgoka	FALSE
beanmelojelecbb	FALSE
bebfmkflpcmelbb	FALSE
bmnlpfiffckgbbh	FALSE
bmokdhjicpaaohm	FALSE
cgnoikpncohhcbb	FALSE
cgophhcjiojdpbb	FALSE
dbkhoghigpfjbaa	FALSE
dbkmgemafilgkbb	FALSE
dmfpkbangijgaap	FALSE
dmgeaeodnmhlgaa	FALSE
ehcgdbadfhpmobb	FALSE
ehcoadhnnjncnaa	FALSE
fclkfpophdpafaa	FALSE
fcmjgcaghleamaa	FALSE
fnbeckhbmddgnaa	FALSE
fnbipblbkbmaebb	FALSE
ghcgapmkdjliobb	FALSE
ghckmflggkpgnbb	FALSE
hbckjoginkikfbb	FALSE
hbcofoanhpbcdaa	FALSE
hlcebgcnndnhibb	FALSE
hldnhalnldhioaa	FALSE
ifiaikiliblnjaa	FALSE
ifijomidohjmobb	FALSE
ipkmbhpibhgmmbb	FALSE
ipmalcoeinmipaa	FALSE
jjpcljajfiidfaa	FALSE
jjpgakgaopfpoaa	FALSE
keloflbgkfnhcaa	FALSE
kelpdpbmfifbebb	FALSE
kogdbhflchgggbb	FALSE
kohagiagbfpngbb	FALSE
linblolcgphdibb	FALSE
liomdhgmjmnldaa	FALSE
mdpfeikmabghabb	FALSE
meaammdffcomkdj	FALSE
mnibabpmdfcheaa	FALSE
mnigpopodmjdcaa	FALSE
nhdpcpaojebicaa	FALSE
nheemioimfeekaa	FALSE
oapdfleiibgmmbb	FALSE
oaplckhleeknlbb	FALSE
olhionjlheboaaa	FALSE
oljlpnjbmakjpbb	FALSE
pgcnnglkabianbb	FALSE
pgdgoiglfagejaa	FALSE
aaaiajkcincmigbb	TRUE
aaalooianhjlecbb	TRUE
akkbaboifeipgmnj	TRUE
akkedinmbfbapooc	TRUE
bdmccgapjhnfkhnh	TRUE
bdmphgnkkljlmncc	TRUE
bodimfkmeadfbmfc	TRUE
bodpenneffdolglb	TRUE
cidnfembbhbhjhaa	TRUE
cigeohkhfiacnhif	TRUE
dcefdeebmgmblopg	TRUE
dceimifopbojcefb	TRUE
dmmlceeihojjpioi	TRUE
dmmpailoljhmkmci	TRUE
ehgblllcccopblfj	TRUE
ehglkpkejhfngppi	TRUE
fbphjicfobjganen	TRUE
fbpibpdeoemibfbe	TRUE
fmgndjkfgdchhipe	TRUE
fmigneefajjlknnf	TRUE
gfnhmgblalgakgih	TRUE
gfnihjimngobceog	TRUE
gpkflenodmobnblm	TRUE
gpldjibeafeaboln	TRUE
hkbfkhljnhokgjei	TRUE
hkbgokelhbhcgfag	TRUE
iecfbebdjbdjlajh	TRUE
iednhdmpkjkdomnh	TRUE
iojkgfmnaofpkpib	TRUE
iomcaipkccbogcdp	TRUE
jjfkdokijipnnjka	TRUE
jjignlabficinbog	TRUE
kdieflagcemmfoic	TRUE
kdmnohbfdldbfmak	TRUE
kncophioleokcgej	TRUE
knehlogccegiinif	TRUE
lgpoaoclbkofanol	TRUE
lhaailbncniolpbb	TRUE
mbeddanlbeimcjmf	TRUE
mbfgcmlleaepeopd	TRUE
mmcjkajefomcmcfg	TRUE
mmckdkkpopbhgfbg	TRUE
nfnklekhamkjbleo	TRUE
nfoikfalkndkljjd	TRUE
oangpfajbimjcpmh	TRUE
oanjfohdcelpelad	TRUE
okkjncpgoodlcnhd	TRUE
okmmpjahnbgfdbja	TRUE
penfclckfmfonlco	TRUE
peoemmifjciponnb	TRUE
aaaiajkcincmigoo	FALSE
aaalianhjlecbcfg	FALSE
akgdppoclbgpmhbb	FALSE
akgmfnpdllhpdoaa	FALSE
begeehjcnfagmmbb	FALSE
beghjnafhldaghaa	FALSE
bocpioaccpcobpaa	FALSE
bodgjknglkcmodbb	FALSE
ciifkenkkkmakbbp	FALSE
ciiphllgedhdigbb	FALSE
dchjpbmhejfkgpbb	FALSE
dckkemjgmiepbmaa	FALSE
dmcmagecajepojbb	FALSE
dmcnnfbcdhfhdlbb	FALSE
egpcchoalolkicbb	FALSE
egpegollnbnahlaa	FALSE
fbnbfjcacgepafaa	FALSE
fbnlpnmbpopakkbb	FALSE
flmkohmnjlgeafbb	FALSE
flnghcafkfpgbmbb	FALSE
ggfpgegpcmneenbb	FALSE
gghimflilffbmpaa	FALSE
gplfgoofgdheblaa	FALSE
gplmfhmhpljbjbbf	FALSE
hjhplogfihelclbb	FALSE
hjibcppolaecelaa	FALSE
iehnecobkoecpabb	FALSE
ieiclfaipboaffaa	FALSE
ipcfkkgfcbholdbb	FALSE
ipdmkiodpmhchfbb	FALSE
jiknbbbjepkhioam	FALSE
jilbdeogjagkahaa	FALSE
kemoakfgcgkojhbb	FALSE
kendagbkgafcncbb	FALSE
kohlapdchhamekaa	FALSE
koibekmmklbjpkaa	FALSE
lhchcfiffifjfgaa	FALSE
lhdnkicbmbnklaaa	FALSE
mamfkjkfopjklabb	FALSE
maolnlpofgjfdiaa	FALSE
mlilkncbhmhbjeaa	FALSE
mljnddanlbeimcbb	FALSE
ngfhlipkfpjagnbb	FALSE
ngfpnhdnpganljaa	FALSE
oaialkndkljjdjaa	FALSE
oakochjabkkokkbb	FALSE
okcmbpobilimilbb	FALSE
okdhldklheleloaa	FALSE
pfbpafdabgdlolbb	FALSE
pfcfkdlolmjpddaa	FALSE
aaahljimeaokaibbl	TRUE
aabebmmghackkojbb	TRUE
ajdaaokgldfaffbbj	TRUE
ajdbopclgelphdgdc	TRUE
bcgdnfnljaljjkjgf	TRUE
bcgfknchignmcghih	TRUE
bmhbcdbhjbdfcnkgg	TRUE
bmhbcgpckijlpimkh	TRUE
cgahimkmcplkalclg	TRUE
cgapofpdhmmhddlij	TRUE
daiipaopenbmdljbh	TRUE
dajhdbdejenmcloob	TRUE
dkpejcapbpcfbfahd	TRUE
dkpgempkiiijpapkd	TRUE
edimhfedlachhamda	TRUE
edjeigkeaifalofjk	TRUE
enidgbkngpkgeifga	TRUE
enihpmajnnaaighbb	TRUE
ficgminlbdbaehhji	TRUE
fidiccplehgkogdbi	TRUE
gcngodbbalfbgdlaa	TRUE
gcnjbmfefajjdcamn	TRUE
godibclmcjfkolhgh	TRUE
gofamlkjpionfmmpb	TRUE
hhmjcgedebeipncef	TRUE
hhmjdplifglbknigg	TRUE
ibpdnplhlidkpnnoj	TRUE
icbcgckflkhccbmmc	TRUE
illpohbhablpcpojc	TRUE
ilmpbniajagmakbnh	TRUE
jfdploigjneoeeohn	TRUE
jfefabofmieheehhc	TRUE
jopimkkdmkjhggapb	TRUE
jpacefdpgnoojmkfp	TRUE
kjlbfcmccagoiflnf	TRUE
kjlcmekoelbooocmi	TRUE
leipadmkmnmiljcoa	TRUE
lejadmkmmgonfcked	TRUE
lopecbhioekldmfog	TRUE
loplddgbepcfonban	TRUE
mkiokkempmdpmnock	TRUE
mkipmcahcodhonaek	TRUE
nfaheaiealkkjginn	TRUE
nfbamoofeahegfopj	TRUE
oaecafelnekodifph	TRUE
oaepjmcnobpejblee	TRUE
okfokkpcdhgjlecil	TRUE
okgaamdnbgjhbhjbb	TRUE
pfjjgagfhmeadedjg	TRUE
pfkacjmcnplfoicoi	TRUE
aaackhlimpnkbdkja	FALSE
aabjaomfhanheoaca	FALSE
akmedaegpcckdebaa	FALSE
aknfenndcieookhbb	FALSE
bfbgnfdjgpgmgljaa	FALSE
bfbhljpleciambmbb	FALSE
bopbonndhecipdcaa	FALSE
bophakdnafiockkaa	FALSE
cinegeedihoeffgbb	FALSE
cjaihlhjpakgfdjbb	FALSE
ddckkfiljjdjmcobb	FALSE
dddkknlkdgaooddbb	FALSE
dmpcpikogjalkmfaa	FALSE
dmpnkcmmgblgipjaa	FALSE
ehhbiajjjmjjhcmbb	FALSE
ehhjfhhchgladpfaa	FALSE
fafpjmhoablgifdbb	FALSE
fagbaggdkmabdfdaa	FALSE
fkekcmeeobfeaodaa	FALSE
fkekkamojnhipdfbb	FALSE
gfladgpoominofiaa	FALSE
gflkonlcdafphgcbb	FALSE
haafdncnbdofdiigh	FALSE
habcogfnjggcldpbb	FALSE
hkemjikgdapbikibb	FALSE
hkgahllifhddmeeaa	FALSE
ieaabkmihfjodjbln	FALSE
iebbiajmfilcbfpah	FALSE
iojckenmalpgmikaa	FALSE
iolnlkgkjedjbodbb	FALSE
jinbiaemldgmcocaa	FALSE
jinlmimnhhlkhembb	FALSE
kckgkifcohdokapaa	FALSE
kckkbiljdcejbgnaa	FALSE
kmgaicigldolnecbb	FALSE
kmjjcmkfmhinknoaa	FALSE
liakebekmdmkofgaa	FALSE
lianmbmoejegoflbb	FALSE
mcjfcjffafjnfocbb	FALSE
mckmbkbcbglgiifaa	FALSE
mnfpmgnjiofgpghbb	FALSE
mnggafngeebokkdbb	FALSE
nglbpohbiejkjmmbb	FALSE
nglmdednkgbdaajdg	FALSE
oaioannhcoadeafaa	FALSE
oalleflepgiicafbb	FALSE
ojogecfjlbdeekpbb	FALSE
ojopkdcdpfleipjbb	FALSE
pedjmlindkmoabfbb	FALSE
peebcejnlgjddlibb	FALSE
aaackhlimpnkbckjbb	TRUE
aabaoaomfhanheoabb	TRUE
akmfenffnehdodaljp	TRUE
aknfamemjnbdkiiekj	TRUE
bffhhobmgbegncoebi	TRUE
bfghoppikapmlkcffi	TRUE
bpalaabecgehbfkkbb	TRUE
bpclmhanglanhfhalf	TRUE
cinahgbohmkjkmkkod	TRUE
cinckfbmcdnljdedod	TRUE
dcbmnlldcpdhlkpdci	TRUE
dcdfofekkghnballdi	TRUE
dnhnlilmhocopkmfoo	TRUE
dnjdnecjcajacoognp	TRUE
egphfdmliikgaamobb	TRUE
ehamocjjoncdmcfbmj	TRUE
fadmbldefccbhenehi	TRUE
faecdninnbhjcogacg	TRUE
fkiloihlnlcenkgkmg	TRUE
fkjcpmmacfelfegihg	TRUE
gflpclkanfmakgfkde	TRUE
gfmfahgkacdggahpan	TRUE
haagnepoapdkoipkbb	TRUE
haalccfojkoglkicbb	TRUE
hldlpghnkodncilhje	TRUE
hlepknkgnjhhikdgmd	TRUE
iedgeekehbiphcnhgl	TRUE
iedjoahjbgjlkmidbl	TRUE
iolpdmcfgejppnllgd	TRUE
iondcigefeggckdfei	TRUE
jijihpgdkfhmmnnine	TRUE
jikmcpjfocmiagbjpf	TRUE
kdkpfnchlknpchegnj	TRUE
kdlcloineenhnhlogn	TRUE
kmnofcnlhmcclcegmp	TRUE
kmoehaoldadphkfkjm	TRUE
lhmcdoceomjgmdfpcp	TRUE
lhmfhgblanajnglmoo	TRUE
mbobdanolningihinh	TRUE
mboiaobbogflblcmaa	TRUE
mmokbjcjoegolgchge	TRUE
mnalomkehffddlndpn	TRUE
ngnnfhmnllnghafaog	TRUE
ngpndfoigenlnkgfde	TRUE
oahaebkjhfhfnamjci	TRUE
oahapoabaaalfldgbb	TRUE
okgcigjnedngobbiaa	TRUE
okgeapfgjfibdkicfl	TRUE
pemajigmpilgmcmpjg	TRUE
pemfghcfddbpjojngd	TRUE
aaapnkbjkdmfjcngol	FALSE
aabjlfbgjoafhhbnga	FALSE
akahaicbbbdkhdllmk	FALSE
akbdoapleemjdhimbb	FALSE
bfleaonmdedjaojkbb	FALSE
bflmieildbpjcajaak	FALSE
bpfpegjhcpgmmmjeaa	FALSE
bpgaadglofjhpopafc	FALSE
cjaacpbkgnblijaklf	FALSE
cjbekbdjdicpbkpjbb	FALSE
dcbbjjjohhddjncbhj	FALSE
dcbclhjnlpocbhgjaa	FALSE
dmknapoblollooljbb	FALSE
dmkogneiplfcknffaa	FALSE
efnpamenljlkemjcbb	FALSE
efphonilmfchfahpbb	FALSE
fbeljlkgpnolbfaoaa	FALSE
fbhfgnkbkadccmbbno	FALSE
fljllkagmlaenbjjbb	FALSE
fljoielcjljniapeaa	FALSE
gfnaipeccmilcodlbb	FALSE
gfojdjofahalidkgaa	FALSE
halmeelopllkmcjpbb	FALSE
hamcppabnkepbodnbb	FALSE
hjkpboddpmfepdjfaa	FALSE
hjlnjfdamlcnbgcibb	FALSE
idkmponpdnkopnjibb	FALSE
idkoocfaafapikdldk	FALSE
inlecidahljkmanoaa	FALSE
inlnmmighmplmgahbb	FALSE
jhhgjjidkjmplgejaa	FALSE
jhjkmoedfceoehpjbb	FALSE
kddkffceoimajbkdaa	FALSE
kddnhghfjpkkgdgiaa	FALSE
knlgbolhhcnmmfahbb	FALSE
knlhbkbndfclngjnaa	FALSE
lifchohdiaphcfepaa	FALSE
lihacgbhlepdccpobb	FALSE
mbmpehcniofegipcbb	FALSE
mbnpiilgfonojalmbb	FALSE
mkloipbecpfeciopaa	FALSE
mklppcahmmeknfppaa	FALSE
nfemgmhppegmebegbb	FALSE
nfgagepmhhkmgbloaa	FALSE
nphpkgbghfcmheaoaa	FALSE
npmlboajpkdaichmaa	FALSE
okhdnjlanklpgkpcbb	FALSE
okhmelmliimpmjlfaa	FALSE
pfmmgoklkibhgiaiaa	FALSE
pfmpelafjmlfhmmcbb	FALSE
aabklnpdfpholmhedbb	TRUE
aacgecmnbommmcdkjbb	TRUE
akemhbjffgomfmlapme	TRUE
akfampglgdbgbfmcbcn	TRUE
bfaljhfomkfllfdoclh	TRUE
bfapgofdjgghdhemedl	TRUE
bpdgmlnejdilijpboho	TRUE
bpdniijdgffjpoihecc	TRUE
cjodkljkecijjbkpgpd	TRUE
cjoogahlmcjejlcgfdf	TRUE
deiochfedcpmbkcmonj	TRUE
dejflcefdhhiohnaabb	TRUE
dolopgjfgjmfncikdlg	TRUE
donbdekbablllafnflh	TRUE
ejdfpdcnfjcginhhnop	TRUE
ejfloomopdfahfihcpp	TRUE
feddnpnmoebfpdjoadj	TRUE
fegjepmdhbmldjijnog	TRUE
foleklnbcebnjneallg	TRUE
follelooihifhjjiond	TRUE
gjpgfdblpiedicoilmi	TRUE
gkalokcnibgbhgknenn	TRUE
hemipgffgnkpfokcocm	TRUE
hemmphehmnepjeheijm	TRUE
hpimcgpdgkelpiipflk	TRUE
hpjefaklnkokpifinno	TRUE
ikfinbeepfjcdmfcdep	TRUE
ikgnicjpoicjpcgfifp	TRUE
jdjlimddobliclecejl	TRUE
jdlclheimoiknajdjnc	TRUE
jnlfehglkpopmomnocm	TRUE
jnlibliiaennkbnjlgi	TRUE
khbeoojdpiejcigklbp	TRUE
khbipkjnjmjcbnjfdfi	TRUE
lbjglnidhodkbckbppk	TRUE
lbjgpdpmaajccleppbb	TRUE
llnbdkncddnlolpmekb	TRUE
llnnjfkgcbbkikpgaak	TRUE
mghbbcnginapcejjjaa	TRUE
mghifaepghidpepihkl	TRUE
mpdgpiinjffgnfadeop	TRUE
mpfaenmjfmdmllimjmf	TRUE
nigfbkjngbcmemihmed	TRUE
niglneclpmkpcppglfc	TRUE
ocebmmkfknbhhfeihhl	TRUE
ocefhkbpjcilhdjmhba	TRUE
omdepdbcdbbmagfnjaa	TRUE
omgfmapjegcaddllmci	TRUE
pfkliccdhaoabkkipei	TRUE
pfklliblfpbojihhknn	TRUE
aaahjjkkgldngcnekpk	FALSE
aachienkcainoacofae	FALSE
ajifpadfihafkbdbmbb	FALSE
ajkinmjlealgdhoofaa	FALSE
bembpljglolngmdooaa	FALSE
bemfdmmfnkhidhlclbb	FALSE
boglhkdkkjmmgopokbb	FALSE
boibhdcldnkjahhhaaf	FALSE
cijfmenkbnacaamnpgc	FALSE
cijondjhadjgcnahfaa	FALSE
ddfiaofbaebmejjplbb	FALSE
ddggdcehmndjodmgpbb	FALSE
doiofcdkelfjmhhagbb	FALSE
dojighplbpeijcjkmaa	FALSE
eihchiaiaafamifloni	FALSE
eiibkichihpbpgnegbb	FALSE
fcdfakmdeilmljalobb	FALSE
fcdgafhcmdidmhpblaa	FALSE
fndjfkoojeapoecooaa	FALSE
fnfbdgkfjaijmbhioaa	FALSE
ghcmbllgilfgpjcedbb	FALSE
ghdemhmjffbcmhklbbb	FALSE
hbfdhkajmjabncngcbb	FALSE
hbfdmkibaknlgejgjbb	FALSE
hmafipkgplgbjdljcbb	FALSE
hmampaaffajkmmanlfb	FALSE
igcoddgcfcoincnnibb	FALSE
igdekmppdnelliajabb	FALSE
iphakenjfcdfpcemdbb	FALSE
ipjccjcbpbnbapbpmbb	FALSE
jkajncdiepoeajhgpbb	FALSE
jkaklfgpkblioffblbb	FALSE
kdocnoecphkigjhbkaa	FALSE
kdpdneknmgfonplhhbb	FALSE
kndegfgpmpkaaccbffn	FALSE
kndofibkagohcigebbm	FALSE
lifjamdklelocakgfaa	FALSE
liflkhjmojmmabokpbb	FALSE
mblodcojlalejailgbb	FALSE
mbmbnlbpdekgfjaglaa	FALSE
mnbleobmhcehngfceaa	FALSE
mnelmohdinficdfikbb	FALSE
ngkamceijpjhjemoebb	FALSE
ngkkmbmnjllmgmciaao	FALSE
oaekoekjccpbgjhkabb	FALSE
oaempdflbpnkgohhkaa	FALSE
oklkmhlipnjmpeodfbb	FALSE
okmdjlfbncdikebedaa	FALSE
pfdbnjncjpekaokpkaa	FALSE
pfdjdlfbhkholbhdfbb	FALSE
