aaaaepjhik	TRUE
aaajidaolg	TRUE
ajjilkcgcn	TRUE
ajkdaagpej	TRUE
bdmfbgngpe	TRUE
bdnacbnjbp	TRUE
bnhladdieh	TRUE
bnjhemcckg	TRUE
cgimcnfkml	TRUE
cgjajkcecj	TRUE
dajfgcecgk	TRUE
daledfgglc	TRUE
dkcoohneaf	TRUE
dkdecimnnc	TRUE
eealhllabm	TRUE
eeamiaejig	TRUE
eodlgcboaa	TRUE
eoebcdbpii	TRUE
fifbnkgcdf	TRUE
figdnkhmji	TRUE
gbdaajifme	TRUE
gbdhknffmb	TRUE
golboonekk	TRUE
golenobabf	TRUE
hjgckjdldp	TRUE
hjhbpofiji	TRUE
idhhekhpkf	TRUE
idimjndamh	TRUE
iokcpbfgpi	TRUE
iolkohcfdo	TRUE
jipnnhgcml	TRUE
jjcjbcphbb	TRUE
kdnbppadie	TRUE
kdngclhjgc	TRUE
knjeljcohn	TRUE
knjfckccai	TRUE
lgokngfogj	TRUE
lgpbigagkf	TRUE
mbecpbanpj	TRUE
mbefaehknn	TRUE
mlllfpnikp	TRUE
mlnapohmbe	TRUE
nhgpibmdbh	TRUE
nhicahbnfl	TRUE
oblndabidi	TRUE
obloneelaf	TRUE
olnoekndgh	TRUE
oloioegiai	TRUE
pgfiekhpdb	TRUE
pgfldlodpg	TRUE
aaaaepabcd	FALSE
aaajhiabab	FALSE
ajfmapabcd	FALSE
ajigfkabcd	FALSE
bdkpepabcd	FALSE
bdllmgabab	FALSE
bnnhjlabcd	FALSE
bnnpijabab	FALSE
cgpijababb	FALSE
chbieoabab	FALSE
dagbhbabab	FALSE
dagfcnabab	FALSE
djagdlabab	FALSE
djbmpcabcd	FALSE
edmemhabcd	FALSE
edmfmmabcd	FALSE
eopdlhabab	FALSE
eophamabcd	FALSE
fhcdefabcd	FALSE
fhddgpabcd	FALSE
gbiecjabab	FALSE
gbmbfjabab	FALSE
gnpidjabab	FALSE
gnpjbhabab	FALSE
hinkeeabab	FALSE
hinnjiabab	FALSE
idfhakabab	FALSE
idgefeabab	FALSE
iogbjcabab	FALSE
iogmlbabcd	FALSE
jjkhafabab	FALSE
jjkllpabcd	FALSE
kcglnjabab	FALSE
kchplpabab	FALSE
knmcdgabab	FALSE
knneagabab	FALSE
lidapaabcd	FALSE
lieaipabab	FALSE
manmkababh	FALSE
manplhabab	FALSE
mmodnpabcd	FALSE
mmplchabab	FALSE
nidldhabab	FALSE
nififlabab	FALSE
ocdeflabab	FALSE
ocfcjjabcd	FALSE
omhmoaabab	FALSE
omlajhabcd	FALSE
pgfldababd	FALSE
pgghcmabab	FALSE
aaaaepjhiki	TRUE
aaajdaolggd	TRUE
ajihlhmegfb	TRUE
ajjdhdagohj	TRUE
beaomhkcepf	TRUE
beciffjlmka	TRUE
bnkobdphoda	TRUE
bnlenmhiepf	TRUE
ciclkillbnh	TRUE
cidkmklhbfa	TRUE
dalgbbefjha	TRUE
dalnehineon	TRUE
djgpcdmpkef	TRUE
djhmfgkeeni	TRUE
edhdomhpnke	TRUE
edikniomole	TRUE
epakahpcbhn	TRUE
epbfhjlkmdg	TRUE
fhopibdifci	TRUE
fhplecgeead	TRUE
galfdlifgco	TRUE
galljbjkkhe	TRUE
goapmiljkoa	TRUE
gobimdhohjo	TRUE
hiphapelkdd	TRUE
hjaaankmmka	TRUE
idadbgojicn	TRUE
idbdfkmnojb	TRUE
iodbminagpp	TRUE
iofnimljbdg	TRUE
jinhbmhdkmo	TRUE
jjajmgbmjel	TRUE
kdcgnkglbdc	TRUE
kdchckgdndb	TRUE
knkeipadepd	TRUE
knkijimlmpm	TRUE
lhjmnlhjahj	TRUE
lhkajakbcpk	TRUE
mbiedkofmpb	TRUE
mbihogmkneb	TRUE
mmjmphildmf	TRUE
mmkadmfenph	TRUE
nhaemomljin	TRUE
nhaohlfogaa	TRUE
obopghafmlb	TRUE
obpbibpjdnk	TRUE
ombehgfikcg	TRUE
ombfjheacmd	TRUE
pgcnjafjnlj	TRUE
pgdfklecogm	TRUE
aaaafegabcd	FALSE
aaabnhabcdd	FALSE
akfcoifabab	FALSE
akflianabab	FALSE
bejomclabab	FALSE
bejpieoabab	FALSE
bpadglkabab	FALSE
bpamimnabcd	FALSE
cigbmdjabcd	FALSE
cihcnjiabab	FALSE
dbebpkeabab	FALSE
dbgmcnnabab	FALSE
dlojbppabcd	FALSE
dlojnlfabab	FALSE
eedjeipabcd	FALSE
eedolglabcd	FALSE
epobbgpabcd	FALSE
eppdjgkabab	FALSE
fkebljmabab	FALSE
fkeipjnabcd	FALSE
gffdbgfabcd	FALSE
gfffmbkabcd	FALSE
golglceabab	FALSE
gopkjeababb	FALSE
hjpfaggabab	FALSE
hkafipoabab	FALSE
idnnehlabab	FALSE
idooamiabcd	FALSE
iolajggabab	FALSE
iolcgegabcd	FALSE
jjccojfabcd	FALSE
jjdkomkabcd	FALSE
kcpdeofabcd	FALSE
kcpoodlabcd	FALSE
kmlalihabab	FALSE
kmlhfidabab	FALSE
lgpaoiiabab	FALSE
lhajbnbabcd	FALSE
mbiojcfabcd	FALSE
mbjmijfabab	FALSE
mlkmknhabcd	FALSE
mllemdcabcd	FALSE
ngfmigkabab	FALSE
nghccmjabab	FALSE
oammpfgabab	FALSE
oanphinabab	FALSE
okojmceabab	FALSE
okolelkabcd	FALSE
pficpeaabcd	FALSE
pfiicbabcdp	FALSE
aaaafegpnhad	TRUE
aaabpdheoekf	TRUE
akfinbbclfid	TRUE
akfmdcdfehid	TRUE
benpomamcigg	TRUE
beofehelcaic	TRUE
boggihalgbnl	TRUE
bogpeigplfco	TRUE
cimjiiklileh	TRUE
cimjndnahagd	TRUE
dbpbcjhigpki	TRUE
dbpclofjlphj	TRUE
dlaflpcpbmnm	TRUE
dlagalikgego	TRUE
egaoigimedke	TRUE
egbnllmbnblo	TRUE
eplcglhajknb	TRUE
epmemaoaccfm	TRUE
fkfkiddobnab	TRUE
fkfmnkbfacjg	TRUE
gdofehglnpbd	TRUE
geaimmcifpgh	TRUE
gpbbahmkliha	TRUE
gpbnfididbkh	TRUE
hjobcjnemkbg	TRUE
hjoeannbdpol	TRUE
ieflkjnilcpa	TRUE
iegjgfnmhhdl	TRUE
iomkdomfbfkk	TRUE
ioncahffageh	TRUE
jihgjjmjhdhb	TRUE
jijldofdemkc	TRUE
kdckahopplee	TRUE
kddacicmjfaj	TRUE
knalmjnmliac	TRUE
knbaegllnbfn	TRUE
lhjlnhiinbal	TRUE
lhkgnlalammn	TRUE
mbeaghbcfegj	TRUE
mbebgfggpcaf	TRUE
mlgfaoooddkb	TRUE
mlhhfefohlbo	TRUE
nggdjfigmpbc	TRUE
ngglbfiabokh	TRUE
oahpgehpadli	TRUE
oahpmjneaobk	TRUE
okkljomgikof	TRUE
oklhnpbjfehn	TRUE
pemekanhfnmg	TRUE
pemenlgmjmin	TRUE
aaaejkalabcd	FALSE
aabdgfbpabab	FALSE
ajibaohpabab	FALSE
ajiclbaaabab	FALSE
bemoiecfabab	FALSE
bepfhbedabcd	FALSE
bnmifdokabcd	FALSE
bnmjdkdiabab	FALSE
cikdjfnpabab	FALSE
cikkigcmabab	FALSE
ddephelpabcd	FALSE
ddfllkolabcd	FALSE
dnfdpbkmabcd	FALSE
dnganibaabab	FALSE
ehnalggkabcd	FALSE
eidadmeeabab	FALSE
fcacbaejabcd	FALSE
fcbgfiofabcd	FALSE
flmdllhgabcd	FALSE
flnkamigabcd	FALSE
gghinpapabcd	FALSE
gghkbnngabab	FALSE
hcafldnjabab	FALSE
hcbbpajnabcd	FALSE
hmgkpngeabab	FALSE
hmhnmhomabcd	FALSE
igfnlpgbabab	FALSE
igibgplnabab	FALSE
ipplfhdlabab	FALSE
ippmipofabcd	FALSE
jkjdhidbabcd	FALSE
jkkcpmbjabab	FALSE
kffmnodpabab	FALSE
kffmpehjabcd	FALSE
kokhmjgbabcd	FALSE
koldpaalabcd	FALSE
ljgckihgabab	FALSE
ljgfoignabcd	FALSE
mepegekfabcd	FALSE
mepellfhabab	FALSE
mpaoehbiabab	FALSE
mpbdnjoababp	FALSE
njgopdgmabab	FALSE
njhgnmehabcd	FALSE
odllacababeb	FALSE
odngedfpabab	FALSE
onaadkdpabab	FALSE
onackadkabab	FALSE
pgemndkmabab	FALSE
pgenkaebabab	FALSE
aaaejkalbjdfg	TRUE
aabbgdkjlhmkn	TRUE
ajeimadeggjgh	TRUE
ajhbjiogknpka	TRUE
bdgkfladjadpl	TRUE
bdgnakpchmiij	TRUE
bmpobccafkecl	TRUE
bndehlncahmdh	TRUE
cififlijgeaod	TRUE
cifjhgdaldkgm	TRUE
ddflkfifjcjoi	TRUE
ddfmmimgdjejp	TRUE
dnojhknejjeae	TRUE
dnpfcdlbgikjm	TRUE
ehfjiggnokkob	TRUE
ehhddhgfffcdd	TRUE
fccpadkjfjeid	TRUE
fcdolhjlmkcdn	TRUE
fmgfonllglimk	TRUE
fmheeckodichl	TRUE
ggolpneacomgn	TRUE
ghbnnghlofkia	TRUE
hbojnjnbgndjl	TRUE
hbpibdboodbfp	TRUE
hmmolpnbpmecn	TRUE
hnbamnlieehdi	TRUE
iglehallbpgdj	TRUE
iglgpfpclemka	TRUE
ipnlgbjlnecno	TRUE
ipnpelcakeiml	TRUE
jkoaglmgaajmd	TRUE
jkomomnkakkio	TRUE
kenagakmhhlpe	TRUE
keocigamjgngj	TRUE
koofkocdddbmn	TRUE
koompkoggkeka	TRUE
ljjjnodkdgcge	TRUE
ljlbnmapheana	TRUE
mdpplpbcofekb	TRUE
mecjmagdcodbp	TRUE
moecaeibejobb	TRUE
moecckhgaeceh	TRUE
njbnekjahdaab	TRUE
njceldehkpkdo	TRUE
odgdlhkeljgij	TRUE
odgpjoofahemi	TRUE
onbmdgfjhebfd	TRUE
onbmeeolnakei	TRUE
pgokfdpdohcib	TRUE
pgonbfckmdcbd	TRUE
aaaejkalbabcd	FALSE
aabdfbpgdabab	FALSE
ajhpkedbhabcd	FALSE
ajjnlplioabcd	FALSE
beiaicamiabab	FALSE
beihbgmkgabab	FALSE
bocfeeidnabab	FALSE
bocimhpcmabcd	FALSE
ciibofmplabcd	FALSE
cikgkbjbmabab	FALSE
dcpohmcbfabab	FALSE
ddceelhjmabab	FALSE
dnjnelojabcdh	FALSE
dnkhhdniiabab	FALSE
ehghogpagabab	FALSE
ehimlhhniabcd	FALSE
fclpbdiihabab	FALSE
fcmijigpbabab	FALSE
fllfmlhemabcd	FALSE
fllpmomfhabcd	FALSE
ghlbcaohoabab	FALSE
ghnffcjakabab	FALSE
hbooeifblabcd	FALSE
hbpcelakkabcd	FALSE
hmjldnoeiabcd	FALSE
hmkjijbfnabab	FALSE
igejigljgabab	FALSE
iggjklbclabcd	FALSE
ipoficjkiabab	FALSE
ipogmglmlabcd	FALSE
jkbpohcheabcd	FALSE
jkdflgbkaabab	FALSE
keljmecnmabcd	FALSE
kemhhkkgeabcd	FALSE
koelmhplgabcd	FALSE
kogmdmbijabcd	FALSE
lkfjkgbjnabab	FALSE
lkgcpakffabcd	FALSE
memgajhjbabcd	FALSE
menldnkjhabab	FALSE
moljoedgfabab	FALSE
momflajedabcd	FALSE
nicpicmobabab	FALSE
nidopkbohabcd	FALSE
odcpgpoigabcd	FALSE
odcphggalabcd	FALSE
omklciponabcd	FALSE
omkokcbobabcd	FALSE
pfnngnbfaabab	FALSE
pfoecpeooabcd	FALSE
aaaaajakfnebll	TRUE
aaaicndckebcji	TRUE
allbklhpgmbhlb	TRUE
allnpbmmlhfpih	TRUE
bfkknmhnalignn	TRUE
bfldnfmbcjfcdm	TRUE
bpfimhnmkbonja	TRUE
bpgebioomhnbpk	TRUE
ckbncgkeeodhan	TRUE
ckbndkdceebkpo	TRUE
ddnohnbmfbjacf	TRUE
ddoeipgkiibbkm	TRUE
dnahpbnnefnobo	TRUE
dnaodbidgeaemk	TRUE
egmlljcppjbmdh	TRUE
egninfbibbocem	TRUE
fampoamahalode	TRUE
fanbfchcncohjd	TRUE
fkdhlmohmcmakp	TRUE
fkgafkceplkgbn	TRUE
gfajadhcnoelnm	TRUE
gfbahojpfehehc	TRUE
gphnganjhpblfd	TRUE
gpinelfdidogld	TRUE
hjekjjeijlakpb	TRUE
hjffbgiobjgkbj	TRUE
idlkekpcplmfle	TRUE
idlkhabgklbnpm	TRUE
iodkfomchfebma	TRUE
ioednlfebggfmm	TRUE
jjeoginemgiiae	TRUE
jjhccfgppkdmhe	TRUE
kdkjbghicjjfnk	TRUE
kdkkphhjkdkcki	TRUE
kneiaijioodbih	TRUE
knejigoknampil	TRUE
lhmhpnbmdklikg	TRUE
lhpdnihepifmda	TRUE
mcmlcgkkkjklci	TRUE
mcmmenanagnppa	TRUE
mnahbmfpkohpol	TRUE
mnbnihcmkcgkkp	TRUE
nijakememaoone	TRUE
nijfdebjhedgfn	TRUE
occaommgjfbkhm	TRUE
occclkloiicejg	TRUE
olgeiachlaiege	TRUE
oljnnoaolancoj	TRUE
pflalaniegoplc	TRUE
pfldhkempjhkgg	TRUE
aaaaajakfnabab	FALSE
aaaibllcndabab	FALSE
alonnbkognabcd	FALSE
alplbomggpabab	FALSE
bfimnifkhlabab	FALSE
bfjaagagblabab	FALSE
bpfcdhlhhbabcd	FALSE
bpgdlekeffabab	FALSE
cilfjkimooabcd	FALSE
cilneikkdjabab	FALSE
ddgpadhfjjabcd	FALSE
ddikagcohgabcd	FALSE
dmlmnklfedabcd	FALSE
dmmapjlclkabcd	FALSE
ehbicicnogabcd	FALSE
ehbmoddgppabab	FALSE
famfeiedbnabcd	FALSE
fancbkegepabab	FALSE
flhfepgcdnabcd	FALSE
flhijeknfnabab	FALSE
gelcmefkimabab	FALSE
gembohieeiabcd	FALSE
gpkbglhpifabcd	FALSE
gpneoohcmoabcd	FALSE
hjablcibhjabcd	FALSE
hjbbdochhhabab	FALSE
iegaonkmifabab	FALSE
iegciajijaabcd	FALSE
iofcfaglbjabab	FALSE
iogbebaiooabcd	FALSE
jiifojbjgpabcd	FALSE
jiijlfpgngabab	FALSE
kdlblicpikabab	FALSE
kdljpimgndabcd	FALSE
knhehjnejmabab	FALSE
knkkmgoipnabab	FALSE
lhlmplpclmabab	FALSE
lhmffpeghkabcd	FALSE
mcleobiohjabab	FALSE
mcopjjhecfabab	FALSE
mnekbopadoabab	FALSE
mnepnpdkeiabcd	FALSE
nhodjodbmabcdj	FALSE
niaoeihhpmabcd	FALSE
obpgfkdifkabcd	FALSE
obplkanjfhabcd	FALSE
oliljgnpjnabcd	FALSE
olinkajefoabcd	FALSE
pfiilainpcabcd	FALSE
pfjednambnabcd	FALSE
aaampnchmafbbpj	TRUE
aabpanpllejaede	TRUE
akmpkmpbfmllipp	TRUE
akndlnkndjpaagi	TRUE
bflnifaoaipdgda	TRUE
bfloibfgemjeobj	TRUE
cadbakoofjophek	TRUE
cadfpohflejlgkc	TRUE
ckclfpgomfdojig	TRUE
ckcohknjncemheo	TRUE
ddpoogbpdbmpcfj	TRUE
deahmmmhemfbefa	TRUE
dokjdnodgfomoma	TRUE
dokplkcngjpoame	TRUE
eidpjkidkpeobid	TRUE
eifampfikhdhghk	TRUE
fdkfacdjkmdhjil	TRUE
fdkfbccicaglaco	TRUE
fnggbmjdefmgigl	TRUE
fnheppbkgcidpfc	TRUE
ghlijehgfbhpboj	TRUE
ghmakmhgnjeaeao	TRUE
hapebeckekhhenl	TRUE
hapfknnmpmbbmjm	TRUE
hkfhinagbhfomhb	TRUE
hkfhjlamjiebcao	TRUE
ifoiiphgcdiigfa	TRUE
ifpekdibgeklfef	TRUE
jagdljahnkbekbm	TRUE
jahhmkdndimpaop	TRUE
jknonjfohpmmlhm	TRUE
jkoahpohkcpcccb	TRUE
kdhmhmdmhplnico	TRUE
kdjcmiichkgmdho	TRUE
koknigoblbbbmei	TRUE
komplpeodbchbik	TRUE
lifhnfghambbmab	TRUE
lifkakcbnflgfmh	TRUE
mcpligghfkmdmlg	TRUE
mdaohejjollcoeg	TRUE
mmkiecladleohli	TRUE
mmknefickaiplje	TRUE
nfkonmpojcjclef	TRUE
nfmlmcjefcnlhmh	TRUE
oalchhdomcijchg	TRUE
oaleaempgiminon	TRUE
olgjncaekepbdjf	TRUE
olhmmekhaciigdp	TRUE
pffgamifjpokloh	TRUE
pfgakmdcdgegbim	TRUE
aaajgggkllfabcd	FALSE
aabbgjfggpmabcd	FALSE
akjcfngfdfpabab	FALSE
akjoehehnagabab	FALSE
becbolgpjifabcd	FALSE
becmonojohmabab	FALSE
bofhhpofbjjabcd	FALSE
bohhikammhiabab	FALSE
chmplhnhhghabcd	FALSE
chnhmlkllbbabab	FALSE
dcbjnpoglfnabcd	FALSE
dcbmmokomopabab	FALSE
dmodfhcpobkabcd	FALSE
dmoomnpdmaeabcd	FALSE
ehepmdcjgdkabcd	FALSE
ehfcpcgafofabab	FALSE
fbpobgkoppeabcd	FALSE
fcafiehchpaabab	FALSE
flngffhlbfaabab	FALSE
flopfpjhjhpabab	FALSE
gfdoickodhdabcd	FALSE
gfebimigkhjabcd	FALSE
gpekkkndpbgabab	FALSE
gpfflbhockhabab	FALSE
hkmpgjniandabab	FALSE
hknnkgkoecnabcd	FALSE
iepkeehcpnkabab	FALSE
ifajdlehoohabcd	FALSE
ioiieiobecfabab	FALSE
ioiogamcdhpabab	FALSE
jiiemcjipodabcd	FALSE
jijacjligpbabab	FALSE
kcjfhdbnhfdabcd	FALSE
kcjgpaeofmeabab	FALSE
knledoaooaoabcd	FALSE
knlhopcakonabcd	FALSE
lgoenddiibiabcd	FALSE
lhabkeidbecabab	FALSE
mbcgiljpiheabcd	FALSE
mbchmbcieokabab	FALSE
mlhhaigpleoabcd	FALSE
mlhooppockpabab	FALSE
ngkdmeaoamhabcd	FALSE
ngkmnkmnbmcabab	FALSE
obgeicbjlbhabab	FALSE
obgekmeiineabab	FALSE
omleaaklbjnabcd	FALSE
omlgkenicinabcd	FALSE
pggfkocplkgabab	FALSE
pghloafjppgabcd	FALSE
aaajgggkllfpbfng	TRUE
aabfgpmbcodhojlj	TRUE
akhgfnpdpkoenhem	TRUE
akhjpfdlcnloonij	TRUE
befadlaopflpbbml	TRUE
befeigjijbogodeg	TRUE
bobhnhhghlhmlkll	TRUE
boblbbinbojnhkii	TRUE
cidahgfbkfplefke	TRUE
cieieioglgnekoof	TRUE
dbokaekiffmpfcpi	TRUE
dbolhoiccbfpjepn	TRUE
dmicmafiehchpaok	TRUE
dmjaepmlimbcgbdk	TRUE
ehoedkkellfclamc	TRUE
ehpabmnfbejbjcob	TRUE
fceokgahhiifocop	TRUE
fcfdpjlpeojgkckd	TRUE
flnohoohlcnheeoi	TRUE
floheopnaiobbnoc	TRUE
gfpihpoaoincmidi	TRUE
ggaabflpkannlbjc	TRUE
gphhiocfmogfoccp	TRUE
gphjjimidmjinaap	TRUE
hjjmkipnnicnghbh	TRUE
hjkbmjlfhbkhopgg	TRUE
ifbecbhimogjeidm	TRUE
ifbimhncgjhfmmgk	TRUE
ipbpbimmhcmokifh	TRUE
ipchaakejbnkkhnb	TRUE
jijbfmmjdcolfegh	TRUE
jijieopdlnahnpde	TRUE
kcabjlphhfdjdcbn	TRUE
kcaijfockfonbdlk	TRUE
knjamlfgmjdmelim	TRUE
knjpifcdmegjbnfe	TRUE
lhdaagfbaakoijlk	TRUE
lhdgedndiijnagfh	TRUE
mbacopmpoffhnpkh	TRUE
mbahbpakolipiall	TRUE
mklfolmpjhdpepha	TRUE
mkljoejoedpmpeke	TRUE
nhacldememnlcode	TRUE
nhbbcfojmpkhldlp	TRUE
obhopecddheklbad	TRUE
objbhejolfbpffhg	TRUE
omhjjpnnlbodnkcf	TRUE
omhlecmkkocgdbad	TRUE
pgablcmkfmefmaof	TRUE
pgbmglfmggdhccda	TRUE
aaadimoniphmabab	FALSE
aabiglekgbnpabcd	FALSE
ajhjiknohgenabab	FALSE
ajijnjfhbcnjabab	FALSE
bcncigbidjdlabab	FALSE
bcokgacnopiiabcd	FALSE
bmdikijdgnddabab	FALSE
bmecbppefhkcabab	FALSE
cfpjhhdclpmdabab	FALSE
cgafakkdkjbkabab	FALSE
daenemgjdhlbabab	FALSE
dahfmbjipgfjabcd	FALSE
djmldnjdbpkkabcd	FALSE
djnffglibhonabcd	FALSE
effnhlambkndabab	FALSE
efhcaklmiobbabab	FALSE
faknajefcopgabcd	FALSE
famjbnheebmfabab	FALSE
flbmllgeldoababo	FALSE
flcgclbilhcmabab	FALSE
gfplcghoglbeabcd	FALSE
gfplfeafnlfkabcd	FALSE
gpodoegechdgabcd	FALSE
gpofnokojgcfabab	FALSE
hkigligllaehabab	FALSE
hkkbiggekngpabcd	FALSE
ieknkicpngjbabcd	FALSE
ieldiplfogdjabab	FALSE
iocjaiinjcojabab	FALSE
iodaafjflddlabcd	FALSE
jildopknagjjabcd	FALSE
jilphakohofjabcd	FALSE
kcajkiibjgdkabcd	FALSE
kccannjogacmabab	FALSE
kneogaeaihceabab	FALSE
knfoohmpjnnlabab	FALSE
lhogffagbnepabab	FALSE
liahnlebepleabcd	FALSE
mcincigkgmfhabcd	FALSE
mcipjmdnlfacabcd	FALSE
mmibikcalbmkabab	FALSE
mmikcaohdnomabcd	FALSE
nhoefhpkalkhabab	FALSE
nhofioonbbphabcd	FALSE
obibhhnimnbjabab	FALSE
obidlbgcdbjeabcd	FALSE
omaghcacdmefabab	FALSE
omakgkgpcijmabcd	FALSE
pgaencfccfjhabcd	FALSE
pgbbkcbnoodlabab	FALSE
aaadimoniphmimigl	TRUE
aabegbnphabmjikfp	TRUE
ajjhcgopnfaobacnj	TRUE
ajjhijelhfmkjofej	TRUE
bciomomgpjfnnkmgb	TRUE
bclaaddbgbinmignf	TRUE
bmgnabpbokjfcngbj	TRUE
bmhkkpkamonlbmjnc	TRUE
cgfafoampmnhcfenn	TRUE
cgfhgbnfdoljpeiom	TRUE
daompgciocpgkfkol	TRUE
dapaajlhppdbjcemb	TRUE
dkgniaodcncapiekm	TRUE
dkiolanjioanlkhmh	TRUE
eekkbfpcmgepnoepd	TRUE
eekldhojlkjkdekdd	TRUE
falhkpdbongdmbfcj	TRUE
falncldoebjmmjlid	TRUE
flbmagjljpnjkbnod	TRUE
flceagabddjfhdpdm	TRUE
gflghpenfibehcckl	TRUE
gflpoecjjclpnipdj	TRUE
gpoifnppdmoihhmbg	TRUE
gpokcmedlmmalchek	TRUE
hkdgpgnenjbecpnhb	TRUE
hkdhdjmcpnhnpoolo	TRUE
iemmjeeddacmcafna	TRUE
ienkpemghddpbolgl	TRUE
iofllkapgpllkjdjj	TRUE
iofonhnoheceblooj	TRUE
jinegkdobnhhcgnnp	TRUE
jioapkjocafkenflp	TRUE
kckfpnjgepfkbdfla	TRUE
kckllmijobhaapjca	TRUE
knaipojoioogoefio	TRUE
knbbamdjkohlifhbn	TRUE
libdnaohnjimfbifn	TRUE
licghlcecpjeacaec	TRUE
mccmhnolooalkbafo	TRUE
mcdehbkkobncmnjch	TRUE
mnakeiehnjgihldkf	TRUE
mnccoeehjpeenopbk	TRUE
ngefgdaepiikmjhhe	TRUE
ngfeolbflpkhkhenf	TRUE
obehhdalpoaifhgpj	TRUE
obehnkgkomnhenigb	TRUE
omaideghgbpbangmf	TRUE
ombkghlfioiminbha	TRUE
phbcanojjdhjhjiao	TRUE
phbkhkjnebgnhgied	TRUE
aaapebchddnblabab	FALSE
aaapehloapebfabcd	FALSE
aiomgbeemoamjabcd	FALSE
aiooijijbminbabcd	FALSE
bclifiadbdhceabcd	FALSE
bcljbcmbhffedabcd	FALSE
bmlhnklkogllhabab	FALSE
bmmiahaebdeepabab	FALSE
cgoikpgcdjmppabcd	FALSE
chablfmnnknleabcd	FALSE
dbndhnpjdkjjkabcd	FALSE
dbngmmnngfmpkabab	FALSE
dlipnjhifclgpabab	FALSE
dljknlcombmokabab	FALSE
efcoihphalchgabab	FALSE
efdegffbnmpppabab	FALSE
fadkipmelhkjfabab	FALSE
fadnkllcbcilkabab	FALSE
fllpbeljpamcaabcd	FALSE
flnbiijmnbfnmabcd	FALSE
gfkpfeogooibdabab	FALSE
gflogonndkjpaabab	FALSE
gonlnmgifgmfiabab	FALSE
goofelhdiilcoabab	FALSE
hinibkbepcaooabab	FALSE
hinjggcnegmbfabab	FALSE
idlldcgibikamabcd	FALSE
idmchngbccimoabcd	FALSE
ioohebggnijpmabab	FALSE
ioominjfndbbdabcd	FALSE
jipjnlmnhdcjdabcd	FALSE
jipkccjlejfcnabcd	FALSE
kdifdbcloididabab	FALSE
kdigpdonhmajhabcd	FALSE
kogglnaifnkidabcd	FALSE
koidkkcpfaahlabcd	FALSE
ljeimlnciiobkabab	FALSE
ljfnoadmpnicabcdi	FALSE
mdiphbebidjgbabab	FALSE
mdjamojhjoiepabcd	FALSE
mobjhmjjbaonbabab	FALSE
mobpdfbjepoepabab	FALSE
niccpkcfcjpjbabcd	FALSE
niceaiiohebfpabab	FALSE
ocanocgikadfiabab	FALSE
ocbkipmgealgbabcd	FALSE
omhkijblgngmmabcd	FALSE
omicimdnkhdhkabab	FALSE
pgeafhoakeopeabab	FALSE
pgeagafbobbmfabab	FALSE
aaacfcckoofhbjndla	TRUE
aabkcedgfifhhffkij	TRUE
akahmbjmgpkgfplfpj	TRUE
akbbikdmdbmhpebbdd	TRUE
beeojjcmkbgmjnpebl	TRUE
befalanagadojijaii	TRUE
bphnckjmghcekpnbcn	TRUE
bpiigpepnkihnifloj	TRUE
ckbikdookinakanlnk	TRUE
ckcbmfceaddbgpnbja	TRUE
decbehppgfcifablbg	TRUE
decjlkfgmdoalicfoh	TRUE
dodbpnealhmjcafecb	TRUE
dodeidbaaipdlbefga	TRUE
ehnkegbfcjggdggejj	TRUE
ehnljkhmflncajmloe	TRUE
fcmnmhfoiinohnalhf	TRUE
fdahedjffcpfaohdfn	TRUE
fndjmefmlcidcjjgjj	TRUE
fnejngopfhkjmblcal	TRUE
ggekdmanipnjcjjcbl	TRUE
ggenlomncdamhfipmn	TRUE
halnfklihfakeaahmm	TRUE
halpbdafmpfckicnee	TRUE
hkjhbjendencinoecf	TRUE
hklclcbcpikfpledko	TRUE
iegdjkbnclcjaikgip	TRUE
iegechblnnidpopepp	TRUE
iofhohccflfcoefipe	TRUE
iofnghonbkoilnkpol	TRUE
jiiecphoihegagndfi	TRUE
jijanbhblgbohideee	TRUE
kdfhgjhjjgaoepbplk	TRUE
kdhnbjokpknkpfhlep	TRUE
kohjefhjjbaoahhaba	TRUE
kojcdbdeahjehbmlbp	TRUE
ljfcffmoomonkdangn	TRUE
ljfphhfekkhcakneja	TRUE
mdidaghndghdfjpodg	TRUE
mdidfcnakpongmglne	TRUE
mnebkpfenjljpcibcb	TRUE
mnekcgbfchdihkhhaa	TRUE
nhjfbpjhiodeegopee	TRUE
nhjfjjbbenbcffgbhe	TRUE
obdinbdjmpfppdhaea	TRUE
obfakhcmopdjnkagef	TRUE
olmgninjcmmagndoee	TRUE
olmigdbbkbbpaimkne	TRUE
pfhdffpkcdconkdedj	TRUE
pfheiipjigigibbeln	TRUE
aaabdocaaokajeabab	FALSE
aaabnbkgcdloaeabcd	FALSE
aldikkcfnhkhknabcd	FALSE
aleiiehnknadjfabab	FALSE
beegobcnebnhclabcd	FALSE
beehopklapdonpabab	FALSE
bonaienkpbanohabcd	FALSE
bophdmhdpcihnlabab	FALSE
cjacfnmidnmpenabab	FALSE
cjadhjjgkcccnpabab	FALSE
dcllmcmdjjbmhjabab	FALSE
dcmanbipbiapebabcd	FALSE
dnppcnejjkmmgaabcd	FALSE
dobabpgpmnoajoabab	FALSE
eineobmocbphhjabab	FALSE
eipienelbjamlcabab	FALSE
fcloeemikgohfoabcd	FALSE
fcmodmilkiceagabab	FALSE
fnakoillppkjigabab	FALSE
fnaokpbokcojhlabab	FALSE
ggndlcimjcniigabcd	FALSE
ggniamamdadcfpabcd	FALSE
hblpgeobkofdjnabcd	FALSE
hbmdnanlldjlkjabcd	FALSE
hmafblmmgbjdkmabcd	FALSE
hmahgfkkhmcdfababc	FALSE
ifpcfdpikaoghbabcd	FALSE
ifpeekekgpdackabcd	FALSE
ipkplhicbfokljabcd	FALSE
ipmdenkijlkpheabab	FALSE
jlgndfaammmhghabab	FALSE
jljaofjhiahbbeabab	FALSE
kebcefkjcoklioabab	FALSE
kecnlkpefmfhllabab	FALSE
knhjhaaghpofoiabcd	FALSE
knicjilhfdclbeabab	FALSE
lhiaphdogkcegcabab	FALSE
lhieegegjgnkpnabcd	FALSE
mbanelhmmbobjpabcd	FALSE
mbbhgcfpgoelioabab	FALSE
mkpddegjnfgoboabcd	FALSE
mlapdocajcpojmabab	FALSE
ngieaofdnlenojabcd	FALSE
ngjmbpbaklcjiiabab	FALSE
oaonlannkpgkdnabab	FALSE
oapaoafnnnpodgabcd	FALSE
oknggnehojmcjeabab	FALSE
okpjaahfbjblofabab	FALSE
pfoapiclpdkpfpabcd	FALSE
pfokfjfnonjcfgabcd	FALSE
aaabdocaaokajeibkgc	TRUE
aaabndloaepnddhngic	TRUE
alcjefgakmilfghlijb	TRUE
aleeemibekniemkecon	TRUE
becpdhadcoelbpgkmma	TRUE
beddaooagpiapmfpijm	TRUE
bpbhcgodmaappmomnfb	TRUE
bpbhnmdomamdgljefjh	TRUE
cidpajjnfnhcffjgmcp	TRUE
cidpfjmdfnaidbbbdmb	TRUE
ddcolbcnkokllchdcic	TRUE
ddenmojcbdnpoobbgfn	TRUE
dogcbcjnkpfkipgddmm	TRUE
dohagacnloikbakkpak	TRUE
eiiciknnaecpflmilih	TRUE
eilkjboalpdllmpcdeh	TRUE
fddgaldhglkhgcogkjb	TRUE
fddhjdbkidbioelkgdk	TRUE
fmeogbkgaajnmkhhmko	TRUE
fmfcefehgnhgolkgpoc	TRUE
ghjmnkgnmjmmbpflabl	TRUE
ghldmpedofoehlpddjc	TRUE
hboejnilmeandbgbhan	TRUE
hbojgnbjkemhkhpieno	TRUE
hmcjcamheihiacbjfal	TRUE
hmcmipboodjfffdijad	TRUE
igbooaffpnmonaladjh	TRUE
igdimhbhhkakjdhndbm	TRUE
ipnopmbgofocdlhlpfm	TRUE
ipoflhafoajjmmebgoj	TRUE
jklfjnilnakaijdpmfi	TRUE
jkllmnmpgffelicodfk	TRUE
kemaknikfflboojnkka	TRUE
kenehpiecdpgbdoicef	TRUE
knnnmjbeelbpommpmkg	TRUE
knomiogmkaleicnedak	TRUE
lheepgobaochgbleaga	TRUE
lhehljeglielbnfdifh	TRUE
mbajfmgpfklejpkmadc	TRUE
mbceeadleaiobbkihic	TRUE
mlbhbcoopbmdmecekdi	TRUE
mlbhdhnjlhlegifnpea	TRUE
ngeanllkelgnkggkclg	TRUE
ngeepdlhnbafleakmkj	TRUE
obiemehjellompjfjij	TRUE
obijlbnlfaiogcbicea	TRUE
olhdnibcpcjhfcakggd	TRUE
olhjodnmonnmfpmglfc	TRUE
pfbananlkbohnnjpjgn	TRUE
pfbmlnmhnnagocpecml	TRUE
aaadllkbclkfhomabab	FALSE
aacabhbppepmbigabab	FALSE
aldffmgnkcalnmlabab	FALSE
alebijbbcogkfckabab	FALSE
bfbomadlblljpcoabcd	FALSE
bfbppeiieieoeaababf	FALSE
cackllcmcoeakgpabab	FALSE
cacokhpgajkhbjlabab	FALSE
cmdeclhigfkofcbabab	FALSE
cmeobghknnlfnmhabcd	FALSE
dgiekkjaenahgjgabab	FALSE
dgjeojackaeelplabab	FALSE
eakffmkpoologjjabcd	FALSE
ealjpafbhgdkallabab	FALSE
ekfhfjojabkdfpgabcd	FALSE
ekgkiodmebneclgabcd	FALSE
fdnblhelhppaengabcd	FALSE
fdncipkajbgigciabab	FALSE
fohcmmgdikdmoebabab	FALSE
foibmcphfbldnplabab	FALSE
gjecmfkbomdhbkmabcd	FALSE
gjeoakmiamffdbiabcd	FALSE
hcodimcdikkfcbnabcd	FALSE
hcofdbncgagkhkoabcd	FALSE
hnedaabcnfnakndabcd	FALSE
hneicljkmfhnmdpabcd	FALSE
iheamhelaaofhfaabcd	FALSE
ihfhijdikcheggbabab	FALSE
jbbpcfpoeghnlpnabab	FALSE
jbdgoabmfjjgpebabab	FALSE
jlhlakohghhhjllabcd	FALSE
jlmdmbbfidfmnikabcd	FALSE
keinlalklaaliilabab	FALSE
kejaelbfenacccdabcd	FALSE
koeojlcibojdbkoabab	FALSE
kofclnilnnmkefmabcd	FALSE
lhigkidljfkiajfabab	FALSE
lhijednnjofjapeabab	FALSE
mbhejbjjfhjgjpoabab	FALSE
mbhmliogokfjcpkabab	FALSE
mlkkkneolhnnpkjabcd	FALSE
mlmaafedabmbdodabab	FALSE
ngccehhpoeafemfabcd	FALSE
ngcmoehpaebgbifabcd	FALSE
oacgpfcjkihkciabcdn	FALSE
oadbiaoolpcdobeabcd	FALSE
olbagcpkpjmaccgabcd	FALSE
olcdhkdnohmkngaabab	FALSE
pgjjegljmjgmlnfabab	FALSE
pgkboechmklhianabcd	FALSE
