aaajcfomfe	TRUE
aabohgbdgm	TRUE
alajdaleaj	TRUE
albjldhjbm	TRUE
beniodljmh	TRUE
benkgncbpc	TRUE
bpdeiodapp	TRUE
bpdilhnoeg	TRUE
cjbepjngip	TRUE
cjcdabpnlc	TRUE
ddibnmgmhp	TRUE
ddicbmpjkm	TRUE
dmodhcfhbg	TRUE
dmogjpfigc	TRUE
eflkfenojn	TRUE
efloimaann	TRUE
fadodapiie	TRUE
fagkimdong	TRUE
fldgneplij	TRUE
fleelddndg	TRUE
gfceacbgpe	TRUE
gfdchkjlad	TRUE
haaflnonje	TRUE
habahieeib	TRUE
hjkbebllmh	TRUE
hjkggmeipg	TRUE
iclebjepbe	TRUE
iclmmbiaeo	TRUE
infkllmnno	TRUE
infncbnloh	TRUE
jjadafeifd	TRUE
jjamjhhohk	TRUE
kcgiaingpb	TRUE
kcgkgodcpp	TRUE
knelafoijh	TRUE
knfpckcckp	TRUE
lgmfflihlh	TRUE
lgmpjphego	TRUE
mckelobdji	TRUE
mclldkdkcl	TRUE
mmeinejffl	TRUE
mmeopcadan	TRUE
nfeefbghfc	TRUE
nfepdeioln	TRUE
nomcdinkgd	TRUE
nomdjnkeaj	TRUE
ojhicnfpdp	TRUE
ojkheodogn	TRUE
pfgaijcgmb	TRUE
pfhbkojahp	TRUE
aabhakaaaa	FALSE
aabpgeaaaa	FALSE
ajgbodaaaa	FALSE
ajgcccaaaa	FALSE
bcpfkpaaaa	FALSE
bcpojhaaaa	FALSE
bndamnaaaa	FALSE
bndbllaaaa	FALSE
cimfpfaaaa	FALSE
cimpjoaaaa	FALSE
deijkjaaaa	FALSE
deikfmaaaa	FALSE
dnfbkdaaaa	FALSE
dnfdklaaaa	FALSE
ehmmchaaaa	FALSE
ehmndhaaaa	FALSE
faiepcaaaa	FALSE
fanekeaaaa	FALSE
fkecklaaaa	FALSE
fkedbjaaaa	FALSE
gdamjbaaaa	FALSE
gdbeehaaaa	FALSE
gmfmniaaaa	FALSE
gmhjnnaaaa	FALSE
hhfjhbaaaa	FALSE
hhfmccaaaa	FALSE
ibjpicaaaa	FALSE
ibkahfaaaa	FALSE
imelkdaaaa	FALSE
imenjkaaaa	FALSE
jhijajaaaa	FALSE
jhjahkaaaa	FALSE
kbgfhdaaaa	FALSE
kbiafjaaaa	FALSE
kmeijeaaaa	FALSE
kmfkaeaaaa	FALSE
lhbmhdaaaa	FALSE
lhbmnkaaaa	FALSE
mbpnfdaaaa	FALSE
mcadcoaaaa	FALSE
mljkfaaaak	FALSE
mllhjbaaaa	FALSE
ngjmmpaaaa	FALSE
ngkhblaaaa	FALSE
npjebnaaaa	FALSE
npkefcaaaa	FALSE
okcdlnaaaa	FALSE
okcgkdaaaa	FALSE
pemoooaaaa	FALSE
penediaaaa	FALSE
aabhakgeoab	TRUE
aabpbaeeoma	TRUE
ajiemmfogdn	TRUE
ajikifcgdln	TRUE
bdlnjajiojc	TRUE
bdnhdffedlo	TRUE
bocfiiolbip	TRUE
bocnmmbkpnl	TRUE
ckakcmphgla	TRUE
ckbcbejejbf	TRUE
debjmaommgj	TRUE
dechmbojilh	TRUE
dngmbhinfff	TRUE
dnhiljlbdjl	TRUE
eghflfhnehl	TRUE
egjnboimkfc	TRUE
faflmlgolbd	TRUE
fagmkfaapai	TRUE
fjlfkljgohb	TRUE
fjlmenbgebj	TRUE
gdjjcnolphe	TRUE
gdjpnncfljf	TRUE
gngapefeppa	TRUE
gngkjokkjda	TRUE
hhbdppnamae	TRUE
hhcopoodkhc	TRUE
ibjhodekjok	TRUE
ibkghcibben	TRUE
imfmkcohhea	TRUE
imghdjcjjfj	TRUE
jgnhjdhjkbk	TRUE
jgnokgcamdb	TRUE
kbgknkcokjn	TRUE
kbhbmdkigpn	TRUE
kmkcbaighoh	TRUE
kmkilchooep	TRUE
lhflfldflin	TRUE
lhgeobckmgj	TRUE
mbmoidfagne	TRUE
mbnanhappdf	TRUE
mmkofnmdalp	TRUE
mmldhejjmdk	TRUE
nflpdmikffa	TRUE
nfmihpppjon	TRUE
npdpeobpadp	TRUE
npebcghnocb	TRUE
ojoemdjnhej	TRUE
ojpponjcfln	TRUE
pefbpfcdpel	TRUE
pegdpapkain	TRUE
aabhakgaaaa	FALSE
aabpeoaaaab	FALSE
ajindkhaaaa	FALSE
ajjajidaaaa	FALSE
bdgbhijaaaa	FALSE
bdhddneaaaa	FALSE
bnmeabgaaaa	FALSE
bnnfafjaaaa	FALSE
cjjagblaaaa	FALSE
cjkglheaaaa	FALSE
ddpocegaaaa	FALSE
deadiedaaaa	FALSE
dnhejkpaaaa	FALSE
dnhpdhfaaaa	FALSE
ehgjbecaaaa	FALSE
ehgjflaaaae	FALSE
fakaohbaaaa	FALSE
famacioaaaa	FALSE
fjhbpnoaaaa	FALSE
fjhipggaaaa	FALSE
gdoifpeaaaa	FALSE
gedcdckaaaa	FALSE
gmlddieaaaa	FALSE
gmnjalkaaaa	FALSE
hhihgcmaaaa	FALSE
hhlmpfcaaaa	FALSE
ibnaoigaaaa	FALSE
ibnlhepaaaa	FALSE
inaajmgaaaa	FALSE
inaikoaaaai	FALSE
jgfiiccaaaa	FALSE
jgfphifaaaa	FALSE
kbkjcgmaaaa	FALSE
kbkmcgpaaaa	FALSE
kmoejlpaaaa	FALSE
kmoodgiaaaa	FALSE
lheiilgaaaa	FALSE
lhfgoejaaaa	FALSE
mbfnpnpaaaa	FALSE
mbhfohfaaaa	FALSE
mlljieiaaaa	FALSE
mllkimoaaaa	FALSE
nfdmamiaaaa	FALSE
nfeodecaaaa	FALSE
npflcnoaaaa	FALSE
npgfngeaaaa	FALSE
ojlnkloaaaa	FALSE
ojmkameaaaa	FALSE
pfajcdnaaaa	FALSE
pfamnkgaaaa	FALSE
aaahjjainmdb	TRUE
aabdbgpcfmdf	TRUE
akhlicoodaef	TRUE
akifhiklmnif	TRUE
bememllmlpnc	TRUE
beniepadphob	TRUE
bpfbhjhjffaf	TRUE
bpgkjhjjafff	TRUE
cjfflgikddjc	TRUE
cjfjendhekbp	TRUE
deecpjehnjhh	TRUE
deedajomglmn	TRUE
doanmochoikc	TRUE
docmgdfkhfak	TRUE
eioflhepmoaa	TRUE
eiohoiflhiia	TRUE
fdboihbilcga	TRUE
fdcjadoodjcg	TRUE
fnkjkpiajgjl	TRUE
fnlckdkkheka	TRUE
ghcpjaogacgm	TRUE
ghemklamhjag	TRUE
hbkmaejdmmjh	TRUE
hbloddhppobb	TRUE
hljakoddfmob	TRUE
hlkhemndfhjj	TRUE
ihdeppmlcfga	TRUE
iheeclpmgajl	TRUE
jblfkafdmjjm	TRUE
jbmggmdibbde	TRUE
jmagdainkeff	TRUE
jmalimegncpm	TRUE
kglpbldllalh	TRUE
kgngdignahpe	TRUE
lbnloloabgak	TRUE
lbodpjmmiikm	TRUE
llcblcnjmphd	TRUE
lldakgjlofgp	TRUE
mgcpfmimdgjj	TRUE
mgdhpiaojdcf	TRUE
nakcbpeaejln	TRUE
nalnfojjdjib	TRUE
njkgbdnfdach	TRUE
njknbaiaodje	TRUE
ocjnaeomcnlp	TRUE
ockdcfhppcbk	TRUE
omfbbbebigco	TRUE
omfhnhgjilii	TRUE
pgddgdbjdmod	TRUE
pgeflilejcdb	TRUE
aaahjjaiaaaa	FALSE
aabnmdbdaaaa	FALSE
akhgdfaoaaaa	FALSE
akhlcpmcaaaa	FALSE
bepmbahiaaaa	FALSE
bfaiccjlaaaa	FALSE
bolhhdmhaaaa	FALSE
bolodgjpaaaa	FALSE
ckakdjmmaaaa	FALSE
ckcedkfbaaaa	FALSE
decfhdeoaaaa	FALSE
dedahmolaaaa	FALSE
doddfeefaaaa	FALSE
dodplhdhaaaa	FALSE
eiifnhpeaaaa	FALSE
eijfblbnaaaa	FALSE
fdbgjifiaaaa	FALSE
fdcfkfdaaaaj	FALSE
fnbooohoaaaa	FALSE
fnccglkmaaaa	FALSE
ghbeoagaaaaj	FALSE
ghbggnpcaaaa	FALSE
hbhikhaoaaaa	FALSE
hbhnknelaaaa	FALSE
hmfhpopfaaaa	FALSE
hmfpmbdbaaaa	FALSE
igoemdldaaaa	FALSE
igpoknppaaaa	FALSE
jbodimlhaaaa	FALSE
jbpeaokfaaaa	FALSE
jmfimnkoaaaa	FALSE
jmflkhbcaaaa	FALSE
kgmlclckaaaa	FALSE
kgpgnccpaaaa	FALSE
lblljkliaaaa	FALSE
lbmcdojgaaaa	FALSE
llbikpklaaaa	FALSE
llcgopocaaaa	FALSE
mggcjpaeaaaa	FALSE
mghacackaaaa	FALSE
nafameapaaaa	FALSE
nafbedamaaaa	FALSE
njhpeigbaaaa	FALSE
njjlklfkaaaa	FALSE
oddhfmhpaaaa	FALSE
odeabhlpaaaa	FALSE
olmhhnhnaaaa	FALSE
olniiicaaaao	FALSE
pgfccecnaaaa	FALSE
pghpjibgaaaa	FALSE
aabhplcjjmlkf	TRUE
aacangpcafbfd	TRUE
ajficlleoffnn	TRUE
ajgihbcmodajd	TRUE
bckghfcnkdfcc	TRUE
bcljikkkmkblg	TRUE
bnkcckfpdpdec	TRUE
bnlnakegjjhhe	TRUE
cielaebakekdn	TRUE
ciffcbhcbmnmm	TRUE
dbnipieldipaa	TRUE
dbocpepffmccd	TRUE
dlgadalefmcai	TRUE
dlggjgldiiein	TRUE
eepcpdnehplpg	TRUE
efadhnmfgclbd	TRUE
eojnakdnadnij	TRUE
eojneompekhbm	TRUE
finadobjpapca	TRUE
findoejijkblc	TRUE
gdpleihlklocf	TRUE
geadehmagemnh	TRUE
gpggoadnhedne	TRUE
gpgjnhijakblh	TRUE
hjjneilalefme	TRUE
hjlplehfjedde	TRUE
ifaaealdcjjdg	TRUE
ifahllgjienin	TRUE
ioibchlmflihp	TRUE
iojbnjfbenbmi	TRUE
jieencfcjmmde	TRUE
jieibmpepkjgi	TRUE
kdhlkiokipmlh	TRUE
kdicahgcofonl	TRUE
knpmdddmdncfc	TRUE
koaaahelbfdnd	TRUE
licffglefohca	TRUE
liefkgegllebj	TRUE
mdbnmehbbhfbd	TRUE
mddchjgcoldej	TRUE
mofinejjjkahf	TRUE
mofnnhlhcaaai	TRUE
nindpiplhefnb	TRUE
njbaifbngkbal	TRUE
ocajckepcocjj	TRUE
ocalhfmahipfg	TRUE
omdickmfbkimb	TRUE
omdkafepbgjnd	TRUE
pfdampofbkemk	TRUE
pfdlflbalafmo	TRUE
aabhplcjjaaaa	FALSE
aacmlkfanaaaa	FALSE
ajhmicoicaaaa	FALSE
ajjhmfbhoaaaa	FALSE
bcnlihimhaaaa	FALSE
bcnmjjnefaaaa	FALSE
bnmphcifcaaaa	FALSE
bnoeljjfeaaaa	FALSE
cihnmfjjcaaaa	FALSE
ciiamjdlbaaaa	FALSE
dbmmhfghdaaaa	FALSE
dbmpflojjaaaa	FALSE
dlfonmmceaaaa	FALSE
dlggngpicaaaa	FALSE
eebnoideeaaaa	FALSE
eecgokgpfaaaa	FALSE
enplkellcaaaa	FALSE
eoahdolohaaaa	FALSE
fjobeehciaaaa	FALSE
fjoknjbinaaaa	FALSE
geikhmeegaaaa	FALSE
gejcegjmfaaaa	FALSE
gphkbfblhaaaa	FALSE
gphkclmidaaaa	FALSE
hjnpkppnkaaaa	FALSE
hjoakahdlaaaa	FALSE
ieoampcdcaaaa	FALSE
ieogkppheaaaa	FALSE
iooaiionoaaaa	FALSE
iooandpggaaaa	FALSE
jigfodboaaaaa	FALSE
jihfnnfccaaaa	FALSE
kcgheocfmaaaa	FALSE
kcgmoljffaaaa	FALSE
knjbgieagaaaa	FALSE
knjpillgjaaaa	FALSE
lidkeaicfaaaa	FALSE
lidofmjgdaaaa	FALSE
mdjffecmbaaaa	FALSE
mdlcladoeaaaa	FALSE
mobefghipaaaa	FALSE
mobflmbohaaaa	FALSE
nideepnpkaaaa	FALSE
nidjnalngaaaa	FALSE
ockbhilogaaaa	FALSE
ockhpkfldaaaa	FALSE
okmdgmchdaaaa	FALSE
okndlmankaaaa	FALSE
pfgdjlfeeaaaa	FALSE
pfgifgmphaaaa	FALSE
aaaejmdafniiio	TRUE
aaakgkimjajgfd	TRUE
akchnlkjjgeagh	TRUE
akcmlmpkchgaml	TRUE
bdoicddgbkhiih	TRUE
bdoihnjngodbfe	TRUE
bnejokfnlfgpod	TRUE
bnfimhdoblekej	TRUE
chdkekcpjmnofi	TRUE
chdlopdiijogjd	TRUE
dbeooojbhjopnl	TRUE
dbgnbdckadbhof	TRUE
dlldifnelfpjah	TRUE
dlljkcgcdmflgj	TRUE
egbnhjndhkjbgi	TRUE
egecloiligfmaj	TRUE
epmgifhmomgcin	TRUE
epnknojcfeikkd	TRUE
fjnpfoohgjemga	TRUE
fjoehigopokcim	TRUE
gekepngeiicben	TRUE
gembfhakjjgmlf	TRUE
gpmimpjnbnbmbj	TRUE
gpphlmppcblfcn	TRUE
hjobpekkpidlmo	TRUE
hjpgepkblfjgoh	TRUE
iekodfobffmcih	TRUE
ieliflabaknaho	TRUE
iopebojdkdmdmf	TRUE
ipaajieiohlnbd	TRUE
jingloefndpcam	TRUE
jjcboanpdcfjna	TRUE
kdnookhbodpcng	TRUE
kdocfobjahclic	TRUE
kpfcnmlegojdcn	TRUE
kpfnhdgipdaeig	TRUE
lhnaoinnpfmpbl	TRUE
lhngakhmblgdlm	TRUE
mblboomikmjfom	TRUE
mblhdaplpplnni	TRUE
mlnkelokecmcph	TRUE
mlobifodehilkg	TRUE
nhfiljccijcpkp	TRUE
nhhbkfipjmcolk	TRUE
obpdlkdmcjhkbn	TRUE
ocaccoafiaomfe	TRUE
omippaikjkhoko	TRUE
omjbigmfbfllmn	TRUE
pfkndokgjjddaa	TRUE
pfmgngcakkmada	TRUE
aaaejmdafnaaaa	FALSE
aaakiiiogkaaaa	FALSE
akbgdhcbidaaaa	FALSE
akcbejiefdaaaa	FALSE
bemnnimbblaaaa	FALSE
bemojccjglaaaa	FALSE
bngjnhhabcaaaa	FALSE
bngkpeifngaaaa	FALSE
cgkpbbhenfaaaa	FALSE
cgnbfcnfkmaaaa	FALSE
dbnimgcfafaaaa	FALSE
dbpljgpnifaaaa	FALSE
dleempbiffaaaa	FALSE
dlemlodddeaaaa	FALSE
eflobegeflaaaa	FALSE
efmnchcnmaaaak	FALSE
epjfohcpccaaaa	FALSE
epljcpkfpkaaaa	FALSE
fkpncppgeoaaaa	FALSE
fkpodimkmfaaaa	FALSE
gfkcbnpjioaaaa	FALSE
gfkdiadkilaaaa	FALSE
gppmbfbnjnaaaa	FALSE
gppoalephjaaaa	FALSE
hjipgdmdbcaaaa	FALSE
hjjlnlbmekaaaa	FALSE
idogglogngaaaa	FALSE
idohpefndeaaaa	FALSE
ipbcjdidnpaaaa	FALSE
ipekdhkamiaaaa	FALSE
jimldiilonaaaa	FALSE
jinaejlmapaaaa	FALSE
kdelkjmbdpaaaa	FALSE
kdfjkepdieaaaa	FALSE
kpajdghbflaaaa	FALSE
kpalkodhplaaaa	FALSE
ligfakiffmaaaa	FALSE
ligofmfnddaaaa	FALSE
mbneppmnehaaaa	FALSE
mboejpdoccaaaa	FALSE
mlokacmbaaaamp	FALSE
mloldoofcbaaaa	FALSE
nhehlfnojmaaaa	FALSE
nheohnkgopaaaa	FALSE
ocangjcfbgaaaa	FALSE
occbafabchaaaa	FALSE
omindnbmdbaaaa	FALSE
omjkbgiodbaaaa	FALSE
pgjglhoepfaaaa	FALSE
pgjichhblgaaaa	FALSE
aaagmommempakko	TRUE
aaajfhednkagenp	TRUE
ajjcgdemgnlgoao	TRUE
ajjkppmnknhiibp	TRUE
bdlnjhelhlgbkck	TRUE
bdlnnimeeakpepi	TRUE
bnfdheppjacbcgg	TRUE
bnfociijckajplg	TRUE
cgklbflanihlbpg	TRUE
cgljcajedcgenlh	TRUE
dbapdkbghhfjpkl	TRUE
dbcmcbkkbkpcfoh	TRUE
dlceeeiakcigkml	TRUE
dldkegmmfeejmnb	TRUE
ehemhgepmaeiock	TRUE
ehgepllealpbddp	TRUE
fcnpfbehhgjlnmk	TRUE
fconedffkpaclmk	TRUE
fnafimeekjjjclo	TRUE
fnbnipajfcagfna	TRUE
gibogcceeifmddd	TRUE
gieejefojgjkclf	TRUE
hdaehohecbedhmd	TRUE
hdajdgjfilejkko	TRUE
hmjnpgoobmhjnjk	TRUE
hmkoddoknoacppl	TRUE
igilaiglkdkgbio	TRUE
igkljgbeillnbej	TRUE
jafamhmfddeohjl	TRUE
jafpiimekaecabc	TRUE
jkoaonkcobgchga	TRUE
jkolboebhmfbmmn	TRUE
kfaaecfghfhblod	TRUE
kfcddhfoofejjlc	TRUE
kpdmhacmahjmiek	TRUE
kpdpmpdfealdbfp	TRUE
liobbhlajomgjnf	TRUE
liopabchgjnolcp	TRUE
memfmoeeeifmgnn	TRUE
menobkiaakplfad	TRUE
mokiiogommncdfi	TRUE
molpihgofdkhcnp	TRUE
nipndeadahmknmi	TRUE
njaipkoefeojhcm	TRUE
ocioohggndbeocl	TRUE
ocniefmcehfalap	TRUE
omliimmdlnekhmf	TRUE
ommfcgphbiplnfk	TRUE
pfnlnfcolpojkoe	TRUE
pfnnlcaikmddecg	TRUE
aaagmommempaaaa	FALSE
aaajakkofheaaaa	FALSE
ajhplbpchpeaaaa	FALSE
ajiljfecocoaaaa	FALSE
bddgdpbajedaaaa	FALSE
bdehfplcpbdaaaa	FALSE
bmiklfmpcimaaaa	FALSE
bmimldmbmjmaaaa	FALSE
chgifgdcekkaaaa	FALSE
chglmocnaciaaaa	FALSE
dbflobfbdafaaaa	FALSE
dbgjmmhggokaaaa	FALSE
dlngaheegceaaaa	FALSE
dloiigoljanaaaa	FALSE
egjhmppjpbdaaaa	FALSE
egkgidaggalaaaa	FALSE
fdcekekhbapaaaa	FALSE
fdciahkiobjaaaa	FALSE
fnbnhhjjifjaaaa	FALSE
fncepbnceilaaaa	FALSE
gijdekopffaaaab	FALSE
gillihibadeaaaa	FALSE
hcndcpncfjcaaaa	FALSE
hdaeobogkbeaaaa	FALSE
hmfbiokmoobaaaa	FALSE
hmffgcoeghkaaaa	FALSE
igeffbigloeaaaa	FALSE
igfbfdciidpaaaa	FALSE
jakididjbnhaaaa	FALSE
jakijholichaaaa	FALSE
jkmndnlaboaaaah	FALSE
jkoeheaphgcaaaa	FALSE
kfehdllinlgaaaa	FALSE
kfenlpehmodaaaa	FALSE
kpccafpbbjnaaaa	FALSE
kpdnapamipoaaaa	FALSE
ljlhckifdedaaaa	FALSE
ljlkadbekijaaaa	FALSE
mffeaimbgnkaaaa	FALSE
mfgigffaohiaaaa	FALSE
mofaiadjmhgaaaa	FALSE
mojkjcghodlaaaa	FALSE
njbbnfhogdbaaaa	FALSE
njbfifngikoaaaa	FALSE
ocnbabeaennaaaa	FALSE
ocomigcagfcaaaa	FALSE
omfggkofmplaaaa	FALSE
omfjjenfcckaaaa	FALSE
pfoflfdpjlaaaak	FALSE
pfoobmmkfonaaaa	FALSE
aabficjdifjpjmcd	TRUE
aacbhledkpmagmib	TRUE
akbkibgdbhioihpc	TRUE
akbmloeckoogdnap	TRUE
bedhoamnidccjbkj	TRUE
befbhhnpgaecmeme	TRUE
bnpocjcigmaejpmd	TRUE
bobnbdaggmhbdonp	TRUE
ciaeolocngibkhck	TRUE
ciahgiijlhbhocde	TRUE
dcbokmioebfpjhpi	TRUE
dcchojlbofnchbeg	TRUE
dkpjehblhfodghgb	TRUE
dlagofobmcpfedkn	TRUE
efgklnifokeeighg	TRUE
efhkbnpmpkpgefag	TRUE
ephbfiapjpiincmh	TRUE
ephddmkgkdkboepo	TRUE
fjnhlikbgaodilnp	TRUE
fjomgmjemkkabjop	TRUE
gdhnghfnenajffkb	TRUE
gdlceihdaehlaale	TRUE
gpjhighfoecanlel	TRUE
gpjmejbcmadehdhc	TRUE
hkcjpgenebldkbap	TRUE
hkclbahggbaicncm	TRUE
iemaabafhlpjhojm	TRUE
iembncfmjfnppnjj	TRUE
iooeoadobficcfkm	TRUE
ioppmbfhpgmiajnd	TRUE
jjfnkcibnbfbmgdp	TRUE
jjhocejjpjpjphig	TRUE
kdljmcgpoejgccol	TRUE
kdmapnmgnjofgfgj	TRUE
kojjmemdkhobjeik	TRUE
kolhpdlcpoiokhpo	TRUE
ligdcgokljgegefm	TRUE
liglepjjogglhgne	TRUE
mdlknaonemejadch	TRUE
mdngodeafjkbobdk	TRUE
mnkgbpebcjimmcoe	TRUE
mnkifmhmcdlhjfmc	TRUE
nhmikoeapobmoapi	TRUE
nhmipanoedacljhb	TRUE
objkkghldljnpejg	TRUE
obkdmahcnldcoabc	TRUE
okpffpmfahfihbom	TRUE
olcfackpocldlneg	TRUE
pfjpmlimaklhbiim	TRUE
pfkocaapookchlfb	TRUE
aacihbdnbdfjaaaa	FALSE
aacnamplnakdaaaa	FALSE
akdplccklobeaaaa	FALSE
akehbcoiaaneaaaa	FALSE
bepoajmdnencaaaa	FALSE
bfajmmahgmdmaaaa	FALSE
bpdnmlaaijilaaaa	FALSE
bpfbmkbaophdaaaa	FALSE
cjfljhdieikbaaaa	FALSE
cjfncndbnhllaaaa	FALSE
debapmohlfodaaaa	FALSE
deckihledkegaaaa	FALSE
dnjnednbghmnaaaa	FALSE
dnlhielmdaieaaaa	FALSE
eikgjhjknghjaaaa	FALSE
eimiagefmjloaaaa	FALSE
fbfdjdbbadnjaaaa	FALSE
fbfmbdlkcodhaaaa	FALSE
fldlenpdmbepaaaa	FALSE
fldmhdblnafkaaaa	FALSE
geomdckpohenaaaa	FALSE
geonebnnbhkbaaaa	FALSE
gopnkcbimagiaaaa	FALSE
gpcihmjhhbijaaaa	FALSE
hjjlkmpmnbfiaaaa	FALSE
hjldlnflafjbaaaa	FALSE
ickncmfjggdcaaaa	FALSE
iclaholdaoblaaaa	FALSE
imfllohjefilaaaa	FALSE
imfmhnmkfjgfaaaa	FALSE
jfoaglfjagepaaaa	FALSE
jganhbieemmkaaaa	FALSE
kaddmaffgdlgaaaa	FALSE
kafdcflakanhaaaa	FALSE
kkgidiadidjhaaaa	FALSE
kkhdpjbekboaaaaf	FALSE
lfepdmifggbhaaaa	FALSE
lfhkdhajeachaaaa	FALSE
mamocededkohaaaa	FALSE
manaicfnfcflaaaa	FALSE
mloejajdpndgaaaa	FALSE
mlpcheddmlimaaaa	FALSE
nflkjekfgmmbaaaa	FALSE
nflpmbmheeciaaaa	FALSE
npdaejmpfhaaaajk	FALSE
npdfcmnmgedkaaaa	FALSE
ojmhnojdifgbaaaa	FALSE
ojmndcepbbloaaaa	FALSE
pekleilnhihaaaaj	FALSE
peljaikeakhnaaaa	FALSE
aacihbdnbdfjampln	TRUE
aacnakdejimgeopch	TRUE
akcmgmbakofjfpofa	TRUE
akcmieidlofihieji	TRUE
bdonnboddakfmpppd	TRUE
bdopjaeemklnaidgf	TRUE
bpfngokddhoadplho	TRUE
bpgahdobfpjkaikga	TRUE
ckbbpcfmeciihipkb	TRUE
ckdgaebpnnnmjlklh	TRUE
degganomafikggklj	TRUE
deggibomcebnkojdl	TRUE
dohilflhicofpegjb	TRUE
doijhhfbbkhknpopm	TRUE
ehpkkckndjimaolpf	TRUE
ehpocpfneejpefpje	TRUE
fbjhlmcllafackkka	TRUE
fbkfgkidkhbblihkg	TRUE
flfbjdfjodnbnnibb	TRUE
flfdfkjbhoogfined	TRUE
gfcdpmdmklhldpmfe	TRUE
gfcghehdfmilckhdf	TRUE
gpbdfhlejijoddkjm	TRUE
gpcbpogommbnmmpcj	TRUE
hhhfnhcmbcnlcdcbo	TRUE
hhhhopipbpadbmcdk	TRUE
ibnpmcjpocbhobmak	TRUE
ibobecpchhihbeikc	TRUE
imeohpekefaoebafg	TRUE
imfbhegnfhkhlpicn	TRUE
jfejlnoiccojopggf	TRUE
jfenbhcmdegbgiahd	TRUE
kadepoibecmjanlfm	TRUE
kadhkmfmeiplhgioi	TRUE
klbocjieadmakgcdi	TRUE
klcjcclpfkbbpmdmd	TRUE
lfmckmobpkdpgmnbb	TRUE
lgccplnjmahamlkko	TRUE
malcadnmiocncfbmo	TRUE
malggcldfcbcdkpni	TRUE
mlmmdnpdhbjobhilg	TRUE
mlngadgplclokifkh	TRUE
nfidmggkgenfjeaeb	TRUE
nfjbpjoahbmeacjbb	TRUE
npfkeclcnfgdnicbf	TRUE
npfnffpclnkbnpndc	TRUE
oindopaddfilagdmd	TRUE
oinhkfackkpbfllmb	TRUE
pembpcpnachppbpkm	TRUE
pemfiongiiljgbaoi	TRUE
aaabhngfdcjmcaaaa	FALSE
aachpimadlkgbaaaa	FALSE
alabgjgkffmphaaaa	FALSE
albdhaajphihhaaaa	FALSE
bfippcipnolnbaaaa	FALSE
bfleeidihginlaaaa	FALSE
cajmmnjgkmdkpaaaa	FALSE
camfnibngkfkcaaaa	FALSE
clpflongljeooaaaa	FALSE
clpjnjmanjfpkaaaa	FALSE
dhijdmngjpfmaaaam	FALSE
dhjijmhljjeffaaaa	FALSE
ecceaoobhhociaaaa	FALSE
ecchndagnbgjdaaaa	FALSE
emdgdcmbkednhaaaa	FALSE
emdlaaldeheikaaaa	FALSE
fgdeelnpefgodaaaa	FALSE
fgdikafkobkldaaaa	FALSE
galpdpgbnkbecaaaa	FALSE
gamgghiadajieaaaa	FALSE
gkiebaabkjgjjaaaa	FALSE
gkiiflohedljlaaaa	FALSE
hemjekegjlbdjaaaa	FALSE
hemjmnihgmijbaaaa	FALSE
hpenlcegniokdaaaa	FALSE
hpffmhioddpdfaaaa	FALSE
ijmkeplmaonaiaaaa	FALSE
ijocmcnndiojiaaaa	FALSE
jeblbnmgibeooaaaa	FALSE
jeccibeheodfdaaaa	FALSE
jopnnchkobjdjaaaa	FALSE
jopoackkdijneaaaa	FALSE
kifgbdklegneoaaaa	FALSE
kifpljoagffdcaaaa	FALSE
lcilkhponbpkaaaag	FALSE
lcinnkoioagfcaaaa	FALSE
llpjnfkeppmgkaaaa	FALSE
llpmjmdmcadgbaaaa	FALSE
mejpiebnfogecaaaa	FALSE
melbgpgjbbclpaaaa	FALSE
moloimpiolhoeaaaa	FALSE
mooggmljjfhkdaaaa	FALSE
niicmdbdkccdgaaaa	FALSE
nijdddgfmhlfmaaaa	FALSE
ocoilaijjbfkpaaaa	FALSE
odbldcjpddohlaaaa	FALSE
omjaojkkabeklaaaa	FALSE
omkjmkhbgbehfaaaa	FALSE
phljiiijcmiioaaaa	FALSE
phobddnaknoedaaaa	FALSE
aabaidlgeoocnbglgd	TRUE
aachoopomikildgfgc	TRUE
akfnkfpbofadachjon	TRUE
akglfpfdfenlgkchjd	TRUE
bfpdfnpmldjocafjdg	TRUE
bfpibdghocagecihhb	TRUE
bpjecelenmkblbafnd	TRUE
bpjehonijbfhkjlcdl	TRUE
cimoclamiialpnnpkc	TRUE
cincjjmfgomfndidof	TRUE
dcjmcaebkdombciagd	TRUE
dckmcbelgoieppmpji	TRUE
dmajniejkgfklmfmmd	TRUE
dmbachnoimibnbkmob	TRUE
ehaehabajohmbnfokf	TRUE
ehafamoadmmpehcbpd	TRUE
fbdbgpaeafbncbojhg	TRUE
fbdefjljhhcgldhkip	TRUE
flkdlncgeeedmkjpge	TRUE
flldlodaebhhjboofa	TRUE
gfkhhhenldkpeagonj	TRUE
gfmgnllngjpiemadfb	TRUE
hafjmfibichfhdlpgd	TRUE
haflndapbihmdhmgcg	TRUE
hkmjibhnmhkocagedf	TRUE
hkndmkedcckjegohkl	TRUE
ifigeglnedknojdmkk	TRUE
ifignmofhglgjcdmce	TRUE
iphnnpogmehlkjelgh	TRUE
ipieopgmdamcfonagc	TRUE
jkekdeehgcddfobcbh	TRUE
jkfdpocdinocmaghjl	TRUE
kdklllpppddnlkpobk	TRUE
kdodikmfabgciglhee	TRUE
knmafhcbcnepienomn	TRUE
knmclgoffhlfddnaap	TRUE
lifglljbhminnpjdjf	TRUE
lifpgelfnpadpkkldd	TRUE
mbklhbmbpfkealfblb	TRUE
mbnfpeebnfpkdcgkca	TRUE
mkpciahekmmmmdgdhh	TRUE
mlagmmndelojibeomf	TRUE
nelkajjpkhmlaolaog	TRUE
nelodhmpfikbcgkbip	TRUE
nnppakgkenkdhmbpap	TRUE
nobhkjghlafkbhgmnl	TRUE
ojbbhdgdomkjjpommn	TRUE
ojbconlmokjnjpcfem	TRUE
peeklpegjmcjfdhphj	TRUE
peflchjjickbkefppf	TRUE
aabaidlgeoocnbaaaa	FALSE
aacggdnhoopomiaaaa	FALSE
akhbkikmihlhbmaaaa	FALSE
akkgihfkdpajpdaaaa	FALSE
bfjlegbombilobaaaa	FALSE
bfkehgdjenapldaaaa	FALSE
bpdbfddngikeegaaaa	FALSE
bpelcmokeofkokaaaa	FALSE
cjfbfdjfciokkiaaaa	FALSE
cjgfnimaelnodiaaaa	FALSE
dcpncihfhpdjcdaaaa	FALSE
ddbkpgmcaonphlaaaa	FALSE
dmnacogjanmopjaaaa	FALSE
dmoaampkfbkakgaaaa	FALSE
ehhamojdgndceiaaaa	FALSE
ehhooepelgbnnnaaaa	FALSE
fbcmpkpcikmfjeaaaa	FALSE
fbdghgcemcjjjcaaaa	FALSE
flebkofbiaodkiaaaa	FALSE
flednopoajaejmaaaa	FALSE
gflkgpdhkfpfphaaaa	FALSE
gflmojmogphpldaaaa	FALSE
hageolkdlinbgmaaaa	FALSE
hahpkbiphbjcngaaaa	FALSE
hlgccgmhenglbkaaaa	FALSE
hlhfoiohlfipmbaaaa	FALSE
ieoldkpeagonjgaaaa	FALSE
iepnllngjpiemaaaad	FALSE
iphgdfdmncfbdpaaaa	FALSE
iphlglefmacgkcaaaa	FALSE
jjdncmblkfpanlaaaa	FALSE
jjhedbacfgagcaaaao	FALSE
kenepddjjnefepaaaa	FALSE
kenmpmmmbolngkaaaa	FALSE
koijfahpkofiiiaaaa	FALSE
kokhlhkmhcipoiaaaa	FALSE
lifpibfclmlfnjaaaa	FALSE
lihaaajkoeolpfaaaa	FALSE
mccpbgjpagbjjhaaaa	FALSE
mcdbmpjlmpeiocaaaa	FALSE
mmcjopcfopcdnoaaaa	FALSE
mmcnjkiccdmnnaaaam	FALSE
nenodjobkeaphhaaaa	FALSE
neokfncdkeielgaaaa	FALSE
noddadijidlicfaaaa	FALSE
nodgogpaihebcpaaaa	FALSE
oiilefihgcdbefaaaa	FALSE
oilaffeajajgioaaaa	FALSE
pehnfpnopoejdfaaaa	FALSE
peickpdcmidomcaaaa	FALSE
aaapjpmmhngkfdgaman	TRUE
aaappnhehhapoibkjek	TRUE
ajfkoblmaifhkacknim	TRUE
ajgbhceibalkcemmamc	TRUE
bcopbpebgdmdfbchkdh	TRUE
bcpplgcdbjlkbhindml	TRUE
bofgmomlmbfokiibimc	TRUE
bofipkgbeicaiadidaj	TRUE
cidbjlainpkojcopdcj	TRUE
cielibammkpaoodhdbn	TRUE
dcamacfefjginmaddoa	TRUE
dcbmlbmgdhegdipmdma	TRUE
dmohckocnbbbpjfigcb	TRUE
dmpehbmnlgnjdifnabf	TRUE
eieplaoipbmppjejdon	TRUE
eigfmmlaonlaboclefe	TRUE
fbcahomfhoikkacgogk	TRUE
fbcdmeaabnjgfjmgadm	TRUE
fkkodfcicepihdehldl	TRUE
fkldphpkpampdccmmna	TRUE
gfmmgakkjgeiniifmme	TRUE
gfmocdeaghapkaajkaf	TRUE
gpepggbpdclnjphhmpm	TRUE
gpghmoakjadodljlkki	TRUE
hkfmhgdealfkemidfnj	TRUE
hkhimohfdfngjjhhkop	TRUE
idpdpaejiedakmmokha	TRUE
idpnheiakipekdhamko	TRUE
iocoaanmgjcchfkdgno	TRUE
iodphpokhdnakefogpf	TRUE
jjbepadojlpijdfjnfp	TRUE
jjcdnadiblicibdniej	TRUE
kdjcmgipnncdmcegeme	TRUE
kdjlbbgfbndiikhhgan	TRUE
kpfbanikaidlgiccdbf	TRUE
kphhjjjagjbagcbikfj	TRUE
ljahhjnmplpgdaapbml	TRUE
ljdolmalbakmnccimlj	TRUE
mdlocmjdpepjigijbhg	TRUE
mdmncogodoeolikihcf	TRUE
moccciadcgkbdgjhfgp	TRUE
mocipenipcgbdaddfkc	TRUE
nigajclncaphcpjegjm	TRUE
nihgllckoebeedjaebb	TRUE
obgeocnelpokohifbgh	TRUE
obghgohaldbbppfkdki	TRUE
okpifgmogeabhjmnnom	TRUE
okpmbbnlhjlclgbigkp	TRUE
pfeonahgadcpogalnoa	TRUE
pffcdmkfabdmfjbjdjj	TRUE
aaahejfacldcnobaaaa	FALSE
aaamafdfgodfmhhaaaa	FALSE
akjnffojmjohcgiaaaa	FALSE
akkgklfbhpmpaokaaaa	FALSE
bfogbhgjjhhijlfaaaa	FALSE
bfookeofkacjhfdaaaa	FALSE
caamejmdonfkkfkaaaa	FALSE
cabnofngmcmikhcaaaa	FALSE
ckbgnmoefjoehjgaaaa	FALSE
ckddinihgicolibaaaa	FALSE
deokpmmjfcdkdlnaaaa	FALSE
deoolkkbioopibiaaaa	FALSE
doogilmneigodanaaaa	FALSE
doojaijbmheaokiaaaa	FALSE
ejahoadpphjcccbaaaa	FALSE
ejaphfdopenldmmaaaa	FALSE
fdfeffepfknghhmaaaa	FALSE
fdgdlkgfpmkhpajaaaa	FALSE
fnenphifjajbkjdaaaa	FALSE
fnfjkinmbhhofcdaaaa	FALSE
giebolhodddapakaaaa	FALSE
giecgnjogfcbifbaaaa	FALSE
hdkdglmfcfgpfmoaaaa	FALSE
hdkladmaecaapaoaaaa	FALSE
hndbahgdbblklniaaaa	FALSE
hndblcmgfameekhaaaa	FALSE
igjkomebenpalmlaaaa	FALSE
igjnjjgjcgkcdjbaaaa	FALSE
jakighkcmpnfdnoaaaa	FALSE
janaellahcnlbnfaaaa	FALSE
jmeocajmjokbjdjaaaa	FALSE
jmgenbobgmjbnbeaaaa	FALSE
kgdaenhiaboflcnaaaa	FALSE
kgehafplkcgmnocaaaa	FALSE
lagmfkknhegifphaaaa	FALSE
lagojegjclhfncnaaaa	FALSE
lkhnhohdkmfcdflaaaa	FALSE
lkibldfkecijbmkaaaa	FALSE
mebonlkcloonhkeaaaa	FALSE
mecljmkakpogmmiaaaa	FALSE
mogmekofcjgcnllaaaa	FALSE
mogofeghbabgmblaaaa	FALSE
njeeeeonfhhplhfaaaa	FALSE
njehefodkehcgaoaaaa	FALSE
ocaagglopdncdfeaaaa	FALSE
ocamaeikgoeceioaaaa	FALSE
olfeeleoedclbcpaaaa	FALSE
olfmkjlgfkgleeiaaaa	FALSE
pfhdolegbakjocbaaaa	FALSE
pfheefoiiheggamaaaa	FALSE
