aabngjilbb	TRUE
aacnhnkfbb	TRUE
alndaamhbb	TRUE
alpfiefpge	TRUE
bgfkhjnfei	TRUE
bgfocmkgme	TRUE
cakbbiegll	TRUE
cakccnkpcf	TRUE
ckninapgpk	TRUE
cknpodhjol	TRUE
dfakplhadm	TRUE
dfaphgpdlf	TRUE
dpmfolaoke	TRUE
dpmnieiijb	TRUE
ekhhffapea	TRUE
ekhlhideie	TRUE
ffeligoblh	TRUE
fffkfiokhf	TRUE
foljbmombf	TRUE
folkaoaabb	TRUE
gjbmobjfkj	TRUE
gjboaioaih	TRUE
hcleadnena	TRUE
hclilpjcio	TRUE
hmnhinhoap	TRUE
hmnmbimeie	TRUE
igjmgpejnp	TRUE
igmlhcpddc	TRUE
jagcpdebbk	TRUE
jagfapjjdj	TRUE
jkeddafmop	TRUE
jkfdfkeime	TRUE
kealfocahm	TRUE
keamanhkki	TRUE
knmhpkbhje	TRUE
knnababgij	TRUE
lijpggneml	TRUE
lijpijccde	TRUE
mckganlnfd	TRUE
mckmffffbm	TRUE
mmihkdkpog	TRUE
mminifipoa	TRUE
ngjklopmcj	TRUE
ngkhbmamki	TRUE
obenlhlmng	TRUE
obfahcekhi	TRUE
omeakcjjol	TRUE
omedfflbia	TRUE
pfodmbngbi	TRUE
pfojabeblm	TRUE
aabmbmeaei	FALSE
aabpjalkpd	FALSE
akklacgiaa	FALSE
aklengplaa	FALSE
bgkcoihkaa	FALSE
bgknpmbcaa	FALSE
bppaiobcaa	FALSE
bppmplheaa	FALSE
ckkpicgjaa	FALSE
cklefkikaa	FALSE
dfbpojliaa	FALSE
dfeklmbhaa	FALSE
dpokgfpdaa	FALSE
dpoknnflaa	FALSE
ekbnoldhaa	FALSE
ekbollnmaa	FALSE
fddnmblpaa	FALSE
fdegihpfaa	FALSE
fobakopfaa	FALSE
fodldkbnaa	FALSE
gidmhggnaa	FALSE
giebjgjcaa	FALSE
hbnbpmegaa	FALSE
hbncloepaa	FALSE
hmfpgahbaa	FALSE
hmgopcpkaa	FALSE
igcajfpkaa	FALSE
igehagnaaj	FALSE
ipmeolnlaa	FALSE
ipnakjpdaa	FALSE
jjkdhdaoaa	FALSE
jjkkbcjbaa	FALSE
kdnnlaigaa	FALSE
kdnpdgdcaa	FALSE
knmhlpooaa	FALSE
knmkjhggaa	FALSE
lhdpglclaa	FALSE
lhfeghacaa	FALSE
maiofmhdaa	FALSE
maiokddoaa	FALSE
mmcfcddlaa	FALSE
mmcmjceeaa	FALSE
ngclmcejaa	FALSE
ngcojoopaa	FALSE
oaedgfkgaa	FALSE
oaeghbamaa	FALSE
ojhkhfckaa	FALSE
ojicmapmaa	FALSE
pfhdncinaa	FALSE
pfhdniebaa	FALSE
aablbleaebb	TRUE
aaboijalkbb	TRUE
akffekdjdeb	TRUE
akflbbpfihe	TRUE
bgfjnhilami	TRUE
bgfojflmnco	TRUE
bpplmhekppg	TRUE
bppnbobgpkc	TRUE
clijjfccjdi	TRUE
cljaaebpnbb	TRUE
dfpbakemlak	TRUE
dfpbflnngfd	TRUE
dpnhdghapnl	TRUE
dppoflfihom	TRUE
ejnpngphpab	TRUE
ejobhecgkbe	TRUE
fdijdhbmgkc	TRUE
fdkldlfjfmj	TRUE
fnnombbgmdl	TRUE
foaggonjlbd	TRUE
gianemjjmne	TRUE
gibipnecmjk	TRUE
hbpeiijgcpj	TRUE
hbplikhbbja	TRUE
hmfooplaabb	TRUE
hmgdoljpack	TRUE
igkdfhhlinh	TRUE
igkooookiad	TRUE
iplgjjipjpp	TRUE
ipoiobcddml	TRUE
jjjckmaaibb	TRUE
jjmcpbklman	TRUE
kdgdffjcfla	TRUE
kdieeklabgf	TRUE
knnmpjlmidc	TRUE
knpakdkchai	TRUE
lgjbdeijjjg	TRUE
lgjcdlpeojf	TRUE
majdfehnflj	TRUE
majgenonmhp	TRUE
mlhedfgnmnm	TRUE
mlhjhmjejal	TRUE
ngbcnjalpcj	TRUE
ngbljchgeng	TRUE
oaglbalopfj	TRUE
oaheglcgejf	TRUE
okgmlfpmhhm	TRUE
okhmgpmmfob	TRUE
pfddklohjao	TRUE
pfdinlcpemk	TRUE
aabmbmeaeij	FALSE
aabpalkpdog	FALSE
akiobnghjaa	FALSE
akjaghdnjaa	FALSE
bfmaccmgeaa	FALSE
bfmacjdelaa	FALSE
bpnkejfdiaa	FALSE
bpongiooaaj	FALSE
cknfodjleaa	FALSE
cknohpofaak	FALSE
dfoijdjcbaa	FALSE
dfoomkcgaaa	FALSE
dpndmdpggaa	FALSE
dppgbhifiaa	FALSE
ejphhhlikaa	FALSE
ejpmdpmhfaa	FALSE
fddfbmpknaa	FALSE
fdeagjoooaa	FALSE
fnjinplegaa	FALSE
fnkjlhgblaa	FALSE
ghhgbcplhaa	FALSE
ghinkjljgaa	FALSE
hchpicjfaai	FALSE
hcihofmaoaa	FALSE
hmkjibekcaa	FALSE
hmkogkdhbaa	FALSE
iflhifikgaa	FALSE
ifmeebgibaa	FALSE
ipmmlhnanaa	FALSE
ipnfpclalaa	FALSE
jjpccdjpmaa	FALSE
jjphdgjgnaa	FALSE
kdblflacoaa	FALSE
kdcibmeojaa	FALSE
knjapgideaa	FALSE
knjbgiipjaa	FALSE
lhedeijhjaa	FALSE
lhfainkgfaa	FALSE
magaklhaiaa	FALSE
magnjdcpdaa	FALSE
mmbepophnaa	FALSE
mmekalhboaa	FALSE
ngnclhnmnaa	FALSE
ngnjpljfcaa	FALSE
oaipmapghaa	FALSE
oajfjibhdaa	FALSE
okcjbhflbaa	FALSE
okdakajfiaa	FALSE
pfecejgafaa	FALSE
pfelajfloaa	FALSE
aaaopegokjbb	TRUE
aabljlkennbb	TRUE
amgiglelbheh	TRUE
amhbjefcilol	TRUE
bgolnhifdmma	TRUE
bhaoelmlliib	TRUE
cbkcaeldcdgl	TRUE
cbkelbbmkdpi	TRUE
cljaplgjflbn	TRUE
cljdonidbkdj	TRUE
dflfeadkmlnc	TRUE
dfngnfdkgekj	TRUE
eabnmojefego	TRUE
eabpadopodoh	TRUE
ekkeakdkffan	TRUE
eklcbomnclgh	TRUE
fefopcadgohi	TRUE
fegiaagengbb	TRUE
fpicklapcolb	TRUE
fpjhefgglcil	TRUE
gkalggmncpeo	TRUE
gkccnkongoah	TRUE
hecdehmofkfg	TRUE
hedegcefjbjb	TRUE
hnlicpbkgdha	TRUE
hnmcapdocnla	TRUE
ihmdhnicjpda	TRUE
ihmhnfekbojh	TRUE
jbadiidkkkhh	TRUE
jbajpimjbikg	TRUE
jlckaahkbnbb	TRUE
jlckjcfikoef	TRUE
kepnpjombkfe	TRUE
kfakccebcbho	TRUE
ladahmoemphl	TRUE
ladcemcccgdp	TRUE
lkfbofmcgmbg	TRUE
lkfclfddgamk	TRUE
mebnadcobcmf	TRUE
mecfkdefjgma	TRUE
mnkdnhaknmlm	TRUE
mnkkgondnekg	TRUE
niakffmldkfe	TRUE
nibgekeeamdb	TRUE
oclppijgkhdj	TRUE
ocmehdeelgea	TRUE
okkbfipaljdl	TRUE
okkjpaonpkbc	TRUE
pfegdldnkeha	TRUE
pfepolfnknib	TRUE
aaaopegokjlj	FALSE
aabmkennnlon	FALSE
amhhcnnohmaa	FALSE
amidhlhdbmaa	FALSE
bhelocokilaa	FALSE
bheoammbafaa	FALSE
cbigfmeoabaa	FALSE
cbkoghbilbaa	FALSE
cllfdckbkbaa	FALSE
clmdjmklamaa	FALSE
dgaaaekmiinl	FALSE
dgbdecfhikaa	FALSE
eabajgddhkaa	FALSE
eacngagoanaa	FALSE
ekccgijendaa	FALSE
ekcjaplhlgaa	FALSE
ffehpaiaopaa	FALSE
ffelddknmmaa	FALSE
fpeigdkaodaa	FALSE
fpejdhkpncaa	FALSE
gkdggijohjaa	FALSE
gkeolmbfdgaa	FALSE
hdmaidddegaa	FALSE
hdmfhedbchaa	FALSE
hodekkhmogaa	FALSE
hodgghbodmaa	FALSE
ihpajjkenfaa	FALSE
iiacpohfnhaa	FALSE
janfohibggaa	FALSE
jangfnjopjaa	FALSE
jldlndljgjaa	FALSE
jldmmoimlbaa	FALSE
kfbdodgbijaa	FALSE
kfcjfclhkoaa	FALSE
lacnkdfigoaa	FALSE
lacpffdcbhaa	FALSE
ljoanjaokhaa	FALSE
ljpdaobnbfaa	FALSE
mefcpljefdaa	FALSE
meffpjfgadaa	FALSE
mnfepibjpiaa	FALSE
mngaipaelkaa	FALSE
nibdbijeklaa	FALSE
nibmaafmigho	FALSE
oboomajpdhaa	FALSE
obpdkojcklaa	FALSE
olcenchoooaa	FALSE
oldhdghagdaa	FALSE
pepndnafnhaa	FALSE
pfaljeolofaa	FALSE
aaahkmfgmolbb	TRUE
aabkenoffijbb	TRUE
aladmbbljhgla	TRUE
alambbmhooofc	TRUE
beofmcahhibmj	TRUE
bepofeikkiiod	TRUE
bombhmfcihela	TRUE
bonafijikjpde	TRUE
cjhpbfhegiene	TRUE
cjiofahdhneip	TRUE
ddomlofomhbkj	TRUE
ddpbmbclibkgo	TRUE
dnfgppdeifjga	TRUE
dnglfhnhaplpc	TRUE
eggnhbogfnpaf	TRUE
egikpifkllpkg	TRUE
fcahhkekdhkgm	TRUE
fcbdpbkeookek	TRUE
fmebcblgnhljh	TRUE
fmeokbjnlfpbc	TRUE
ggmngdjnenbcp	TRUE
ggogepeijdldk	TRUE
hbmnopgbdjlmg	TRUE
hbnjlmjidihle	TRUE
hleleilfiklmd	TRUE
hlfghcdnhakah	TRUE
ifhnnabkaaibb	TRUE
ifjhnbacmdddm	TRUE
iolmfofflfoom	TRUE
iolpapdpkipfo	TRUE
jjbepbpkikifa	TRUE
jjbllhpgphimi	TRUE
kddihlpmffgll	TRUE
kddkaocfihlij	TRUE
knficfljmboii	TRUE
kngeapcgcgbbm	TRUE
lhiendnkooblc	TRUE
lhjcldhoegain	TRUE
mcgbonlajopgm	TRUE
mchhkmenpgbgn	TRUE
mmngcafjopjcj	TRUE
mmpejkaamabbb	TRUE
ngmkeinjcoghm	TRUE
ngngockccofeo	TRUE
obfeflngehglj	TRUE
obgceeoacfmek	TRUE
oljkcljgebgah	TRUE
olkekohbmoedo	TRUE
pgidbnjaoohfi	TRUE
pgjpolnadeiam	TRUE
aaahkmfgmolke	FALSE
aabooffijalbp	FALSE
aldkpnalfbaal	FALSE
aldogbajapcaa	FALSE
bgaecpclcieaa	FALSE
bgagofbjjhoaa	FALSE
booddpjacinaa	FALSE
bopgncnfaeeaa	FALSE
cjfklppooobaa	FALSE
cjhahpmjgpoaa	FALSE
ddnkhenmimlaa	FALSE
ddnnnidbcckaa	FALSE
dmnpidgbdnjaa	FALSE
dnaaoiaelbfei	FALSE
ehajeigodcaal	FALSE
ehambfopklpaa	FALSE
fbjmenkmdjcaa	FALSE
fbjojmciejbaa	FALSE
fmbenpaodfaak	FALSE
fmckppipfdhaa	FALSE
ghcfckpmpihaa	FALSE
ghdnkpajgflaa	FALSE
hbihcmmgbacaa	FALSE
hbjlcgakancaa	FALSE
hlepcfmjlhkaa	FALSE
hlffjpclcboaa	FALSE
ifjoahnhagjaa	FALSE
iflagibjnfmaa	FALSE
ipbljadanboaa	FALSE
ipccgggpanhaa	FALSE
jjdlocbgafdaa	FALSE
jjdojjakgbeaa	FALSE
kdelokklnioaa	FALSE
kdfabcabfomaa	FALSE
knejoijbdhbaa	FALSE
knemanjckomaa	FALSE
liglpcfjfgmaa	FALSE
lignhomncbkaa	FALSE
mchphjehjbfaa	FALSE
mciilpfgefgaa	FALSE
mmheijmohfhaa	FALSE
mmhfohdinidaa	FALSE
ngjdpenojmnaa	FALSE
ngjhhfddcdnaa	FALSE
obkgcpoobolaa	FALSE
obkpibmbjgoaa	FALSE
olnjkddfefmaa	FALSE
olnloagjdojaa	FALSE
pgcggndpdidaa	FALSE
pgdnepibiehaa	FALSE
aadfkjdoabpdbb	TRUE
aafgfemohfkgbb	TRUE
aldnkbihpanbpl	TRUE
aledkenibpcike	TRUE
bfdifhdphnogfa	TRUE
bfdklebdimejao	TRUE
cadifmcnjnfmep	TRUE
cadkckfkbkoigk	TRUE
ckekmejlfgafbi	TRUE
ckfjhcefabcijg	TRUE
ddpikhhagpelda	TRUE
deacgdlmcnjacn	TRUE
dojdcnfjnonicm	TRUE
dojndpppkijdbp	TRUE
eiikapgnefgjbk	TRUE
eijjdjkifamjga	TRUE
fdbfojomlfpedf	TRUE
fdcndjcbaeeajl	TRUE
fnpdbggkecgakk	TRUE
fnpmchancdaclf	TRUE
gggkijgfdhefhh	TRUE
gghchiimbenbmn	TRUE
hagjmbnlaamgbb	TRUE
haiadaoeehdfkh	TRUE
hkjodfmdlnjonm	TRUE
hkkmdcnockhhgm	TRUE
ifagafelmjjmcd	TRUE
ifajdchhicbbgj	TRUE
ipaphpelbaggon	TRUE
ipbjalgahjlicn	TRUE
jjkccdkeekjpga	TRUE
jjkcohcgajakem	TRUE
kealnkoppehjme	TRUE
kebcnaehahgnjd	TRUE
kncnjjfdlhndim	TRUE
kndgkodefdcgba	TRUE
lijghbidfjgneg	TRUE
lijianfldfkknk	TRUE
mdddcpgdihoifk	TRUE
mdhaekkcpnjnee	TRUE
mnklpmempjabag	TRUE
mnllneonhhpjnh	TRUE
nhndbnbceimfog	TRUE
nhngmanekffehh	TRUE
ocadohbgfcfalh	TRUE
ocafdfhjodghgo	TRUE
omfdpclehldcha	TRUE
omfglnphbnodcb	TRUE
pfimahoonpbcnl	TRUE
pfiniolhocilgn	TRUE
aadfkjdoabegfe	FALSE
aafmohfkgnpmbf	FALSE
alcdinhikkdbaa	FALSE
alceeaoliaijaa	FALSE
bfppgmblkpobaa	FALSE
bgcabigninchaa	FALSE
cabepdgbnlmiaa	FALSE
cabifggpnpdiaa	FALSE
ckkkoaahijnmaj	FALSE
cklipefogecmaa	FALSE
dfbdpeaoabikaa	FALSE
dfbmhhfbcomhaa	FALSE
dopcindfgadjaa	FALSE
doplfahcalgmaa	FALSE
ehmnenooijdgaa	FALSE
ehnklhimemjiaa	FALSE
fdidbijpjiclaa	FALSE
fdjdnfpihbinaa	FALSE
fnimniaglpalaa	FALSE
fnkpnfgbmailaa	FALSE
ghgfdcekdecbaa	FALSE
ghhmgpgbilgiaa	FALSE
hakgmfmjgegbaa	FALSE
hamnmghmnigkaa	FALSE
hkgmkkjfedjpaa	FALSE
hkhmkkifnncpaa	FALSE
idonpioebgkeaa	FALSE
ieakoapafoefaa	FALSE
ipaaflcfojdpmc	FALSE
ipagggbdebpfaa	FALSE
jjipnmikmlgkaa	FALSE
jjlihoimogeaae	FALSE
kdhplolcblpgaa	FALSE
kdiidaigmlniaa	FALSE
kmijeadjloejaa	FALSE
kminonhgmnimaa	FALSE
libnandfjimpaa	FALSE
licaiebgnjcbaa	FALSE
mcnhmlomcgiiaa	FALSE
mcpcighomoadaa	FALSE
mnlhcggpldaaii	FALSE
mnlhiihcbipgaa	FALSE
ngkolnfgfmmiaa	FALSE
ngnbjgmpmepeaa	FALSE
ocbjhmeijleaao	FALSE
occhkponolcmaa	FALSE
omifopdjhognaa	FALSE
omiiplmhdljgaa	FALSE
pgepiikjmmpbaa	FALSE
pggmlebggnbaai	FALSE
aaadeaepinkogbb	TRUE
aaaooemcdkkjabb	TRUE
aldmcbcdaflilbi	TRUE
alegpilhmdpecdn	TRUE
bgblbcdoflikmkl	TRUE
bgbmgmapilnifck	TRUE
bpiofhimnladkhj	TRUE
bpjijdilemiibif	TRUE
cimjppickimigdm	TRUE
cimmnpflihhojio	TRUE
dbphjjlgklmpkjd	TRUE
dcafdicmjlgnena	TRUE
dnelmphbbiadimd	TRUE
dnemkppafojfnfc	TRUE
egmldeknbcbohna	TRUE
egnckokbbgfldno	TRUE
fbeiombepbkpbcn	TRUE
fbfcilcbboogoeb	TRUE
flhekoncgkahdod	TRUE
flhlllailcanpoh	TRUE
gfipndmghgkeadg	TRUE
gfjbonebppkfijg	TRUE
gploinljmamoaec	TRUE
gpmcmcgbjkoaibe	TRUE
hlblldbmgnfnohh	TRUE
hlbmglelgfbobbc	TRUE
ifdgnglhbooapcc	TRUE
iffbpfokmobinpd	TRUE
ioolcibhnhgkodj	TRUE
iopehbgnegijofk	TRUE
jiapifbjcbibgch	TRUE
jibmghejbgicmhg	TRUE
kciigfeibdklkeg	TRUE
kciimbcdkhjodbe	TRUE
kmfdadnecimojgi	TRUE
kmgjikokpoamgfm	TRUE
lfkiajnbkapfngp	TRUE
lfkojpjcmbjpmmg	TRUE
lpjmcoofncpbnhj	TRUE
lpkclfcjddakcfn	TRUE
mjfmiamkjjjijaf	TRUE
mjgfililepldcbc	TRUE
nfapkgciodbmaof	TRUE
nfcajcfanhghcjm	TRUE
oaaffkkkpfjdmbb	TRUE
oaahjagkingejbb	TRUE
okilmioclmhaabb	TRUE
okjghaiomkcmbdj	TRUE
pemhikbpmmlklel	TRUE
penpglifjonkgdo	TRUE
aaadeaepinkogoe	FALSE
aaaomcdkkjakecg	FALSE
aleodadakiohmaa	FALSE
aleohonbamipiaa	FALSE
bgcmeeknkbnnlaa	FALSE
bgefbfggmmdenaa	FALSE
bpgeekgmbicbkaa	FALSE
bpggoknhgncbeaa	FALSE
cinbdiognbaeoaa	FALSE
cinjailpgjfcdaa	FALSE
dbmcadljedahdaa	FALSE
dbpfolfljchfhaa	FALSE
dmiemmijcjogjaa	FALSE
dmihifcpjohadaa	FALSE
ehlafgckpfllcaa	FALSE
ehlifihopoioiaa	FALSE
fbdpkcbicchffaa	FALSE
fbgaemeejajbfaa	FALSE
fmblcdcppigmjaa	FALSE
fmblklgbmacfgaa	FALSE
gfceichfkdfmhaa	FALSE
gfdcgjlappkonaa	FALSE
gplgehldamfibaa	FALSE
gpmfjefbmleccaa	FALSE
hkciimkefkbmiaa	FALSE
hkdciihneihmiaa	FALSE
ifkmhabofhhhhaa	FALSE
ifkofabiajpddaa	FALSE
ipaokjmgielfgaa	FALSE
ipcajagplndcfaa	FALSE
jimabhpmnjdpcaa	FALSE
jimmfdojiliggaa	FALSE
kdfhbmmjebgdfaa	FALSE
kdigfgpjamcaeaa	FALSE
kmkjmmplfpmfbaa	FALSE
kmkkhlhencljiaa	FALSE
lfhialoaddibmaa	FALSE
lfhihbcmofckeaa	FALSE
lpkgjjdhjgpmdaa	FALSE
lpkodcapgfpkjaa	FALSE
mjobehcpkkgmcaa	FALSE
mkdnelcaefohjaa	FALSE
neokejfhjaepcaa	FALSE
nephdkepgmpopaa	FALSE
oaahdhnagmojjal	FALSE
oabpjiapkajjpaa	FALSE
ojilfpdibgpfhaa	FALSE
ojlhochekdpnoaa	FALSE
penmanflajcfaan	FALSE
peohghcjmnpmlaa	FALSE
aaaockepnodbmfbb	TRUE
aacjjdhafcnmgkbb	TRUE
ajecjcfjmpbloaba	TRUE
ajecphjnnbkginkk	TRUE
bebbgnjecenlhdaa	TRUE
bebfdknlhomkjgba	TRUE
bokmgmjmhdmbafjo	TRUE
boncamhdfkkblbhp	TRUE
cjaplfiaigmhoako	TRUE
cjbddalagmkkgmkn	TRUE
dfboaiodbjegampf	TRUE
dfbpoifnlgjcpfcm	TRUE
dpdeblplpiabgkkd	TRUE
dpeggilpplednieh	TRUE
eiddkdghaiomnncd	TRUE
eidkpifmkaheidkn	TRUE
faofoifhmhklloka	TRUE
faoigmapjfnbmgfb	TRUE
fljecdmfofmndeph	TRUE
fljhdnfbanofcnec	TRUE
gelamoefpallbjhi	TRUE
gemajgbalkncdblc	TRUE
gpbgmkeloedcpbdc	TRUE
gpbihpfkapfpabec	TRUE
hjklbdjgfhdhdgpb	TRUE
hjkoiaammlgfggbb	TRUE
idjlpjpcojhpbjen	TRUE
idkagiehhpaknieg	TRUE
iogcicdjccdgeadh	TRUE
iogdlnofjdlipaoh	TRUE
jigkilpblepoihhn	TRUE
jigohdkhfgipkpeg	TRUE
kbpgnnijmhfjcope	TRUE
kbpgpejelmiihjab	TRUE
kmiokjfidjncklnh	TRUE
kmjlgdmbipfimnhb	TRUE
lglhcjflmidalbln	TRUE
lglnjhdhbphkpgpm	TRUE
mbmmhcgiobemnlig	TRUE
mbmogdjdndfbgegf	TRUE
mmhokhcgeeeopelj	TRUE
mmidddbjeemnaodb	TRUE
ngcnhlolldoihgbc	TRUE
ngefelfnnchflpio	TRUE
oalahdkojgnhpcbe	TRUE
oalecjlhlhoflbdl	TRUE
okobgdgipajcmmfp	TRUE
okohpfccgpjmgadi	TRUE
pemllcokjmfhlnbp	TRUE
pencgajdelbhijah	TRUE
aaafdknfcmaogbfa	FALSE
aaaonfdgaoaikkfp	FALSE
aknnchjhgefmblaa	FALSE
akpoenpjaammjmbk	FALSE
bfiifcmeiocmkpaa	FALSE
bfkddfgcbiiihaad	FALSE
bohfaekmagcdjlaa	FALSE
boifbcpnghpdbaab	FALSE
cjaeacmflpemibaa	FALSE
cjaijhlmaolhddaa	FALSE
dddjfgppalbpjbaa	FALSE
ddiljmjglpfcmlaa	FALSE
dnmgkopjaekndlaa	FALSE
dnoaoopcnchcdjaa	FALSE
ejagemmbldcdlnaa	FALSE
ejanmpigcnodciaa	FALSE
fcfnmcecndnclnaa	FALSE
fcggmhnblhbdgnaa	FALSE
fmoaejpkficcpoaa	FALSE
fmoajjhmcnihajaa	FALSE
ggikfmeoaninggaa	FALSE
ggjmmdfojlneecaa	FALSE
gppijbfphhknljaa	FALSE
gppmmeigbckgedaa	FALSE
hkmadndppbpboaaf	FALSE
hkmhbcodbcihoiaa	FALSE
ienligdbgoimccaa	FALSE
ieoibfdbnbpkekaa	FALSE
ipjcaggfjaepkfaa	FALSE
ipjpcbakpboekoaa	FALSE
jimfmhgnpdkaclaa	FALSE
jimkioilfinlibaa	FALSE
kcepgfankkiaeeaa	FALSE
kcgeanpogfknmdaa	FALSE
klkfmheiegkgpeaa	FALSE
klklenoghjjcegaa	FALSE
lfefgcljlekippaa	FALSE
lffjdpjpnhhnbjaa	FALSE
lpcnkiekehkamjaa	FALSE
lpdfigcebkhlbaai	FALSE
mjkpbfgidolbckaa	FALSE
mjkpmkphlmjhhfaa	FALSE
nffemhbcbacfopaa	FALSE
nfgjoobabmgdojaa	FALSE
npknocanchkehlaa	FALSE
nplglmnmehkfjhaa	FALSE
olccmdngpdnaeeaa	FALSE
olcogkpoilmpmbaa	FALSE
pgbpancbgmhfbmaa	FALSE
pgddakmjfhkkeaaa	FALSE
aaafdknfcmaogbebb	TRUE
aaaoanfdgaoaikkbb	TRUE
akpmbadnajmdbfana	TRUE
akpnighplhphffdpl	TRUE
benpiaklejolmaoap	TRUE
beodadoefkdccdbjo	TRUE
bpfdemoniighidgmj	TRUE
bphllgpmpddbhdfpf	TRUE
cjebfibbfcfllnigc	TRUE
cjfioehjjdpjndegc	TRUE
dceddbmkfceonohdh	TRUE
dceklcnfegfklihcf	TRUE
dnlgdililldiohhae	TRUE
doabcihgemfpaanbb	TRUE
eifhkfgmikjncjcha	TRUE
eifkeaodbcfcnmhhg	TRUE
fbmdcclbnoeamjpif	TRUE
fbnnmfalmfkihlngh	TRUE
fnapkjjokmkdekbgd	TRUE
fnbiadknjiolcikil	TRUE
ggkgbdcamadfgohpb	TRUE
ggkkfhnenpopipmch	TRUE
gpmiihhhijhhldfja	TRUE
gpmkijcdpbohgbkod	TRUE
hkhckhipogbcjccki	TRUE
hkhffhhgpmohlljij	TRUE
iejbigjoanfdkmodk	TRUE
iejoglkodcoblgnjo	TRUE
ipejjbgiihknfcimi	TRUE
ipemcbfkeikehkdpe	TRUE
jikpcfflhcbgbgphf	TRUE
jilehogcdfpginhia	TRUE
kcddfcgidfbaiblle	TRUE
kcdiokgbndcebegfd	TRUE
klfonnadboohkpagl	TRUE
klienimkmffiphpnl	TRUE
lfbdpjghmopnoknbh	TRUE
lfblbppgbimpfcokp	TRUE
lpcnklbekhecdfckk	TRUE
lpdmgmopckbnihibp	TRUE
mkhnaabpdmdimombb	TRUE
mkjllajbeeoenaeld	TRUE
nelnmhojhafcceggl	TRUE
nelpdclofoheceaem	TRUE
npkkmhohmknjmakak	TRUE
nplmklfceijjfjjod	TRUE
oldhfgbemobagpdmh	TRUE
olhgcokfebfoocdom	TRUE
pfmkckijlpmjnapgo	TRUE
pfohplpfbbcigfeoh	TRUE
aabiklpjdbgilmbkp	FALSE
aabmblccdfkpndddi	FALSE
akkpcniimbanaejaa	FALSE
akmdicokccnkdcdaa	FALSE
bgdggagnknkfimkaa	FALSE
bgffinhmeahokobaa	FALSE
bomddeoeiokhbllaa	FALSE
bonbhodjpildhkmaa	FALSE
cjhnelommibegolaa	FALSE
cjigndkccgiccbnaa	FALSE
ddjkfaglakfhfkbaa	FALSE
ddkjfoligpeflhdaa	FALSE
doljfdpcmgpmpjgaa	FALSE
domplplhchfoeahaa	FALSE
ejfkhjkhpffkggdaa	FALSE
ejfkoiechfmeadbaa	FALSE
fdmgpgnlnajgdlnaa	FALSE
fdmpemmneabigfhaa	FALSE
foaonclnghlbahiaa	FALSE
fobhoklokmogfleaa	FALSE
giljnppehekgphkaa	FALSE
gimnaiiajajpaniaa	FALSE
hbpkhphpmbnnhbpaa	FALSE
hcbpbgaeidipookaa	FALSE
hmcgniiigkjnhohaa	FALSE
hmcpogcjemaeljnaa	FALSE
igddcodlpepcpnoaa	FALSE
igflilnhpbgognbaa	FALSE
janlkomjbfhpehkaa	FALSE
janpcndlhfoegmjaa	FALSE
jkbadgddphmhhlcaa	FALSE
jkdjhkfgkdofplcaa	FALSE
kejmokcpmpcijkkaa	FALSE
kekbjmnagdcfpinaa	FALSE
kodfefcejjcnclfaa	FALSE
kodlmeaoifalldiaa	FALSE
lhbfafojokmfecpaa	FALSE
lhcabfiapokkkkcaa	FALSE
mbpmdaekipaoompaa	FALSE
mcaeccepdmngeciaa	FALSE
mlacmbpnfilhkpdaa	FALSE
mlcgebdgfbmmmhhaa	FALSE
nfgmjbiiakafcgnaa	FALSE
nfgppephabajgdiaa	FALSE
npmflhgdlafjdhkaa	FALSE
npnicihccicjfiiaa	FALSE
olicmgnmnnaecddaa	FALSE
olidehhoakakgkaaa	FALSE
pfcnicdmneminbmaa	FALSE
pfdflbcajlmpiokaa	FALSE
aaamccbfkofamoaabb	TRUE
aaaoogfdodkdllbmbb	TRUE
ajgajanmnieapfbhah	TRUE
ajiinmdphjmjbfafjc	TRUE
bdfeldkpdchdipngjo	TRUE
bdfihagglabglnphcn	TRUE
bnhcafipdkjpmihkpj	TRUE
bnhlnaeiddgakpjejd	TRUE
chhghggfpmcmnpgkho	TRUE
chjdodmakelhkgipdg	TRUE
dbacooeeedbjhljina	TRUE
dbcjchlhpcelijifmc	TRUE
dlanjkcndnoaeolneb	TRUE
dlbmlmninnlfcefblj	TRUE
efafciljeoejaiojko	TRUE
efbfjndkdldphmbpeg	TRUE
eonjafhjeclddhfaoj	TRUE
eonjdbnfjioekjafef	TRUE
fjjgihefcajnjomehe	TRUE
fjkkoiehalpeefiepa	TRUE
gefmfglgdifenkdcah	TRUE
gehajoknaadephaibb	TRUE
gpgbdokbfgpgpfdkbp	TRUE
gpgjioemphgneilpdh	TRUE
hjeajaconfdonkeibi	TRUE
hjfbeedebjifodgjao	TRUE
idkompemejegpcmoil	TRUE
idliimlfmngdeacinb	TRUE
ioepihdeomjhlmjlaj	TRUE
iofboaikfpdmhcimkl	TRUE
jhdifjmlhfonbcphpe	TRUE
jheeegjpegnbadhokb	TRUE
kbkdegfomoighoadle	TRUE
kbldkocjmgcdiiabbl	TRUE
kmbgcnbaleagbknbao	TRUE
kmcbhlnfcmojegocmf	TRUE
lgimajbhkcigiligki	TRUE
lgkjppfppeanbicoam	TRUE
maopcjikddnbehemde	TRUE
mbdancojmmglgaefaf	TRUE
mlinfoalhcjjghonjm	TRUE
mljnkbecnabcbjggea	TRUE
nfohgecjpgnnadoejo	TRUE
nfohiolafinmlhcjoa	TRUE
ocalkplhbmbgckelal	TRUE
ocbbabppdblpedflma	TRUE
oljhohjojhiiephhac	TRUE
olkfjjmdfjgfgmkcck	TRUE
pgijaacamamenoblbb	TRUE
pgikhgpmdiejaecfmb	TRUE
aaamccbgkofamoaaog	FALSE
aaaofdodkdllbnmjff	FALSE
ajdgapejgghcdblkaa	FALSE
ajdgpafkkpefjfamaa	FALSE
beikinhknjmdfjidaa	FALSE
bejanjfjpicfdkkgaa	FALSE
bnimmefbmjblelkkaa	FALSE
bnklacghbagijhbiaa	FALSE
chlppgbgpngfjhogaa	FALSE
chnbgmmdjljkdgijaa	FALSE
dbaddnjmjgnboimiaa	FALSE
dbchemjdbobhapdoaa	FALSE
djjinkjoeagcbjhbaa	FALSE
djlocgblhniemnjnaa	FALSE
eemldoedjgdkmeaeaa	FALSE
eeokjoglfmjfdnfgaa	FALSE
eoocjeomdhmfjmbcaa	FALSE
eoohlaoheaodmfojaa	FALSE
fidcechcpogkoigiaa	FALSE
fidjcbagcnglnlnhaa	FALSE
gdkcinohbapfbnanaa	FALSE
gdkkpmgpepeenhinaa	FALSE
gpejofiefieabidbaa	FALSE
gpfknglcflfoimmeaa	FALSE
hihpfddegmcniijpaa	FALSE
hiidpobonhojjimgaa	FALSE
idldmdldjpngehcmaa	FALSE
idmkbniojkicembiaa	FALSE
inpfdkfpaooobkjgaa	FALSE
inpglhhcbgolipmnaa	FALSE
jhhealkedfgmeeciaa	FALSE
jhhehbedheceopoeaa	FALSE
kbglcgkfkgdkcfhgaa	FALSE
kbicipaajdinnjmfbi	FALSE
kmeanhghnopimijkaa	FALSE
kmeifoefbpclfmmaai	FALSE
lgimpllgkdndfmhcaa	FALSE
lgioamkkbljcoaheaa	FALSE
makanjgpnaaahpllod	FALSE
makefaodmcbllgjcaa	FALSE
mlmacollknfepmcpaa	FALSE
mlokdpgnpnpjpbcoaa	FALSE
ngjkpoigafcfifijaa	FALSE
ngkmjknpllimfngaaf	FALSE
obhdijfljknanfelaa	FALSE
obhnnajdobekgcjnaa	FALSE
olijmlgegaipgkjiaa	FALSE
olilcncigjiikjjmaa	FALSE
pgkhpbnaofjjoikbaa	FALSE
pglgmikejplfagogaa	FALSE
aabnpmnepfdillfjabb	TRUE
aabodjmidmghhlimabb	TRUE
akapfeofeoimnlloiik	TRUE
akbcjdmbgkngbdlhjjf	TRUE
bdhnebejlofgmbkmenb	TRUE
bdidbpbooeogipejbnm	TRUE
bnchioakmnpllniccbl	TRUE
bncickndcbdgbmjljem	TRUE
cijcbcljhhdbpocdhfd	TRUE
cikeaknplcfapmkenfk	TRUE
dchidgfolndkbmbcmli	TRUE
dchoplokfnmgjcpbbio	TRUE
dmhjbeiiapfljboodfc	TRUE
dmijpacbiloofhpmaih	TRUE
eiacifingbcnfbipnan	TRUE
eibdchgjblplfanjhin	TRUE
fbaibpcnfknnegiapje	TRUE
fbamlfoillkfbenmgid	TRUE
flmjgjpgikicdcfbpmd	TRUE
flncfldpdnekfaanibb	TRUE
ggkfkbkiipndikfgfjg	TRUE
ggkogmgpebhjlklodoi	TRUE
hbmhihfhncohmnmjmbn	TRUE
hbmlloollgllkpfjbhc	TRUE
hllifdnlhhkcmiebnam	TRUE
hlmbipiagaalcamogbb	TRUE
ifhmikpkjkobfdeahhg	TRUE
ifllcfbkopmgkagcohf	TRUE
jbbnngnlfjmknnfckam	TRUE
jbdbofpdhihjbjgppck	TRUE
jlfnkpeklhjonebblnn	TRUE
jlgfmoegkpddklfheef	TRUE
kffmohmnldlbagmcpmd	TRUE
kfhjeegibhfhklhcjcb	TRUE
kocikdcpjkkgaieaehp	TRUE
kodieanpemdepdbnnmh	TRUE
lhlamceknpecfjfmgec	TRUE
lhpeljbgnecfleognpc	TRUE
mchbnamoemdknojcmbe	TRUE
mchfjbaeidalooompea	TRUE
mmpbkgenejjfkllcgpg	TRUE
mmpieacpbkcamaolfmc	TRUE
nhkkhinkbghlhidhcbn	TRUE
nhlikfapbgmdbfmfjnc	TRUE
ocbnoljdgioljihejoi	TRUE
occfdiphfhcehillele	TRUE
omdpcoepmfdjibfjefe	TRUE
omecccaonifjhgcpncb	TRUE
pflnblhlolhmjhnommk	TRUE
pfnbchnodjicghnocap	TRUE
aadlfoilfilmgbiahhf	FALSE
aadnnhmediongfichok	FALSE
ajofdaedgoejojlbjaa	FALSE
akbkafhobjbmcpadhaa	FALSE
benlajnppjddeclmiaa	FALSE
beoiphakfhpmoenbkaa	FALSE
bonhgmjfpodaaajgdgl	FALSE
bonklpelmmafebpimaa	FALSE
cimjfkkmfhnbgpjgbaa	FALSE
cimojigjgphfaiicgaa	FALSE
dcojcdjlmfmiadfldaa	FALSE
dcomgppdkmhfipjhcaa	FALSE
dnanecjnnjlijhlijaa	FALSE
dnbeckkadgdbhgcnpaa	FALSE
eiailodhpahgicdcaad	FALSE
eiakjlnadoeahimfiaa	FALSE
fdglpfggbepfoobdhaa	FALSE
fdhlhijnajknapejdaa	FALSE
fmmgmgdiagfngeohnaa	FALSE
fmmhpejbdhdonjjlgaa	FALSE
ghpjghigilcmaajlhfd	FALSE
ghpoplfcnehpnabjdaa	FALSE
hcgfkhfoocljcgfkiaa	FALSE
hchplgdjdhgamgbglaa	FALSE
hmfgpjlmmhmadcbpgaa	FALSE
hmfimcpkakihiolalaa	FALSE
ifjlkhjgebiljfgbcaa	FALSE
iflkoahgfblapbgnaaf	FALSE
ipcbciakcbjakjdlgaa	FALSE
ipclfldnggfkmedodaa	FALSE
jiekbcdblfaijfoagaa	FALSE
jielmgidhphilhibjaa	FALSE
kdflpjhmjclbpafakaa	FALSE
kdgeakbmajgffppnkaa	FALSE
knnfnpeogeknefnbkaa	FALSE
knnhpcmgnpamdigobaa	FALSE
lhnnklcfjfkmjkpgpaa	FALSE
lhofegmalligfbdelaa	FALSE
maioaldajkopnaldeaa	FALSE
majnifpmkcgaapdlcmj	FALSE
mlfnhlfkaoneoanlmaa	FALSE
mlgcenjinjfmfdepeaa	FALSE
nfhegiihcgkhhbhioaa	FALSE
nfiagdkdlllopdgilaa	FALSE
oacodpcmcaohdgfgfaa	FALSE
oadjiffoiebjhdklnaa	FALSE
oldpncpnoleagphdoaa	FALSE
olelconifdajdfijlaa	FALSE
pfjkljkaaolfabiffgp	FALSE
pflldkicejlfndlpkaa	FALSE
