aabklpbdjh	TRUE
aadffjacab	TRUE
akninemkhb	TRUE
akpoeccjoa	TRUE
bedlkafhei	TRUE
beeappcogh	TRUE
bpidojkcfl	TRUE
bpiheljdcp	TRUE
ckpbkifocm	TRUE
ckpnlapkpc	TRUE
dfbpgnbpdp	TRUE
dfdjdpmkdg	TRUE
ealecgcbnk	TRUE
ealeimmmeh	TRUE
elkpflohia	TRUE
elljehlkog	TRUE
ffmfkapnoo	TRUE
ffndlifpkp	TRUE
fohmdoojdi	TRUE
foielcclnk	TRUE
gjmegdiopc	TRUE
gjmjhjippp	TRUE
hebbnppjac	TRUE
hecdimmbgf	TRUE
hofnjjioll	TRUE
hogbcehnjh	TRUE
iiaahmkdab	TRUE
iiakjhgalh	TRUE
jbmnenpljl	TRUE
jbmpijlcjc	TRUE
jldlgiinkg	TRUE
jleegfcmbh	TRUE
kfbccffdnk	TRUE
kfbdhfodln	TRUE
kpennhbkbk	TRUE
kpghjgefde	TRUE
ljghgifcic	TRUE
ljgpbpdecd	TRUE
mecfiiigij	TRUE
medbikcada	TRUE
moddckiink	TRUE
modpellmpc	TRUE
niokidgdah	TRUE
nipecoihib	TRUE
ochhcpgbab	TRUE
ochmfdbfkl	TRUE
ombljdahhl	TRUE
omdapkgmfo	TRUE
pfppkbgfjb	TRUE
pgaadpojab	TRUE
aaaholmjfm	FALSE
aaanmpimgm	FALSE
akogcemmaa	FALSE
akogfbmgaa	FALSE
bfojijifaa	FALSE
bfpjdneiaa	FALSE
caodfhemaa	FALSE
caonhlghaa	FALSE
ckmlaljpaa	FALSE
cknhjnnjaa	FALSE
deekfikkaa	FALSE
defbibclaa	FALSE
dogllekcaa	FALSE
doimbipoaa	FALSE
ejghdeppaa	FALSE
ejgkmghiaa	FALSE
fdmlccpdaa	FALSE
fdnccklgaa	FALSE
foiidgfnaa	FALSE
fojidnibaa	FALSE
gifnibieaa	FALSE
gigdhillaa	FALSE
hcijljoeaa	FALSE
hciodgpjaa	FALSE
hmnepfmfaa	FALSE
hmnjemjoaa	FALSE
igjddkbdaa	FALSE
igjhofamaa	FALSE
jbjceaffaa	FALSE
jbjdmcggaa	FALSE
jlpndleiaa	FALSE
jmakkjbpaa	FALSE
kgcealdbaa	FALSE
kgcepmleaa	FALSE
ladmmmifaa	FALSE
laemcfkcaa	FALSE
ljkfldohaa	FALSE
ljkldicfaa	FALSE
mdfhieplaa	FALSE
mdfhmhhaae	FALSE
mnedennkaa	FALSE
mnfefooeaa	FALSE
niebmoohaa	FALSE
nieepfgcaa	FALSE
ockgbppmaa	FALSE
ockmpkohaa	FALSE
olnclebdaa	FALSE
olnnfnigaa	FALSE
pgeghicfaa	FALSE
pgenjdcmaa	FALSE
aaacmlfhlab	TRUE
aacadbmgaab	TRUE
akhpdkakbjh	TRUE
akigiooifnc	TRUE
bgaapncanab	TRUE
bgailcbnkbi	TRUE
cakopmdecja	TRUE
camblmfncea	TRUE
ckcnomfakmf	TRUE
ckcpkmalomm	TRUE
deiajahinlk	TRUE
dejahpkdepp	TRUE
doeibmhkigm	TRUE
dogkoeeghap	TRUE
eimachigkfm	TRUE
einbdpjaela	TRUE
femehfnmekp	TRUE
fenbggfhipk	TRUE
fpcfjigefac	TRUE
fpclghnjhkf	TRUE
gjbcmpdihfh	TRUE
gjbmmdbgoog	TRUE
hcknkgoojgd	TRUE
hckpflfhlhi	TRUE
hmajfhgcjja	TRUE
hmaoooifblo	TRUE
igkeianckpb	TRUE
igkpbipnmml	TRUE
jbbkmekllia	TRUE
jbbmhenlhob	TRUE
jlideimlhfl	TRUE
jliifgihecl	TRUE
kggapfeckcp	TRUE
kgglagclcbp	TRUE
labnjimcibm	TRUE
laccdpabfih	TRUE
liocmgfkdhg	TRUE
ljabndjempa	TRUE
mdbnobnjkbb	TRUE
mdcfhhapeok	TRUE
mnbeckbegfm	TRUE
mncdbmfbjjl	TRUE
nhpglpdbjnp	TRUE
nhpimbehdpd	TRUE
ockmjdeikei	TRUE
oclgjeeccba	TRUE
omcmdmoejke	TRUE
omebhjnhpcj	TRUE
pgkpgajieki	TRUE
pgmaomiomhg	TRUE
aaaifcjfnhh	FALSE
aacdhdiafnl	FALSE
akhffblbpaa	FALSE
akhjndppaam	FALSE
bfjdhmjidaa	FALSE
bfjmbdaghaa	FALSE
bodofffbhaa	FALSE
boedjkelpaa	FALSE
chghnlaagdp	FALSE
chhameincaa	FALSE
dbhdglfelaa	FALSE
dbhhddjcdaa	FALSE
dkjodobofaa	FALSE
dkkhnmcfdaa	FALSE
eecfmpldlaa	FALSE
eecnbifidaa	FALSE
eocbkdhfiaa	FALSE
eochbppmbaa	FALSE
fincbmipfaa	FALSE
finjafapmaa	FALSE
gdmdgbmdkaa	FALSE
gdmgahnbmaa	FALSE
gomcpaccjaa	FALSE
gomijannaam	FALSE
hiemkdghpaa	FALSE
hifcenolbaa	FALSE
idaglpopeaa	FALSE
idbhlaimkaa	FALSE
inaalcgfjfh	FALSE
inakendiiaa	FALSE
jgkiommljaa	FALSE
jgnojdlhjaa	FALSE
kbhnjdkonaa	FALSE
kbidcaiigaa	FALSE
knaejemacaa	FALSE
knbihgoanaa	FALSE
lhnejmkmcaa	FALSE
lhnkhdibeaa	FALSE
mbkedbolgaa	FALSE
mbkpklmcnaa	FALSE
mlbkffcepaa	FALSE
mlcaipmbfaa	FALSE
nemjalkajaa	FALSE
nemlbflplaa	FALSE
noohhegblaa	FALSE
nopdcmaieaa	FALSE
okppckjinaa	FALSE
olaeclhhbaa	FALSE
pfgledkpbaa	FALSE
pfhdjbgiiaa	FALSE
aaalikdfkdab	TRUE
aaanbhcjnbbi	TRUE
akdppcikmlga	TRUE
akemfdkgokjg	TRUE
bebmmpemoelj	TRUE
beceeancjoaf	TRUE
boebjjcdcngn	TRUE
boeeacnnhjji	TRUE
cjehlcfpocnp	TRUE
cjfaglodepko	TRUE
deaeffkeemkd	TRUE
declneheinaf	TRUE
dpdjkdlojpep	TRUE
dpfgbkdlfhng	TRUE
einkicnjkfbh	TRUE
eiohgpfafgjd	TRUE
fcgeeohniano	TRUE
fcgldheiogbd	TRUE
fminlfpmbdpi	TRUE
fmmafdmolhap	TRUE
ghnieedepgma	TRUE
ghppckidnckl	TRUE
hcoiajehdenn	TRUE
hcpifleigcnc	TRUE
hnbjfjhmhfmi	TRUE
hncenfippknk	TRUE
ihbopgnkmfcp	TRUE
ihcfencbbdmc	TRUE
jbfcpegihami	TRUE
jbfnfmbgiegl	TRUE
jlmkmknjaoho	TRUE
jlojfkkgdbpp	TRUE
kgoakmgblebm	TRUE
kgpffliipmhe	TRUE
lbfnjdbkikkh	TRUE
lbgbebjjbjpj	TRUE
llecllhiogec	TRUE
lleicoigloja	TRUE
mfopdhmddion	TRUE
mgamjbigifne	TRUE
naggdbkfbdfb	TRUE
nahdblppogep	TRUE
njkphjmeconk	TRUE
njnfahofmkdi	TRUE
odobhkandlck	TRUE
ododnjkjbgdf	TRUE
omgafnhlajag	TRUE
omgpkgfgfenp	TRUE
pfmnhmbdkgll	TRUE
pfnjkehhbbak	TRUE
aaahamplobeb	FALSE
aacknmjbgmag	FALSE
akofinodieaa	FALSE
akpkkpnelkaa	FALSE
bfdkbcfpgaao	FALSE
bfdmbklbolaa	FALSE
bonhlkhaobaa	FALSE
boniddjadbaa	FALSE
cjfplbihcaaf	FALSE
cjhoccapmiaa	FALSE
degpdhmjebaa	FALSE
degpkhmkfnaa	FALSE
dpjaoelmapaa	FALSE
dpjcnnifdiaa	FALSE
eipecedeblaa	FALSE
eiphbfjdakaa	FALSE
fdgaplbpdhaa	FALSE
fdgfckkkdfaa	FALSE
fnckkbdlfaak	FALSE
fncoliajekaa	FALSE
ghmbkgpkchaa	FALSE
ghmkcbkjpkaa	FALSE
hdbpakjbdpaa	FALSE
hdcnobibmcaa	FALSE
hnmhojmnfmaa	FALSE
hnmnnhocpnaa	FALSE
ihljldhhliaa	FALSE
ihlofmfgpkaa	FALSE
jbagdllipiaa	FALSE
jbdihdmfiiaa	FALSE
jlakmkanneaa	FALSE
jlaoajpmpbaa	FALSE
kgdooliapbaa	FALSE
kgfnanopdkaa	FALSE
lbmdojkdfcaa	FALSE
lbmdpojdahaa	FALSE
llpimmiplfaa	FALSE
llplkbjknaaf	FALSE
mgjjfofcegaa	FALSE
mgkoeknlhiaa	FALSE
naheeebgejaa	FALSE
nahfaigkjaam	FALSE
nkolmgcgpcaa	FALSE
nkonaoccmlaa	FALSE
oeakfajiicaa	FALSE
oeaneolljdaa	FALSE
omfejglngmaa	FALSE
omfpmjjpfdaa	FALSE
pfobedjnfnaa	FALSE
pfohdljpaoaa	FALSE
aaapaoikioaab	TRUE
aabbpocnanalo	TRUE
ajjiiledpcfhi	TRUE
ajjoplapejmgl	TRUE
bdehfoodbgkbp	TRUE
bdfogebfdpjep	TRUE
bnbpnlbodlmnc	TRUE
bncglkgoccfge	TRUE
chhpjgbamabbc	TRUE
chiabpkjblbaf	TRUE
dddfbknapfkil	TRUE
ddedifkfanill	TRUE
dnpneiljodkii	TRUE
doadpnippaabn	TRUE
eillbhobmcdda	TRUE
eiloijomepain	TRUE
fcmambfnojabk	TRUE
fcmjenbfchpma	TRUE
fnffjljddeeel	TRUE
fnfgegigmemij	TRUE
ghfmeelcanfco	TRUE
ghgjcfgbenana	TRUE
hcengdlknhdng	TRUE
hcgakbknkgneg	TRUE
hnfkeeamggmga	TRUE
hngpgljheneab	TRUE
igchpjachhibd	TRUE
igcijhpnfgael	TRUE
jalgdkjocnpkp	TRUE
janbcjbehjbmj	TRUE
jkocbiaicfpnp	TRUE
jkokldfmbjkaf	TRUE
kfaedpafpcpmj	TRUE
kfafgpnmggkch	TRUE
kpgdnjjabmhgp	TRUE
kpggjklpknpkc	TRUE
ljenlpeejlldk	TRUE
ljepnddmfifdi	TRUE
mdkbhialmemch	TRUE
mdknlhhdnheif	TRUE
mnimfadkohnam	TRUE
mnjlmhdilohdb	TRUE
nhmnghaifljkl	TRUE
nhmngolofeole	TRUE
obfpceallfoob	TRUE
obhcfmfhfdhan	TRUE
olnjoloilainl	TRUE
omaamkokmmfab	TRUE
pfkogahbpifce	TRUE
pfldoikkgmpko	TRUE
aaaiokbfnmmgo	FALSE
aaaoipcidflmb	FALSE
ameccbjmpjdaa	FALSE
amjcncbphakaa	FALSE
bhpboceppdiaa	FALSE
bhpkdbodbihaa	FALSE
caapjdmgfapgi	FALSE
caceeegeapfaa	FALSE
ckbpngnehlmaa	FALSE
ckdnoleeofdaa	FALSE
deacbobmogeaa	FALSE
deachdpadfiaa	FALSE
dnamhhjmeagaa	FALSE
dnankmbjjlhaa	FALSE
egphmpegpmiaa	FALSE
egpllplelkoaa	FALSE
fahleiafmooaa	FALSE
faidbnobpcfaa	FALSE
fkgolffekfgaa	FALSE
fkhdcdbhljkaa	FALSE
gemheibngafaa	FALSE
genpalnklbcaa	FALSE
haibmialldmaa	FALSE
hajonlhnickaa	FALSE
hkplhhdamfhaa	FALSE
hladcgldamfaa	FALSE
ieikaopfpnoaa	FALSE
iejcfeebmkmaa	FALSE
inphgpepdidaa	FALSE
ioaclfbohnhaa	FALSE
jhnadnkidllaa	FALSE
jhngjacmggkaa	FALSE
kcjimccmcoaal	FALSE
kckbonjjfemaa	FALSE
kmkkommfjboaa	FALSE
kmknbpochjgaa	FALSE
lgnllejckcaap	FALSE
lgpjgnbcgolaa	FALSE
manimdppokkaa	FALSE
maoemomidaeaa	FALSE
mlfkjjbognmaa	FALSE
mlhbfkfbalnaa	FALSE
nfiehlggcfkaa	FALSE
nfiladjajcaak	FALSE
npnkbikbpfaac	FALSE
nppobiimgjdaa	FALSE
okfildmdphhaa	FALSE
okghcfakmelaa	FALSE
pfgaokiaajnkh	FALSE
pfgenbjcbcmaa	FALSE
aaabldlmakkejb	TRUE
aabimcgjccdpeo	TRUE
akbijlkfllchfp	TRUE
akcbfjbhfdihee	TRUE
beipjeeobbkifo	TRUE
bejhedgmnfcacf	TRUE
bnlmfmclkiphhg	TRUE
bnmapkocmbgeak	TRUE
cgnailgfcbcegl	TRUE
cgpdigmhiiibbb	TRUE
dbjofnllmnfdcm	TRUE
dbmgccfdechgpe	TRUE
dlnajdniibppee	TRUE
dlnejhhkhfmmib	TRUE
egjgegnchdmlne	TRUE
egkdhjlhcoobjd	TRUE
eplhfholoeadnh	TRUE
epliipgolfoedb	TRUE
fkhfbbchnjflnh	TRUE
fkjdllolcpajkk	TRUE
gdlleobfibdldc	TRUE
gdllpijehkbofi	TRUE
goekkndplgnmjl	TRUE
gogdbnjdpgobbb	TRUE
hhnbgpfdnipfgc	TRUE
hhobajebdjkpfo	TRUE
ickbkmdpahiadh	TRUE
ickepfekmdhfgl	TRUE
ioakcdgaocjlon	TRUE
iodmpppmmmknhj	TRUE
jijodhhkkgcoba	TRUE
jikognkmimdehg	TRUE
kdbbaneadppjdi	TRUE
kdblijkinhokag	TRUE
kmddmkonkcojal	TRUE
kmffjgbimjhpkk	TRUE
lhcifeledgjfpa	TRUE
lhcofdbgajmcbl	TRUE
mapjgoocbgfpeo	TRUE
mbaigdajbpolcn	TRUE
mmdlpkfaeionme	TRUE
mmenbacindllgm	TRUE
nfmigfplhollao	TRUE
nfnbfbfagdndac	TRUE
nplglioenlphhl	TRUE
nplidiibhgjdmf	TRUE
olbjfhdfdhcgmd	TRUE
olcacbfbmhppae	TRUE
pfellddhpagocb	TRUE
pfgadhodjmdika	TRUE
aaafbpeejbkipc	FALSE
aacgilpdanamij	FALSE
akganfambppgaa	FALSE
akjfcdhipikoaa	FALSE
beeocnfmojjfaa	FALSE
befkhanmegfaag	FALSE
bnnncdphfadmaa	FALSE
bnnodagpllpbaa	FALSE
chlpicpebdemaa	FALSE
chmkkdggcgpeaa	FALSE
dbgecldckfgjaa	FALSE
dbgmdfoeklmlaa	FALSE
dlcmgkknfbndaa	FALSE
dlepigckmgohaa	FALSE
eefibjhjehliaa	FALSE
eegefkiffcniaa	FALSE
eobgamamdondaa	FALSE
eobjkdfeecfaag	FALSE
fjglkaieodonaa	FALSE
fjlkmclbgdfoaa	FALSE
gdicibhdebofaa	FALSE
gdinkdcnjaaahm	FALSE
gnclpgliacojaa	FALSE
gnefpaolijkbaa	FALSE
hhmgnjlpgohpaa	FALSE
hhnfinndbeojaa	FALSE
icchagigmlgnaa	FALSE
iceebcgfmelbaa	FALSE
imfcnffpcahaam	FALSE
imfokaddalbiaa	FALSE
jgkcfdobpgimaa	FALSE
jgljmbfmbjjiaa	FALSE
kbfnhfeoniopaa	FALSE
kbfoaaffhpigjk	FALSE
klgkgbcpgnkoaa	FALSE
klhgiekbelgpaa	FALSE
lfdngkjbfkodaa	FALSE
lfekhgbaklbpaa	FALSE
lpkdafbnnlckaa	FALSE
lpkmnbjcbkocaa	FALSE
mjdkggkajpddaa	FALSE
mjdmnioeejakaa	FALSE
neandckkgahbaa	FALSE
nebieahmmgheaa	FALSE
nnoeinccjdhiaa	FALSE
nnonkajbopinaa	FALSE
ojeiefnjdpmkaa	FALSE
ojelkdphendmaa	FALSE
pedbdmokhjipaa	FALSE
pedbmobccfieaa	FALSE
aaabhchpapbcmhi	TRUE
aabhdclgbgkgoda	TRUE
ajbeicnkpiofnpd	TRUE
ajcajemoofaeaab	TRUE
bcdmnomclbdeaji	TRUE
bcebmjpibmcmfgm	TRUE
blgjbepkocbkjpn	TRUE
blhdmhfohojljlo	TRUE
cgljjpghgpoliki	TRUE
cgmnpgbampinpjh	TRUE
daldiifehmmgbmf	TRUE
daledngpkdlbcpf	TRUE
dkoaplokohobnjn	TRUE
dkodlbffmenneec	TRUE
efkcmjckamnmkla	TRUE
efkphlchcooimle	TRUE
eonmmkhpedaiffn	TRUE
eoohjhpocblcohe	TRUE
fiiogckpchhailp	TRUE
fijkcdgakcfmiom	TRUE
gcfknppacofgmdp	TRUE
gchbbnobjkebpmb	TRUE
gmbmepcnjldebie	TRUE
gmccmhdflolpknp	TRUE
hgkbnoibhlahkcj	TRUE
hgkoelamcfinmfd	TRUE
iceahllpphodcam	TRUE
icehiaiockcdjfa	TRUE
imfoeofjalomkek	TRUE
imgebgdifacjkna	TRUE
jhdaiekkjgacplc	TRUE
jhdocphdmdfdpag	TRUE
kbfdaklpinabfao	TRUE
kbfnpcaikhkhaeb	TRUE
kmejhhcjoggfbln	TRUE
kmenbklcnelofgo	TRUE
lhiiednmmgafpih	TRUE
lhiokikkbbofgep	TRUE
mckdfiibfbggjka	TRUE
mckdpkacdbionlb	TRUE
mndiphdklfmblno	TRUE
mndjmfoppkfabfo	TRUE
nhnjhiboafagmon	TRUE
nhnmbklkpdmiopm	TRUE
occifljdmigobjp	TRUE
ocealgphindfjcm	TRUE
onioplgnmgoccgb	TRUE
onjekhkhhjjpnoc	TRUE
pglpbkgjnmpboli	TRUE
pgmiabminbjjpja	TRUE
aadmknolgfgdpjj	FALSE
aafehaipakajdcg	FALSE
albieignclideaa	FALSE
albjgdnebfpnpaa	FALSE
bemkfclaalfmemc	FALSE
bendhoembmjoiaa	FALSE
bookieeoijckaag	FALSE
bopcckglpbmkpaa	FALSE
cholonaephdflaa	FALSE
cibkmdcijgfcoaa	FALSE
ddipggfjggaehaa	FALSE
ddjdjlcahccipaa	FALSE
dngjnklkbodljaa	FALSE
dnhakolhganihaa	FALSE
ehaicapkmemkeaa	FALSE
ehcgmhlakbjhkaa	FALSE
fbcmfhbhkcdpbaa	FALSE
fbdecopcpijmiaa	FALSE
fldbmghdhcnngaa	FALSE
fldnffonbjakcaa	FALSE
gfbiicfnpdcdbaa	FALSE
gfbonapccamcgaa	FALSE
gpkhnmndgimjlaa	FALSE
gplalnmifknfmaa	FALSE
hjjjpildeenohaa	FALSE
hjjlljflllhfbaa	FALSE
idokhojgagecfaa	FALSE
idonogjfofgmcaa	FALSE
ioldihgglljmcaa	FALSE
iomgehiopkmcoaa	FALSE
jjdnmjphljbcgaa	FALSE
jjenbdgaagmbfbp	FALSE
kfffchjplihadaa	FALSE
kffmahnghmkidaa	FALSE
koomjinegagkoaa	FALSE
koopmahbemjifaa	FALSE
ljeijknhmljjiaa	FALSE
ljekjgcjmgeibaa	FALSE
mdhfkgddekkihaa	FALSE
mdhigampnlngfaa	FALSE
mocolaedfngeiaa	FALSE
modmghecnmcnnaa	FALSE
nhhdbfcokkhmjaa	FALSE
nhjaedgdajlgfaa	FALSE
obiogbhdocjmiaa	FALSE
objmmampifjceaa	FALSE
olnnjldcbnloeaa	FALSE
omaiogfbkadhdaa	FALSE
pgelikkdlemgeaa	FALSE
pggfocjgnfnnaao	FALSE
aaadnlecmkmjikab	TRUE
aabgnjimpfnmknol	TRUE
akgfhikkjganbccf	TRUE
akgihjagijnciige	TRUE
beakcbampfmahlhh	TRUE
bebmfhfjcgdfhkad	TRUE
bohmpiilcfdjidma	TRUE
boicilbfmegiakdp	TRUE
cjfbdbabdniomicg	TRUE
cjfkgchnljnaaibb	TRUE
ddemajmgcbnfalck	TRUE
ddholifdpdgoefgh	TRUE
dmocadbeabnjlakk	TRUE
dnblmambjkbdddgj	TRUE
egjjkobhciboaeik	TRUE
egjooehiemdadpfd	TRUE
fajnkikmopidhbak	TRUE
fakffidohjeplkmj	TRUE
flgnnfpgdlekiacg	TRUE
flhmgiheehdjccak	TRUE
gfiifonginiohcoa	TRUE
gfiodehpkkignbkc	TRUE
gpjmeochjamehobo	TRUE
gpkaijmgnjdnhhfg	TRUE
hkdoapkpegmohjcg	TRUE
hkefmkmbjgajjacd	TRUE
iebmjajplinppekb	TRUE
ieciikecoliceceh	TRUE
ioebbpkhallmdojf	TRUE
ioechnoembnhkaem	TRUE
jjpdmpjfipllknel	TRUE
jjpegldphcikefil	TRUE
kfdioopdcmnnclfj	TRUE
kfedlaikgkaglpfo	TRUE
kpdobigfdjiccppn	TRUE
kpfgpjijihnlgpej	TRUE
limbllgkamlenklg	TRUE
limcfglobhenopdd	TRUE
mdcmeblngnfddkma	TRUE
mdcndkiopolimchk	TRUE
mnkhimgmgpmljgjp	TRUE
mnlcjdjmnjolkkhb	TRUE
nifkcibckmjiaabc	TRUE
nigoondfldpagnkn	TRUE
ocaebdihjclaeaon	TRUE
ocaimheofhfdgbdd	TRUE
olbmppgigdkgndgf	TRUE
oldghnfjmoknpnpi	TRUE
penahfbggbcimpgh	TRUE
penfdjjchinbkpga	TRUE
aadmbmcbgkhojhne	FALSE
aafilgimkjdbifcf	FALSE
alcokbppgakhfeaa	FALSE
alcpbkkpaecdggaa	FALSE
bfaihigaplhdinaa	FALSE
bfcnpdbgpcghlmaa	FALSE
boccgkamfpmlnnaa	FALSE
boclocpkgoijbkaa	FALSE
cifdcnpnjfkjfjaa	FALSE
cifmjlnaobcdhiaa	FALSE
dcndmeojkhefioaa	FALSE
dcohaanjfaeddkdk	FALSE
dmibenpjbkjfkjaa	FALSE
dmikglagfbjnoeaa	FALSE
ehakpmibecnkgnaa	FALSE
ehbnkpikgnoijcaa	FALSE
fcheioblommjgoaa	FALSE
fchlfognenjbieaa	FALSE
fmiagahbdllejfaa	FALSE
fmimpaompdanciaa	FALSE
ggffohnlijlhapaa	FALSE
ggfhlhbakbiafmaa	FALSE
hanebhmbelnnekaa	FALSE
hanjnfhgmcjfcbaa	FALSE
hlbpphjoiaiacpaa	FALSE
hlcafaaoobhaagec	FALSE
ifjgniiaoibgckaa	FALSE
ifkbcaibnkoflgaa	FALSE
jaaicbigieiiofnc	FALSE
jaajimkokpjbfhkd	FALSE
jkgeaeagblfajpaa	FALSE
jkhnmiohkbpfhnaa	FALSE
kepappiomphclkaa	FALSE
kepfailmlokcdpaa	FALSE
kohlibplfdkddcaa	FALSE
koildpjcefpmnkaa	FALSE
ligplbgeigfgebaa	FALSE
lihbekcihbidbdaa	FALSE
mdankmjlpfaedoaa	FALSE
mdbgocpppdpnanaa	FALSE
mojkeecpalcddnaa	FALSE
mokibdamemnjnnaa	FALSE
nidnkdbmjnhchoaa	FALSE
niegcpemdobgnaam	FALSE
oddikdojnnibklaa	FALSE
odeafehhpcogicaa	FALSE
olmdilaklnjdbpaa	FALSE
olnbopkehmidcjaa	FALSE
pfpnbofkokgiepaa	FALSE
pgaddeohpocajeaa	FALSE
aaaibbopjjjanekbk	TRUE
aaakgaeilaggfllab	TRUE
akncenfkjkbkdfmdm	TRUE
akncommlbfcfkjbnm	TRUE
beoabaodmbkadhenh	TRUE
beoigfihgfdohknfl	TRUE
boogchndpnngedodf	TRUE
boopbfpggoiccojal	TRUE
cjcjpkkichjnmfocj	TRUE
cjedoiolnnfplfndg	TRUE
dceomfhcpikldpcbg	TRUE
dcfaojnffklmodbgk	TRUE
dldedippigbcjbinn	TRUE
dldolledijeolenga	TRUE
efgjdhmkchhhfaccd	TRUE
efhgafpkkcmmbbceb	TRUE
faiejhhkmcnepmmjo	TRUE
faifeijhpfpegdfan	TRUE
fmcoegakfalmmofgd	TRUE
fmdbhncodmjfadnpa	TRUE
gfjieckmjdoidaoal	TRUE
gfjmefhbghhfjchhj	TRUE
gpgbgmeohohoniknj	TRUE
gpgbngmldkehcijmg	TRUE
hickcpcfnmhepcfmg	TRUE
hidojglfhbnnocflo	TRUE
iapbcblfppbglcacg	TRUE
ibacedcnaliaiecna	TRUE
ilnjiongakcnnjnia	TRUE
ilnodnemnpnclgakb	TRUE
jfhoahookklmflhhm	TRUE
jfhojmmhibbpikldo	TRUE
kachpdlilppnblmal	TRUE
kacjcalgomfelelpn	TRUE
kkimfahndjhlmikef	TRUE
kkimgkagjmbkmbkeo	TRUE
leogcfgfbgoemnhlh	TRUE
lfambochhcmokjici	TRUE
mabbpnmfgeloaenia	TRUE
mabijndhbmamlphcp	TRUE
mlabhkhajhjmbhfah	TRUE
mlbkllmdmhkbifapl	TRUE
nfljnfeingodncjnc	TRUE
nfmbknakcckebcoic	TRUE
oadadpbibjfmaipjh	TRUE
oadlnfkpfdbaafpbb	TRUE
okkneaglifgnndncg	TRUE
oklccaijeabcccnhi	TRUE
pficfiofioicdejhj	TRUE
pfipedbelcopnjbmd	TRUE
aaaaigmhnimeegmdj	FALSE
aaacjjikldbdcpgdn	FALSE
akobjaompgebdjpaa	FALSE
akpefnpobfmjfalaa	FALSE
bgbjlpngmmlfjngaa	FALSE
bgbkdghjillkonjaa	FALSE
boofbmgajkpfohnaa	FALSE
booggphiiehojhkaa	FALSE
cilmnlncknhgifdaa	FALSE
cimfcfhdemhlhjiaa	FALSE
dcdihpcpfbdgecmaa	FALSE
dcdodomfnojgejhaa	FALSE
dldfihpidkpanckaa	FALSE
dlekakhhapolejcaa	FALSE
efnkkngbahhffgdaa	FALSE
efobibipmaahjjeig	FALSE
fajjcckplepidieaa	FALSE
fajlmllkekjdkddaa	FALSE
flicpalbhkbmmhjaa	FALSE
flidmcbjminlfkaal	FALSE
gfkoofgdbincodmaa	FALSE
gflfaenpaicgmclaa	FALSE
gpdojijoobfhihbaa	FALSE
gpfnhchbedfbcbmaa	FALSE
hifngmhlbdlfpfgaa	FALSE
hifomeednneakppaa	FALSE
iakjfdngilkplifaa	FALSE
iakmodicpbpjhnkaa	FALSE
imbgmdaenenlljjaa	FALSE
imdaajojonmhmafni	FALSE
jgfcfnhjpbcfednaa	FALSE
jgfgglahfpcmahkaa	FALSE
kacooepjinplfkgaa	FALSE
kadcndfafepnafaal	FALSE
kkacbpcnbgdakjpaa	FALSE
kkagibgedhhehmhaa	FALSE
lfahpdngpiljnhlaa	FALSE
lfbeagpipgidckdaa	FALSE
maeafcbggjifilbaa	FALSE
maenboehjneiohiaa	FALSE
mkocmmjengbcjljaa	FALSE
mkodmjcojahpccdaa	FALSE
nfimcjlkcephjhaao	FALSE
nfjllmhgkkohanoaa	FALSE
oaeobkogbddhfdgaa	FALSE
oafadhjalpicahjaa	FALSE
olbedhdaeiiohjeaa	FALSE
olbglhnobdmaplcaa	FALSE
pfkicdpgeiobmahaa	FALSE
pfklncjllmggambaa	FALSE
aaahcecdbfegdifjbb	TRUE
aadngngognpfbmppab	TRUE
akhkopmoknfjifnjbe	TRUE
akhnnbgmpegehpmbma	TRUE
bdmpfbjdfoaipaabmo	TRUE
bdpbfmgnmpnklhehnk	TRUE
bnihafpdpglnhmfebp	TRUE
bniinhcpbophmapcop	TRUE
cijdmgkagjeheifdph	TRUE
cijhdioliopfjgdgfk	TRUE
dchfnlfhpmcmafbgfo	TRUE
dcimfafmeipapibcol	TRUE
dmbdppgicjlnhkndnf	TRUE
dmckpenbifcfcdajjm	TRUE
efnbcbbjoghbadmopj	TRUE
efnhndjanehhjekiek	TRUE
faccghnhkmjoglaoem	TRUE
fadlhcgnajfmfmllcf	TRUE
fknbkdgneffigkfacm	TRUE
fknpfgdaaeboojajbb	TRUE
gepmopollekjinbdog	TRUE
gfclibopgolfaiajaj	TRUE
gpapmkfcbglaeainef	TRUE
gpbmajoolipjgeghee	TRUE
hjpagphdgehmcibkhl	TRUE
hkagbkmamkmljjijmf	TRUE
ifpdpflpgfbffmoedl	TRUE
ifpenfnpcjhkafahhb	TRUE
jakbgcacbfjpgcfadf	TRUE
jakpepojofbfjofihc	TRUE
jlfkfmokpmonbnibma	TRUE
jlfnfpgbipggnmnjdk	TRUE
kgbgcccjiebinekoji	TRUE
kgdcmkpkcaffknfglc	TRUE
kphacpoenbbkcggdih	TRUE
kpiankenlpjfjlhcga	TRUE
ljplaapkjifdmpiabd	TRUE
lkbodbjddlfjjnmjik	TRUE
meghcglaifhobjnpgj	TRUE
mehhcfecghmlnlnloi	TRUE
momaiojnnbbmoliaaf	TRUE
momnjlnanpefknddil	TRUE
njejnimdpldonakcnp	TRUE
njgddonofkacnphcdp	TRUE
odbcajpedadnjhnhfe	TRUE
odbileckfllcjahani	TRUE
omnidkelfldfmhpdkc	TRUE
onaahofceonhcgdobb	TRUE
pgenmoncmlogbbaple	TRUE
pgfjpldegpmocloglc	TRUE
aaaemjhmihgpedbmoj	FALSE
aaaeodpbcomlhdildb	FALSE
akinlgblkijpdfclaa	FALSE
akjpglmaaedlfmbldk	FALSE
bfcenmpbmigegjomaa	FALSE
bfcooehoiegcailfaa	FALSE
bopebiolmcdgageaai	FALSE
bpafedaeffpimdjfaa	FALSE
cjmdiboejlcdaineaa	FALSE
cjnjogffoifoldciaa	FALSE
ddnddnbfapbejeocaa	FALSE
ddodblngbjllphglaa	FALSE
dnbjhdnnakkfbofcaa	FALSE
dnfbcoaeidnogpigaa	FALSE
eicdddnnggcddppdaa	FALSE
eicjnlppkpbaknjfaa	FALSE
fbjdobdmepefdklfaa	FALSE
fbkihifbialboailaa	FALSE
flakgjflmbkjdibeaa	FALSE
flbdpkjodffjhbnpaa	FALSE
geinmbeepinnihnmaa	FALSE
gejbidbmpilkiejbaa	FALSE
gnpbnajpipmafgloaa	FALSE
gnpcponafgkhgicoaa	FALSE
hicloaanaldehmhbnh	FALSE
hidnnafpdkpkohidaa	FALSE
icijonbpjkhebdhpaa	FALSE
icjeecpndbacedhnaa	FALSE
ioklbiocakmbmcpaae	FALSE
iolihibidfbgkojnaa	FALSE
jhmlbkdblnegojecaa	FALSE
jhmljeekeodaekdkaa	FALSE
kbmhkpjhnfadlcopaa	FALSE
kbnkdajhdickdjgmaa	FALSE
knipflhjjoplimpbaa	FALSE
knjiodilkbkaebifaa	FALSE
lifcfloamjpfljfhaa	FALSE
ligbmbdcgnenaaanbm	FALSE
mcenachlfmoclcdfaa	FALSE
mcghjmdmoegbnmdjaa	FALSE
mnibeppaclhomchkaa	FALSE
mniheehohgegnecgaa	FALSE
nhimhjlinjeecihpaa	FALSE
nhjeiijgplagacmoaa	FALSE
obhcgcbefakkidmfaa	FALSE
obhgjefkebfpecoiaa	FALSE
olpjnokgngcannbfaa	FALSE
omadfbfhdgnfefmaal	FALSE
pfnlnmilomihgeomaa	FALSE
pfohgegopkgdakedaa	FALSE
aaaappgeillidilcbbb	TRUE
aabcnkakmflbcnbnaik	TRUE
akpnmjcjmhblchefokg	TRUE
alafkmmgdedgakgliba	TRUE
bfdjcfcciddadmkbpnh	TRUE
bfenahomihcocpbgiao	TRUE
bnmgepjdicljgbnmacn	TRUE
bnmkocfmbjpciajblml	TRUE
cijjpmdelbcmiimkjje	TRUE
cikgphhmklbgblhennl	TRUE
ddjeobompjldhbpmijd	TRUE
ddjkikibelhkpdlaldk	TRUE
dojfeeeljanolclpohb	TRUE
dojfegcijljllechalh	TRUE
eikngmabikemglmmnmd	TRUE
eimkpoehcpjlblaikpm	TRUE
feodmckglnkelijcgkh	TRUE
feojgejnecmnmfghibk	TRUE
fpimingkdiocggfnceg	TRUE
fpioflbcpgfhpacmbgm	TRUE
gjhlgdlgnkmmdnedojm	TRUE
gjhoohffdfpdhfdbcbk	TRUE
hdcgcoifcopkgpmmmon	TRUE
hdciolklfopocnpdjbh	TRUE
hmmhpmgfjpphkgkhfdc	TRUE
hmmncggcbieddkdoffo	TRUE
ignandmdchmpbloigbm	TRUE
ignbhbakekehfehfpec	TRUE
jaklmbnockjepmihlah	TRUE
jakplgcclgpnhbjghgi	TRUE
jkahmonineeadhnmgkj	TRUE
jkbckakaekjldlhpohb	TRUE
kdlbiibfhoagmaciojo	TRUE
kdlkmbaacnclaokciab	TRUE
knjlodoedgkcmnoglac	TRUE
knjponjoimooedipoik	TRUE
lhbgcbkkikjcoclhbgd	TRUE
lhcalombhgamkgjjhnh	TRUE
mbfgahildfgkbpeioho	TRUE
mbgfmnjiobciacheoad	TRUE
mlenhnjgcgfeciofhcp	TRUE
mlepdjlapljpfflhkeh	TRUE
nficeffggkkjfkefebh	TRUE
nfidfpapngjcgidjing	TRUE
npkmjphbjccdloajnhp	TRUE
npmihbdnjfpaiomabmh	TRUE
olclimjlacemadfpdak	TRUE
oldelgndejcphgkfmdo	TRUE
pfjbcdhpmijpcehjddh	TRUE
pfjefacehgcfkkjldjg	TRUE
aaadnboajkkiknkhmga	FALSE
aaccihfoeipkpoclald	FALSE
akpoppmhohkjfogegaa	FALSE
alannoainkoeibpnpaa	FALSE
bepnimlifaopndjemaa	FALSE
bepoddldiocfedilcaa	FALSE
bnnhokcaaohigianicb	FALSE
bnnkhmbojjmllnnbgaa	FALSE
cimljidchfbcdogklaa	FALSE
cimpihfmkhnhnjamfaa	FALSE
ddeeplceoepcjfldpaa	FALSE
ddemeknimgaijcfknaa	FALSE
dolamnmjbjajhmegkaa	FALSE
donkegbpmpbdbclchaa	FALSE
eigbdeghcbhlpbcafaa	FALSE
eigfpnbpebnhkibjbaa	FALSE
fdhniijchlbkpahlgaa	FALSE
fdimjjgcgfaicgegeaa	FALSE
fpggbojehcojcehadaa	FALSE
fphkehpjdiapjojjjaa	FALSE
gimkafbdecbmeejddaa	FALSE
ginamapfhlcbkilloaa	FALSE
hdbkniiblccbloeppaa	FALSE
hdceehalebehfgbmiaa	FALSE
hmngdcidbadihfinaaf	FALSE
hmnhnnfgkhdcaohejaa	FALSE
ifobodkoboacjnbgfaa	FALSE
ifobppccmemikbmngaa	FALSE
jalpeepedcocbmgdmaa	FALSE
janmgifppbfjanjleaa	FALSE
jjpokomhlpoaeeenmaa	FALSE
jkaokjfafebpnokieaa	FALSE
kefhopnmcjfkifajdaa	FALSE
kefplibaeaekffdckaa	FALSE
koldcpfcndhlgkebiaa	FALSE
kolkofjcaonodfolaae	FALSE
lhjlbjbfjoodjjiapaa	FALSE
lhkdjplmmccppmefmaa	FALSE
mbecoialdlcaphdflaa	FALSE
mbffmpkfmakbceljhaa	FALSE
mldniicapcpadmjklaa	FALSE
mlednhljfjijlfocdaa	FALSE
nflndpmjbeehjfbkcaa	FALSE
nfmocoacnfcdobpdgaa	FALSE
npobhfdgdoioegoidaa	FALSE
npogfgglkjpgighnjaa	FALSE
okpflknghleleiedmaa	FALSE
oladhklalgfifpakdaa	FALSE
pfogcjcdmegakifgdaa	FALSE
pfpoaillignohpbknaa	FALSE
