aaamkfnmgh	TRUE
aabngkieko	TRUE
ajnalgfbap	TRUE
ajnieobecj	TRUE
bdmllkecdn	TRUE
bdpneigmep	TRUE
bonndnimna	TRUE
boockmmiak	TRUE
cieiicogca	TRUE
cifbbffpdf	TRUE
dbghpdlfne	TRUE
dbgiconapn	TRUE
dljkdfopda	TRUE
dlkfilfgjm	TRUE
eggnagajcf	TRUE
eghahkepko	TRUE
famldlckno	TRUE
fanjipdabl	TRUE
flhdgopkdm	TRUE
flhehdfcdp	TRUE
gfhplehkjf	TRUE
gflficekon	TRUE
gokhmagdid	TRUE
gokilnhcei	TRUE
hiooakhhnb	TRUE
hipjpnakdb	TRUE
idmmlbjdbp	TRUE
idnidekdbm	TRUE
iobjgblnkp	TRUE
iodcpllnbl	TRUE
jifakheomn	TRUE
jifbjjbdcm	TRUE
kcobbmflbk	TRUE
kcpkojkdni	TRUE
kndkioomkg	TRUE
kndllpabdc	TRUE
lgeedcbcll	TRUE
lggangppek	TRUE
mbbanhegod	TRUE
mbbpjjlkao	TRUE
mmgeamdmeh	TRUE
mmhehldcma	TRUE
nhdpkfmnfp	TRUE
nheilpgnhk	TRUE
obnjnichlc	TRUE
obodebgpnh	TRUE
olhibppppm	TRUE
olhjfhjgio	TRUE
pgaflinolc	TRUE
pganelehhh	TRUE
aaamkfaaaa	FALSE
aabnmgaaaa	FALSE
ajjphmaaaa	FALSE
ajmkffaaaa	FALSE
bdpojmaaaa	FALSE
bebdkmaaaa	FALSE
boomlbaaaa	FALSE
bopjpeaaaa	FALSE
cihiabaaaa	FALSE
cihmcfaaaa	FALSE
dbndokaaaa	FALSE
dbobapaaaa	FALSE
dljidbaaaa	FALSE
dlkbccaaaa	FALSE
eghkngaaaa	FALSE
eghnpeaaaa	FALSE
fanldmaaaa	FALSE
faohknaaaa	FALSE
fldmfmaaaa	FALSE
flehgmaaaa	FALSE
gelgknaaaa	FALSE
geljjeaaaa	FALSE
golfmpaaaa	FALSE
gomhmgaaaa	FALSE
hieiejaaaa	FALSE
hifickaaaa	FALSE
iedaakaaaa	FALSE
iedicbaaaa	FALSE
inodcdaaaa	FALSE
inpeopaaaa	FALSE
jicpojaaaa	FALSE
jidmnpaaaa	FALSE
kckckjaaaa	FALSE
kckkpbaaaa	FALSE
kmpbkfaaaa	FALSE
knachaaaag	FALSE
lgjidfaaaa	FALSE
lglabfaaaa	FALSE
maomiiaaaa	FALSE
mbbjgnaaaa	FALSE
mmabdcaaaa	FALSE
mmacneaaaa	FALSE
ngkgbgaaaa	FALSE
ngmagjaaaa	FALSE
objhiiaaaa	FALSE
obmjpkaaaa	FALSE
olmmebaaaa	FALSE
olnebmaaaa	FALSE
pgfmjpaaaa	FALSE
pgggilaaaa	FALSE
aaamkfnmghn	TRUE
aabgkiekokl	TRUE
ajikdhailfh	TRUE
ajikgdjkoke	TRUE
bdfifmloabc	TRUE
bdhdidlddbm	TRUE
bobmlnnghfe	TRUE
bofdddicjkh	TRUE
cibknlpbihe	TRUE
cicciaijflh	TRUE
dbinnelbfnl	TRUE
dbjjejgmngh	TRUE
dlhaknjckgj	TRUE
dlhbndljcod	TRUE
eglcelhogmb	TRUE
eglhocobnlh	TRUE
famappiedgo	TRUE
famkpkdmhdf	TRUE
fknmbiacjgp	TRUE
fkofaolcoll	TRUE
gellnldffpi	TRUE
gelooefolgb	TRUE
gohoblhpgdn	TRUE
goiomlfggde	TRUE
hkebamnpimm	TRUE
hkeplclmame	TRUE
iebldbopham	TRUE
iecamaopldj	TRUE
iofcdgddecc	TRUE
iogimijkpca	TRUE
jilemfpoljb	TRUE
jinandmkcgc	TRUE
kbkcelkijlh	TRUE
kbkgackpfbh	TRUE
kmfefkbdibc	TRUE
kmgjjcdolfg	TRUE
lgpngmojged	TRUE
lhbjlbdkpfc	TRUE
mapchepfcjn	TRUE
maphgmpaijh	TRUE
mmhnnaaciko	TRUE
mmieibicbmi	TRUE
ngifgonmeei	TRUE
ngioecojeba	TRUE
obfgcneigde	TRUE
obfjknpkbbe	TRUE
olfknahdloa	TRUE
olgbaomnmlc	TRUE
pfpgoaehgoo	TRUE
pfpimpkaclg	TRUE
aaangjhaaaa	FALSE
aaapffoaaaa	FALSE
ajfmagjaaaa	FALSE
ajgippiaaaa	FALSE
bcoddidaaaa	FALSE
bcoobfbaaaa	FALSE
bnphppdaaaa	FALSE
bnppkdfaaaa	FALSE
ciobegdaaaa	FALSE
ciolglfaaaa	FALSE
ddjadgoaaaa	FALSE
ddjdfocaaaa	FALSE
dnnmfjiaaaa	FALSE
dnppdbbaaaa	FALSE
eihecedaaaa	FALSE
eiinnliaaaa	FALSE
fckbpplaaaa	FALSE
fckifdiaaaa	FALSE
fmgjmjpaaaa	FALSE
fmhcmnoaaaa	FALSE
ggbeeedaaaa	FALSE
ggecnelaaaa	FALSE
gpmdiphaaaa	FALSE
gpnibnoaaaa	FALSE
hjjofbfaaaa	FALSE
hjkkejeaaaa	FALSE
idclhgdaaaa	FALSE
iddmalkaaaa	FALSE
inahbjjaaaa	FALSE
inbindiaaaa	FALSE
jheeimkaaaa	FALSE
jhgkaahaaaa	FALSE
kbnbkjjaaaa	FALSE
kboencfaaaa	FALSE
kmpalhfaaaa	FALSE
kmpbimcaaaa	FALSE
lhpnboiaaaa	FALSE
liackkjaaaa	FALSE
mcbhgjcaaaa	FALSE
mccdjbiaaaa	FALSE
mmapbpgaaaa	FALSE
mmblimjaaaa	FALSE
ngkccdpaaaa	FALSE
ngmbabbaaaa	FALSE
oadflghaaaa	FALSE
oaegokbaaaa	FALSE
okhbijoaaaa	FALSE
okhkgmiaaaa	FALSE
pfgdiioaaaa	FALSE
pfhcnoaaaap	FALSE
aaangjhffobn	TRUE
aaappkldpkgb	TRUE
ajfendedpjpo	TRUE
ajfkogeffhjh	TRUE
bdccbeccbeli	TRUE
bdcfngciacja	TRUE
bocpochlgeed	TRUE
bodkdeajiank	TRUE
cicpelpchpcj	TRUE
cidipamcammm	TRUE
ddjbiadmfcgi	TRUE
ddkaflpflkpg	TRUE
dnjebglfcfla	TRUE
dnlpdjjboceo	TRUE
ejapmapehbhl	TRUE
ejbapijnhijl	TRUE
fddheogoahgn	TRUE
fdemehgkofbi	TRUE
fncdahhppbgh	TRUE
fndbiikffdca	TRUE
ggfaindmignp	TRUE
ggfkbkgikjbk	TRUE
gpncobkjbljh	TRUE
gpnidneadmch	TRUE
hjgkaiahikfa	TRUE
hjhdkhgnmmpj	TRUE
idbjhjpmfial	TRUE
idcggackohjp	TRUE
inkpelpgpdhh	TRUE
inldeamibcpg	TRUE
jhhjeolncdmp	TRUE
jhiadjkdcdln	TRUE
kbmccpjhadda	TRUE
kbmcplhjimdk	TRUE
kncbpgmekfbo	TRUE
kndhgillcmko	TRUE
lgpfeoichodn	TRUE
lgpinannihcf	TRUE
mbojnpoofjae	TRUE
mbpalpnnipin	TRUE
mmipgmhfnffk	TRUE
mmjemlnpigdh	TRUE
nfocpehjbfmc	TRUE
nfodlfigidal	TRUE
oaeicfbdbnkg	TRUE
oaeigamfobge	TRUE
ojdikeoeadih	TRUE
ojefoehaomnb	TRUE
pepdhmikjcla	TRUE
pfafdfpipdmj	TRUE
aaaclbjdaaaa	FALSE
aaaokhplaaaa	FALSE
akdfmgajaaaa	FALSE
akdlkcofaaaa	FALSE
behgohchaaaa	FALSE
beibhapnaaaa	FALSE
bphjnjbgaaaa	FALSE
bpifeljnaaaa	FALSE
cihfdhffaaaa	FALSE
ciifjdjiaaaa	FALSE
dcopoahpaaaa	FALSE
dcpidnobaaaa	FALSE
dmgfbjngaaaa	FALSE
dmiajnhiaaaa	FALSE
efhdoailaaaa	FALSE
efidpbbiaaaa	FALSE
faccapjjaaaa	FALSE
fadclaoaaaaj	FALSE
fllkaanpaaaa	FALSE
fllpebimaaaa	FALSE
gfioemijaaaa	FALSE
gfjelngoaaaa	FALSE
hahomnhmaaaa	FALSE
haiohdobaaaa	FALSE
hknbebiaaaao	FALSE
hknmcgddaaaa	FALSE
ieobaonhaaaa	FALSE
ieobklmeaaaa	FALSE
ipnbepgiaaaa	FALSE
ippfebneaaaa	FALSE
jjpbncadaaaa	FALSE
jkajajhfaaaa	FALSE
kembjpepaaaa	FALSE
kemgllnbaaaa	FALSE
kpepmdikaaaa	FALSE
kpfemlkmaaaa	FALSE
ljggkagbaaaa	FALSE
ljgllekbaaaa	FALSE
mdbbpdmfaaaa	FALSE
mdcemicbaaaa	FALSE
mmjbnkahaaaa	FALSE
mmjfanfbaaaa	FALSE
ngiopmkeaaaa	FALSE
ngipmjkeaaaa	FALSE
objphiapaaaa	FALSE
obkiphciaaaa	FALSE
ombljflbaaaa	FALSE
omblkkimaaaa	FALSE
pfffngbkaaaa	FALSE
pffnbhbgaaaa	FALSE
aaaclbjdkhplb	TRUE
aaaomjchflphi	TRUE
akcncmpahdcpp	TRUE
akddbcpipogfn	TRUE
bfcldnpmkpaop	TRUE
bfdmmgndnohab	TRUE
bpffoepbdbcln	TRUE
bphdfjclhpohe	TRUE
cjblcnogpfkke	TRUE
cjcickkacgibh	TRUE
dclgncpkjdnnb	TRUE
dclngmlpjmada	TRUE
dmfoekgegfcno	TRUE
dmglcimefjgch	TRUE
eghkmhmligpng	TRUE
eghoppiolhekc	TRUE
fadghmdfnnakd	TRUE
fadlcikoeeanh	TRUE
fkojcgcaknneb	TRUE
fkokefjgaalog	TRUE
gfolknmfhhmbc	TRUE
ggaemfinbejdk	TRUE
haghinhmkdlcb	TRUE
hagkjaimlcceg	TRUE
hjppelobeblgm	TRUE
hkamepepnefhe	TRUE
ieppjbcljhjmn	TRUE
ifahpfcalhhco	TRUE
ipoddndifmlha	TRUE
ipphhobfilfmm	TRUE
jkgempdcjnpbk	TRUE
jkgfajhbjhoih	TRUE
keeedncdclhcd	TRUE
kefcolhbngnel	TRUE
kpgbkafggokcl	TRUE
kpgjegpacfgdo	TRUE
ljfgaimcoceag	TRUE
ljfggbcapiaab	TRUE
mclpmofgeombm	TRUE
mcmjbdmpdmlhi	TRUE
mmkllebholhda	TRUE
mmklpdomdglmb	TRUE
nhhfnmckmfnia	TRUE
nhhpalkgojnhg	TRUE
ocalhoccdfdmj	TRUE
ocbabmoafbifn	TRUE
omabcclpecjcl	TRUE
omabolkanafpf	TRUE
pffgogonfeahk	TRUE
pfihkpofcfpjj	TRUE
aaaclbjdkaaaa	FALSE
aaaohplbmaaaa	FALSE
akeigegboaaaa	FALSE
akfgeeaihaaaa	FALSE
beagfbmgpaaaa	FALSE
beakbhinhaaaa	FALSE
bpdnhappaaaaf	FALSE
bpemblkddaaaa	FALSE
cilembbloaaaa	FALSE
cilgcjcjjaaaa	FALSE
dckbnkllfaaaa	FALSE
dckgbikhoaaaa	FALSE
dmefkkeicaaaa	FALSE
dmfacgibhaaaa	FALSE
efmnmbfpeaaaa	FALSE
efodfpihfaaaa	FALSE
fabkkieldaaaa	FALSE
fabmhgodeaaaa	FALSE
flgfojbihaaaa	FALSE
flghemhbgaaaa	FALSE
ggcpnlfkoaaaa	FALSE
ggdadapijaaaa	FALSE
haenclbkpaaaa	FALSE
hafhomaonaaaa	FALSE
hkehjmaggaaaa	FALSE
hkiccpkgaaaab	FALSE
ieiklfndfaaaa	FALSE
ieinnddnoaaaa	FALSE
ipnomdgglaaaa	FALSE
ipoigndppaaaa	FALSE
jjjhimkhfaaaa	FALSE
jjleophcbaaaa	FALSE
kegengombaaaa	FALSE
kehcildejaaaa	FALSE
kpcpomckaaaag	FALSE
kpdmbbfhkaaaa	FALSE
ljkcghafaaaag	FALSE
ljkhgmemcaaaa	FALSE
mdcmeinpbaaaa	FALSE
mddmnmlldaaaa	FALSE
mmpnknjocaaaa	FALSE
mnbkflkneaaaa	FALSE
nhokpafmiaaaa	FALSE
nhoofkcknaaaa	FALSE
ocfmimmcoaaaa	FALSE
ocgenmfngaaaa	FALSE
ollpknnclaaaa	FALSE
olmemcbeaaaag	FALSE
pgfdknbcdaaaa	FALSE
pgfhanjdaaaal	FALSE
aaaakcdiaoabab	TRUE
aachppbkcpljkh	TRUE
akbpddcljmhbgk	TRUE
akciegjakifdho	TRUE
bebbjldkhahjae	TRUE
beccclfapmefab	TRUE
bolenehdghckbk	TRUE
bolokkdhaeljmo	TRUE
cjdeojfbfamcog	TRUE
cjdhelkmicnkjo	TRUE
decdpkokfjcegb	TRUE
declakhffpkhdk	TRUE
dofjhoeombcibd	TRUE
doghlfkfkamjme	TRUE
eiahgigmmgdlgk	TRUE
eiangaodcjckbn	TRUE
fbnahdiedcicnc	TRUE
fbngifkcghigif	TRUE
fljoonkmeglofn	TRUE
flkliclninjdcl	TRUE
ggkekbcghpldip	TRUE
ggldcokgacebop	TRUE
hbcibphgoldgbf	TRUE
hbdgdbabeaomah	TRUE
hlhlfpklflaene	TRUE
hligoenahgkjdo	TRUE
igepckeadmabob	TRUE
igfjedjlnfajcj	TRUE
japmbfkgapjkbj	TRUE
jbanhmghmcmjfi	TRUE
jlhedljkblimel	TRUE
jlhfnpdflefacj	TRUE
khdobecdjceomh	TRUE
khflanmbofjfae	TRUE
lbkcnbcjpjiomn	TRUE
lblcmlpmbningm	TRUE
llkbmllgjjkkmo	TRUE
lllafkmikpobno	TRUE
mfdebamcdgccjp	TRUE
mfdececafonkdl	TRUE
moifllkbojklil	TRUE
moiggeiiabbjhg	TRUE
nhhgblmalifpen	TRUE
nhibbdfagpicpo	TRUE
oboebocioakhge	TRUE
obojkeallkgbnm	TRUE
oloeeeklhhnfpk	TRUE
olpdafbdkedmih	TRUE
pfplihidlliila	TRUE
pfpoogbhlongad	TRUE
aaabdmlihcaaaa	FALSE
aabadkanndaaaa	FALSE
ajiimdgpllaaaa	FALSE
ajinnoplocaaaa	FALSE
bemnbaiddfaaaa	FALSE
benaofepakaaaa	FALSE
bohiibemolaaaa	FALSE
bohnbembmkaaaa	FALSE
cifknohlmfaaaa	FALSE
ciggoiakbpaaaa	FALSE
dbfhpcjbofaaaa	FALSE
dbfjjfmoolaaaa	FALSE
dlghgljpahaaaa	FALSE
dlglobgkclaaaa	FALSE
egchbfjpepaaaa	FALSE
egeihnokhbaaaa	FALSE
faklaebcndaaaa	FALSE
famgcccccmaaaa	FALSE
fkhocllmgiaaaa	FALSE
fkjbngcojbaaaa	FALSE
gfcffaakdcaaaa	FALSE
gfdemjaobjaaaa	FALSE
hamajipkpoaaaa	FALSE
haomahlkjmaaaa	FALSE
hkliheccfgaaaa	FALSE
hklmligaohaaaa	FALSE
iecnpofcfnaaaa	FALSE
ieebidhladaaaa	FALSE
ipbdllecmlaaaa	FALSE
ipceopombgaaaa	FALSE
jkgbeceobkaaaa	FALSE
jkghlekfigaaaa	FALSE
kemjgpfajmaaaa	FALSE
kenbaiaibfaaaa	FALSE
kofpgplojnaaaa	FALSE
koglblfddoaaaa	FALSE
lielmbkpmiaaaa	FALSE
lifickakglaaaa	FALSE
mcbaohgekjaaaa	FALSE
mcbofccdhcaaaa	FALSE
mmnbfommkhaaaa	FALSE
mmnpfogbmaaaap	FALSE
ngonbnmacbaaaa	FALSE
ngookbllbcaaaa	FALSE
obkkclijhhaaaa	FALSE
obkmjgbnijaaaa	FALSE
olnamfembnaaaa	FALSE
olndnbpojeaaaa	FALSE
pfnkhmonkmaaaa	FALSE
pfobbaoeheaaaa	FALSE
aaabdmlihcadcka	TRUE
aabndamlonkbcdj	TRUE
ajkmifjieghambm	TRUE
ajmooaehhdcecic	TRUE
bfdmjclhjjchgbo	TRUE
bfdpbogmdidkpcl	TRUE
boffobaemonfhna	TRUE
bofhcooonknmmfj	TRUE
chjflhilllfcmgc	TRUE
chkahkfajgdjddd	TRUE
dbhcknjhpfipchn	TRUE
dbhdcipdenbfibb	TRUE
dmadampfbopbcfh	TRUE
dmbcgcoicmhpocg	TRUE
ehcbpanfbahknll	TRUE
eheadealjochcgg	TRUE
fahecnniojfionb	TRUE
fahhieckebomfcm	TRUE
flckbiabpnllcme	TRUE
fldhjgibfpnignk	TRUE
gemdkgoafbanapj	TRUE
gemeecchkjgbfmh	TRUE
hafpicgpffklhdm	TRUE
hajmnmncblmoapd	TRUE
hlblbeiaohpmeaj	TRUE
hlbliiejdllfbbe	TRUE
ifgkdmpeohdaffp	TRUE
ifgkhmnohoabnno	TRUE
ipbfhdffplmlnlb	TRUE
ipbgojibebgddce	TRUE
jlocpfgnegfdfko	TRUE
jlpfofpcbmpmikd	TRUE
kfamjdcihjpiibc	TRUE
kfboeccefkjddel	TRUE
kohjfkligkgakfl	TRUE
koifdokeankgpcp	TRUE
lhiaabmeeghjgho	TRUE
lhigilikechhdij	TRUE
mcboadoklipcabm	TRUE
mccehifmfjhfhmc	TRUE
mlomhfnnghkoeed	TRUE
mmdabncdiolmnjf	TRUE
nheambmfbdmmilp	TRUE
nheljapfodpbnja	TRUE
oaphcbfbmpjlegb	TRUE
obaaplhliiblban	TRUE
okpifkbdapmpimf	TRUE
okpmgemfmmocbao	TRUE
pfnecookmaoljke	TRUE
pfnkfacidjaleeh	TRUE
aaaokkkaebkaaaa	FALSE
aaaoldanoneaaaa	FALSE
ajmfjmmkgbcaaaa	FALSE
ajmjgmdajapaaaa	FALSE
bdnkhdgmpmhaaaa	FALSE
bdpahbknnacaaaa	FALSE
bolpgbmdfgmaaaa	FALSE
bomnkliihcbaaaa	FALSE
cidklajcoinaaaa	FALSE
cieffjgnflfaaaa	FALSE
ddbnlepbhemaaaa	FALSE
ddeebpcnempaaaa	FALSE
dodgpfopfdmaaaa	FALSE
doebddcadmlaaaa	FALSE
eiekppaepamaaaa	FALSE
eielkpfcnioaaaa	FALSE
fdllefaimigaaaa	FALSE
fdnfhapccgnaaaa	FALSE
fmobiehfkfbaaaa	FALSE
fmoheodadmiaaaa	FALSE
ghdjpkcbcfiaaaa	FALSE
ghdkoghalomaaaa	FALSE
hbaiaooidiiaaaa	FALSE
hbanfpagdeaaaae	FALSE
hlpbhhopcobaaaa	FALSE
hlpgmkogmegaaaa	FALSE
igkpnoploibaaaa	FALSE
iglgokpikpfaaaa	FALSE
jagmniahkanaaaa	FALSE
jagokagdkchaaaa	FALSE
jjmbhgdnlnmaaaa	FALSE
jjnkadpecaiaaaa	FALSE
kdoaclbagdlaaaa	FALSE
kdpkkkbjmdeaaaa	FALSE
kmppfbgkohfaaaa	FALSE
knaaamdafnjaaaa	FALSE
lgpjjfkmiahaaaa	FALSE
lgpkhidmnloaaaa	FALSE
mbdmaohahfbaaaa	FALSE
mbehnalgkcdaaaa	FALSE
mmhlkecnclmaaaa	FALSE
mmhofjefpfbaaaa	FALSE
nfjhckdmnmaaaaf	FALSE
nfkpnahenahaaaa	FALSE
oajadfppolbaaaa	FALSE
oajpnejfhlnaaaa	FALSE
okpmheopehcaaaa	FALSE
olceoehdembaaaa	FALSE
pfpfmgnplefaaaa	FALSE
pgaajbbnfiaaaap	FALSE
aaaokkkaebkdanon	TRUE
aaaoledgkmgjjlgh	TRUE
ajmgakmbocffnkjg	TRUE
ajmnolmpkgilcabp	TRUE
bebnicnjdkbpdpac	TRUE
becfpjoeecnbeeob	TRUE
bopieimpoolodcna	TRUE
bpacgijgjpjnlbah	TRUE
cipdobfhoedegagl	TRUE
cjappoicmgbenleg	TRUE
dcpjlnpfafemfgda	TRUE
ddaciaichchonbhf	TRUE
dnhcpeokhdbekmmd	TRUE
dnhimilbcbifmaja	TRUE
ejedheiochkhadah	TRUE
ejgpopaecplmkdnj	TRUE
fcnmifhmamjedjge	TRUE
fcoaahghdolmkdie	TRUE
fmofakfkiadojedj	TRUE
fmpadminjaejfmaa	TRUE
ggliiknhcmfblppe	TRUE
ggpacjhhlkgcjlao	TRUE
hbanodjbbljgiomo	TRUE
hbcbmdcgmecmobck	TRUE
hlpnlacieapnbeah	TRUE
hlpnlelnmjlbjcel	TRUE
ifphgbcbjmndcnio	TRUE
ifpkclefcjgkfbcp	TRUE
jahbgnhhljjhhfhn	TRUE
jahopgjfkjpkpbnc	TRUE
jjapiimpeiafihjp	TRUE
jjbccdmpcncdlmoj	TRUE
kdjoocfjdjnfdmmd	TRUE
kdkinfefkgcggjpm	TRUE
kmodempkdpoibhoo	TRUE
kmojbkonkbbhonoc	TRUE
lgogjmpaleggakio	TRUE
lgpjpijlclpoppfj	TRUE
mbejchlnlhibdgkd	TRUE
mbgpipipadmnjfpi	TRUE
mlnikgbnegpkcbjm	TRUE
mlojhmbgbdekjhhf	TRUE
ngolkeifnkhegpil	TRUE
ngpbicplljljpgip	TRUE
oaingepinbekoapj	TRUE
oajbelpohigkkihf	TRUE
olhlfhdkjaniffie	TRUE
olkaimmknopnkaeb	TRUE
pfpjffehgkpghbkk	TRUE
pfpkmnpkcnenlnbb	TRUE
aaabhdeeinojaaaa	FALSE
aadaenlmbfaiaaaa	FALSE
ajnhhhkgigpoaaaa	FALSE
ajpbdellofpnaaaa	FALSE
bdfmkgdbamkmaaaa	FALSE
bdfmleeacehmaaaa	FALSE
bmpeddckedkbaaaa	FALSE
bnbifkoceifpaaaa	FALSE
chbpkeaikmcaaaac	FALSE
chcfnolindfaaaao	FALSE
dbmlnkdiifkfaaaa	FALSE
dboeoojhgbkeaaaa	FALSE
dljoalggkbkpaaaa	FALSE
dlkdfjgfnfjdaaaa	FALSE
eekiclfnoglcaaaa	FALSE
eelcgdbjbojdaaaa	FALSE
epedbjjafbcbaaaa	FALSE
epedegbomjgjaaaa	FALSE
fjbpglpkhmaoaaaa	FALSE
fjcdbnhdjjbmaaaa	FALSE
gdkhdneoccgaaaan	FALSE
gdlgcejomdgjaaaa	FALSE
goclmnlahielaaaa	FALSE
godeabfhbcjoaaaa	FALSE
hhkcbkogddfjaaaa	FALSE
hhkljlnicgahaaaa	FALSE
idaajngfmpebaaaa	FALSE
idaiplfnbmhdaaaa	FALSE
inibibclncalaaaa	FALSE
injinccgdkgcaaaa	FALSE
jibcjmkdbgpjaaaa	FALSE
jicmmicmjodpaaaa	FALSE
kdfgobdabdjnaaaa	FALSE
kdfighlcldpjaaaa	FALSE
knlcnkeegnapaaaa	FALSE
knmmbjoegablaaaa	FALSE
limciehjfachaaaa	FALSE
limjopdlhdjiaaaa	FALSE
mdhllkccngkoaaaa	FALSE
mdiejnnncogpaaaa	FALSE
mmjhailjdhdjaaaa	FALSE
mmjolffabinhaaaa	FALSE
nhickfnhlgneaaaa	FALSE
nhidhhiglijlaaaa	FALSE
obnablbdnbabaaaa	FALSE
obofdfoonihdaaaa	FALSE
olcmichfapgoaaaa	FALSE
oldhlfiahoecaaaa	FALSE
pfofjiiigoecaaaa	FALSE
pfohpkmjohmbaaaa	FALSE
aaakkhfgjehddpapo	TRUE
aabdihcilebklkijb	TRUE
ajpjkjcmackpnjlgd	TRUE
akafmibpeekanjkmk	TRUE
bfmlpflmjllpenjkf	TRUE
bfngldpbbbdhkainl	TRUE
bpichljnmobjnajhc	TRUE
bpkipdeggbnfoejbi	TRUE
ciillphiijpponkbd	TRUE
ciiojdaelmbdeckab	TRUE
dcoibhfgnffnamedb	TRUE
dcpbafieechndeopg	TRUE
dmmagbgibpdfgicgb	TRUE
dmmfkodcheohppgip	TRUE
eflpphgbefmfmhmbb	TRUE
efmmpadffjibofcoa	TRUE
fbdkhlaabladilmld	TRUE
fbdklkmfchghenejp	TRUE
flndnlnkkccohjddc	TRUE
flnojandcmmpkdaaf	TRUE
gfliibhadjaofgkld	TRUE
gfmnmhcodnbibeghn	TRUE
gpklglbnjkclljhkk	TRUE
gpmcpnmpkebcledaa	TRUE
hlbchafdjnhbncajh	TRUE
hlbipidpmdaoehlao	TRUE
ieomffiikclmopohh	TRUE
ifbafabhbippgodpi	TRUE
ioikdmblnapgegogi	TRUE
iojdpnkiolefpcbon	TRUE
jimbkkifkblfbeced	TRUE
jimidhnnoojjefhke	TRUE
kecnlojoakicfcjep	TRUE
kedbeinokgdinbjgk	TRUE
koeeoaggpponcngge	TRUE
koejidkmegpjgcijb	TRUE
libalpapddnccalig	TRUE
licfffopochejcljd	TRUE
mckmppmocaiolngba	TRUE
mclmekdfgfnkboopo	TRUE
mnbmfoceoaoahalfm	TRUE
mncaflelenngmemem	TRUE
nglfgjgecoigaadle	TRUE
ngmhnjacggomgmajg	TRUE
obmipdhpndhbehejo	TRUE
obmmnddhibmohface	TRUE
olpdakicjkfinfclj	TRUE
omaonjeleddkbiggd	TRUE
pfjoplcckdfnjeokn	TRUE
pfkhimjndbcidjjoj	TRUE
aaakkhfgjehddaaaa	FALSE
aabapdoihcileaaaa	FALSE
ajomnbokobibpaaaa	FALSE
akaceokmbflccaaaa	FALSE
benleiahdgjjfaaaa	FALSE
beokmagfbnohjaaaa	FALSE
bpiahapilnhanaaaa	FALSE
bpiccepfmodjbaaaa	FALSE
cjdiihokljmajaaaa	FALSE
cjdkkgdlaoafjaaaa	FALSE
dcknbifekdnpjaaaa	FALSE
dclahechddpolaaaa	FALSE
dlkmoenhnjlfnaaaa	FALSE
dllkmlpkjbbbcaaaa	FALSE
eghmkbegbpnbkaaaa	FALSE
eghndifnlichkaaaa	FALSE
fakkinejofiacaaaa	FALSE
famghnflonpmnaaaa	FALSE
flbalidcmgbkjaaaa	FALSE
flbidjkgcbfopaaaa	FALSE
gfipiocolfgdjaaaa	FALSE
gfjdmgocnklliaaaa	FALSE
gpnechfblamikaaaa	FALSE
gpniijnaelhgdaaaa	FALSE
hmbjlmcfdlhkcaaaa	FALSE
hmbobcjpohaejaaaa	FALSE
ifbglnppcgdapaaaa	FALSE
ifbolmfoemfmfaaaa	FALSE
iocjnclclcibkaaaa	FALSE
iocoobocmcemmaaaa	FALSE
jibphahdhcgloaaaa	FALSE
jiepleglhbficaaaa	FALSE
kdpdogdnjkfagaaaa	FALSE
keaipnfpmhibnaaaa	FALSE
kohobgnegdncnaaaa	FALSE
koialcahhfgcmaaaa	FALSE
ligochllioodfaaaa	FALSE
liilmfnepfifhaaaa	FALSE
mcfdbolhpfeceaaaa	FALSE
mcfhnphkegaidaaaa	FALSE
mnhjkjjhhandcaaaa	FALSE
mnhnejhobcbkhaaaa	FALSE
ngjjillkhajhlaaaa	FALSE
ngmcficeclbndaaaa	FALSE
obmbnhlckdfgmaaaa	FALSE
obphodgkjofjoaaaa	FALSE
olfnbophcnjlmaaaa	FALSE
olgecfadjaeehaaaa	FALSE
pfmnpldhmcbnhaaaa	FALSE
pfnnlmmflncfjaaaa	FALSE
aadpcdhiifipldhlgd	TRUE
aaelmaelfbpeagbdjo	TRUE
aklllkocnaohdgbajd	TRUE
akmclicigibbgfcpma	TRUE
bgcopdnmdaghnpofan	TRUE
bgdkckebolmfhiooog	TRUE
cacgmdimgngnjkfjal	TRUE
cadplpkdmlbakpihek	TRUE
cjnnolkloilkfbfkmk	TRUE
cjokinicepobjfmaol	TRUE
ddofdnnkigbcoonofi	TRUE
dedpjgcaepdjkmkmck	TRUE
dogpmbbjenocckehje	TRUE
dohplkfgomikognaal	TRUE
eijdenomnipciagcni	TRUE
eijmknegdfpofopppg	TRUE
fcnbfaiojoampdcmag	TRUE
fcndnhkhhnfobbkfhg	TRUE
fmpgmlfjdegifponco	TRUE
fnbhegffapiomgenem	TRUE
ggohjbbepnkiefgjnp	TRUE
ggojjgbhmcbaolclnh	TRUE
hbfacdoginahghpokd	TRUE
hbfcaepobfepiijmbn	TRUE
hkampjngkeeajnkjcb	TRUE
hkbfpfalebbciiahpf	TRUE
idijckjhiehjldjgop	TRUE
idimjcbpmblkdbaldb	TRUE
iodpenkkaclgeafbmb	TRUE
iofclfiangjhhjkodh	TRUE
jjcglonbgkgebdjdie	TRUE
jjedlcogkdhhmpccfc	TRUE
kcknlcgamjgiocfckl	TRUE
kclfenpihljlnnfabc	TRUE
knllgbfledjhpnmaib	TRUE
knmmplokmnfmodbmme	TRUE
lhnpganpnmmmbpfnff	TRUE
lhogmjgdkojnbnmjhf	TRUE
mclhmkbnglafnagabo	TRUE
mclmgioljipmbmnkhn	TRUE
mlopipggcmbmblobji	TRUE
mlpagggedmiaebipgd	TRUE
nfhkamopamiachgihl	TRUE
nfjamffgpbbknnkmfn	TRUE
npphdmbimbgfmgnhgi	TRUE
oaaknfabajkfonfaap	TRUE
okchkomdoodnhpoppd	TRUE
okdhfbakheaochgamd	TRUE
peejlenabjcfkbongn	TRUE
peekaaoempkeflcdfi	TRUE
aabcllmhomhhgkaaaa	FALSE
aabhcndfamgmbkaaaa	FALSE
aiohkcmhjngbmbaaaa	FALSE
aiphaheffpigedaaaa	FALSE
bdefbecgmdbojfaaaa	FALSE
bdeipfamnnioiaaaan	FALSE
bnjcogjmajkplbaaaa	FALSE
bnlbnnblggioamaaaa	FALSE
chjblncimgaofcaaaa	FALSE
chkdgkjlodadbaaaam	FALSE
dcfeeafmonglacaaaa	FALSE
dchfbkeebnlaejaaaa	FALSE
doopfeonimfkenaaaa	FALSE
dopbbkkimicdjhaaaa	FALSE
ekcfgnjpippinmaaaa	FALSE
ekckfomgadokdjaaaa	FALSE
fdmdhcdjlplalcaaaa	FALSE
fdnckjlfghdjlhaaaa	FALSE
fohkeofokoojelaaaa	FALSE
fohpnndlapfjcnaaaa	FALSE
giehomdkmgofpjaaaa	FALSE
gielpfkenifjieaaaa	FALSE
hcedompefkmljhaaaa	FALSE
hceoejlambemfoaaaa	FALSE
hmpbhlogjdpejpaaaa	FALSE
hmpcimmdlakgokaaaa	FALSE
ihhfggmeaghfhaaaah	FALSE
ihhlfjebfleicfaaaa	FALSE
jcaobommnjaomiaaaa	FALSE
jccanhlfncmpgfaaaa	FALSE
jlnhhbgomkafjoaaaa	FALSE
jlnmbpabhbpfmpaaaa	FALSE
keobehnpggokoeaaaa	FALSE
keobfhncocfmebaaaa	FALSE
kpgnelnbijnlefaaaa	FALSE
kpkioahchohlhfaaaa	FALSE
ljmbcafcicbpioaaaa	FALSE
ljmljffjnhdcbgaaaa	FALSE
mfgccannjgdffgaaaa	FALSE
mfgobhpfihdaccaaaa	FALSE
mnmjijfgfgpjoiaaaa	FALSE
mnnhhpchegkcapaaaa	FALSE
nhlkhkcljcodkkaaaa	FALSE
nhnjfgjlidpcdnaaaa	FALSE
occbmgnfeommcnaaaa	FALSE
occnildgolgapfaaaa	FALSE
olobcihnbgmkalaaaa	FALSE
olomffnojndoidaaaa	FALSE
pfohpabgjnlieeaaaa	FALSE
pfokmeifedkgdhaaaa	FALSE
aabcllmhomhhgkcndfa	TRUE
aabhmgmbkejfblkbnld	TRUE
aipapbdhnmcfncibdmg	TRUE
aipiikocakbimamepni	TRUE
bcidppaknipokfmmeok	TRUE
bckfcbfdgdkjppheamk	TRUE
bnflmehdkoiimmbbcdd	TRUE
bnfmaegbkdahhlkgjdd	TRUE
cieccfhjgcbebmcmjpo	TRUE
cieicofllhcggmiehcp	TRUE
dchlmilmcfdankhhgdl	TRUE
dcikikekdaampfopikc	TRUE
domgiionfjobofgiflh	TRUE
doodjbljmneanlenngd	TRUE
ejioiedcaehnpfofbli	TRUE
ejipbejifcfpbmeimon	TRUE
fdiejlambemfobplill	TRUE
fdihocikipghbeoadjh	TRUE
fobhcaeoodilhajagec	TRUE
fobjecpagdnmpnedflc	TRUE
gibhekakkemjadbbekn	TRUE
gicfflllgobnckolhld	TRUE
hbkconcnnhfdnkgbeek	TRUE
hbkeejdbjlhebiaklad	TRUE
hmkbnikckjnfnkilkpm	TRUE
hmkiacbilmkdabalnga	TRUE
ihedccjjolphffpijip	TRUE
ihenkahgnapimiieppk	TRUE
jboikbhoooplbhocggf	TRUE
jbpcboodcpkimdflcdd	TRUE
jmblhjfbhdkdnbjnmhj	TRUE
jmcccmpfeohclfgpdoo	TRUE
kekildgolgapfeipgfa	TRUE
kekniegofechnioppoo	TRUE
kpfjibogapalhbfacgc	TRUE
kpfkohgjddaicloghdg	TRUE
ljnlggeppficnaionkf	TRUE
ljokdfgfpidgeefnfee	TRUE
meckdgplmgfmkicipbj	TRUE
mecmafjkgmojknbklda	TRUE
mnlmkknllmcgpgnidne	TRUE
mnmhnleahniflmmppfh	TRUE
niillfkobfaladcofbl	TRUE
niincnkiohcoflhgkci	TRUE
ocpbhmjbbhimjbimkje	TRUE
odachfcpaheekenlbbf	TRUE
oljhcodbljdifiojdnn	TRUE
oljhdobcjbbppjplcpb	TRUE
pfpoobdchcmodoemmeg	TRUE
pgaphofhghkdpkmlphk	TRUE
aabajaapoleefgoaaaa	FALSE
aabdnjiffppnohfaaaa	FALSE
ajkgkalcbjhffhgaaaa	FALSE
ajklbdmgagcaacoaaaa	FALSE
beggimicfplegglaaaa	FALSE
behadjebkapiodhaaaa	FALSE
bnpfkdhaoeanjflaaaa	FALSE
boadmcpolepdiobaaaa	FALSE
cideohniillbfniaaaa	FALSE
cidonclpfloiadjaaaa	FALSE
ddjbaeaggmdpdnnaaaa	FALSE
ddkkmlnlhoppmfnaaaa	FALSE
dnhciephddgbcflaaaa	FALSE
dnhcmppdakfakadaaaa	FALSE
egkffpnoobjfjfmaaaa	FALSE
egnbogajdpoendgaaaa	FALSE
ephbajjcaegmpgiaaaa	FALSE
epjmceokckhlmcnaaaa	FALSE
fkpdcghocjppjacaaaa	FALSE
fladgmnbnkdnephaaaa	FALSE
gfeenfjnfmkpbjlaaaa	FALSE
gfggifmjhdjallnaaaa	FALSE
gpfcnmdlkpknamkaaaa	FALSE
gpgabgaglchflfcaaaa	FALSE
hkhdgciccgpjiilaaaa	FALSE
hkipefaippebjjnaaaa	FALSE
iefniccjeinkbbeaaaa	FALSE
iegbbonfcjmljgpaaaa	FALSE
ioicmklebadmddiaaaa	FALSE
ioimocahfgakphfaaaa	FALSE
jilgbiaagfabmnhaaaa	FALSE
jillikobllkbkdcaaaa	FALSE
kdiamnfgimfhabbaaaa	FALSE
kdiandnbeemngecaaaa	FALSE
knlfeojemflgfnbaaaa	FALSE
knmaieegapngokkaaaa	FALSE
lijlkebgpoddgihaaaa	FALSE
lijllmdcpeepnjcaaaa	FALSE
mbpgobpaaihoggfaaaa	FALSE
mcancphedenednjaaaa	FALSE
mmbckkgfhofhlicaaaa	FALSE
mmbffnpjhfaamnhaaaa	FALSE
nfnofkkfipjfkpbaaaa	FALSE
nfojfigaldlecafaaaa	FALSE
obdkjlfdkagkklfaaaa	FALSE
obfbgobgbchinklaaaa	FALSE
oldpkcjopiglifiaaaa	FALSE
olebjoikfnkgfpaaaah	FALSE
pfidjffpbbnjdjdaaaa	FALSE
pfkdcgbhhmphnddaaaa	FALSE
