aaakemajpc	TRUE
aabaomllgd	TRUE
ajkdhcfkfe	TRUE
ajliaokabp	TRUE
bdkcgicanh	TRUE
bdkcicnpok	TRUE
bnemeciofb	TRUE
bnfgfacllj	TRUE
chbffdjjcf	TRUE
chbldmpaec	TRUE
dcbmohfapf	TRUE
dccmdjifaf	TRUE
dnhdbemaoc	TRUE
dnhnbiakao	TRUE
egpofkhdad	TRUE
ehfiahbjam	TRUE
fcekinedai	TRUE
fceoikgaba	TRUE
fnkmaihhch	TRUE
fnldojblfk	TRUE
ginidhnjii	TRUE
ginkpdbjjo	TRUE
hckngcgdbn	TRUE
hcmhcfbhob	TRUE
hngjokpinj	TRUE
hnjjjmagec	TRUE
iicaonhlda	TRUE
iicempofhp	TRUE
jdcbjemdpd	TRUE
jdelkpppbj	TRUE
jnclmpjjee	TRUE
jndelbohmb	TRUE
kgdfmgljfg	TRUE
kgeafagogb	TRUE
lblegcckgg	TRUE
lbljmiimbc	TRUE
lljlneicnk	TRUE
lljnfcemdc	TRUE
mgbnaojhap	TRUE
mgcbkobige	TRUE
molleopejp	TRUE
molobapmbi	TRUE
nihkpjeoci	TRUE
niilhaodkf	TRUE
ocoocdgcka	TRUE
ocpciillpp	TRUE
omdodophpo	TRUE
omeapiifia	TRUE
pfdfopmihe	TRUE
pfdjclbhhm	TRUE
aaakemabab	FALSE
aabacnabab	FALSE
ajkeagabab	FALSE
ajkgnbabab	FALSE
bcnofiabab	FALSE
bcocbjabab	FALSE
bmpahmabab	FALSE
bnaeghabab	FALSE
cidbmdabab	FALSE
ciedeiabab	FALSE
dbkbonabab	FALSE
dblbnfabab	FALSE
dnhkafabab	FALSE
dnipedabab	FALSE
eieaooabab	FALSE
eiegkpabab	FALSE
fdcmolabab	FALSE
fddimababi	FALSE
foehonabab	FALSE
foemchabab	FALSE
giepdoabab	FALSE
gifpemabab	FALSE
hceideabab	FALSE
hcgmbdabab	FALSE
hndnohabab	FALSE
hnegclabab	FALSE
iijijnabab	FALSE
iijokcabab	FALSE
jblgijabab	FALSE
jbmcbcabab	FALSE
jmifbiabab	FALSE
jmindfabab	FALSE
khedchabab	FALSE
khepipabab	FALSE
lbhjipabab	FALSE
lbimndabab	FALSE
llcfhlabab	FALSE
llcjdhabab	FALSE
mfhhfdabab	FALSE
mfhiipabab	FALSE
mofkhoabab	FALSE
mofmcbabab	FALSE
nikadgabab	FALSE
nilgilabab	FALSE
ocgeicabab	FALSE
ocgeokabab	FALSE
okofceabab	FALSE
okpkfhabab	FALSE
pfilemabab	FALSE
pfipbiabab	FALSE
aaakemajpcn	TRUE
aabamllgdfj	TRUE
ajjdgoogkmk	TRUE
ajjfbchmicj	TRUE
bdbamndljfg	TRUE
bdbbfdealap	TRUE
bnihiaafoao	TRUE
bninicghffh	TRUE
chfmjdgdeme	TRUE
chglcgphpge	TRUE
dbjjmmlkfhd	TRUE
dbkdkgeihon	TRUE
dmlpnigaipi	TRUE
dmnadmgjngj	TRUE
eieaebaiadd	TRUE
eieamjfdiki	TRUE
fcljfdbaihh	TRUE
fcmchhdojbl	TRUE
fofnobffhah	TRUE
fogkdlgkkgk	TRUE
ghfolggngfi	TRUE
ghgpkmjefnf	TRUE
hckhnodhchn	TRUE
hckplbpoabh	TRUE
hnhckfjlgmp	TRUE
hnhdekjoobo	TRUE
iikjhhbjhgo	TRUE
iikkklenopn	TRUE
jcmbnjaidkc	TRUE
jcmdabiglje	TRUE
jmpiecpaihf	TRUE
jmpmkbcemnb	TRUE
khdmmokigem	TRUE
khfaondbdio	TRUE
lbhfhnfojgc	TRUE
lbhnjhfnnmf	TRUE
llkbaplgemo	TRUE
llmdcpcjgbb	TRUE
mfkgjjklimd	TRUE
mfklebplgme	TRUE
momhiiadhgm	TRUE
momihaklgcn	TRUE
njhpemhendi	TRUE
njhpknlchpg	TRUE
ocoincfdgde	TRUE
ocopalienka	TRUE
olfgieppeik	TRUE
olgfjhhnanb	TRUE
pfbfkckpibg	TRUE
pfdboedjlfb	TRUE
aacjlhmabab	FALSE
aafkailabab	FALSE
akpafbkabab	FALSE
akpffkhabab	FALSE
bffjpjkabab	FALSE
bfjfnhpabab	FALSE
bplfhecabab	FALSE
bpmceblabab	FALSE
cjihnjjabab	FALSE
cjioeadabab	FALSE
decbppcabab	FALSE
decfebdabab	FALSE
dnjkbnoabab	FALSE
dnlplcoabab	FALSE
eiaohklabab	FALSE
eibdcjlabab	FALSE
fcdgiafabab	FALSE
fcdgiopabab	FALSE
fmbglebabab	FALSE
fmcbcjeabab	FALSE
gfobfbaabab	FALSE
gfojdlhabab	FALSE
gpbjjfeabab	FALSE
gpbnpdnabab	FALSE
higdiigabab	FALSE
higlflfabab	FALSE
ibdonoaabab	FALSE
ibebbhlabab	FALSE
iljibjbabab	FALSE
iljnhjoabab	FALSE
jfnlbhnabab	FALSE
jfnonhjabab	FALSE
kbninidabab	FALSE
kboiekdabab	FALSE
kmghpoeabab	FALSE
kmhegmkabab	FALSE
lggnccbabab	FALSE
lghmcmlabab	FALSE
lpmpeciabab	FALSE
lpoancoabab	FALSE
mjakoajabab	FALSE
mjakppiabab	FALSE
nejcpomabab	FALSE
nelifjfabab	FALSE
npehhieabab	FALSE
npeknbiabab	FALSE
ojimlagabab	FALSE
ojklpajabab	FALSE
pfmhgcgabab	FALSE
pfmpnffabab	FALSE
aacjlhmkailf	TRUE
aafcjfofembl	TRUE
akmhheblicbk	TRUE
akmicmminhhb	TRUE
bgfbmicpjjan	TRUE
bgflilgpgpii	TRUE
bpkmgjlelhla	TRUE
bplmapfdpcbo	TRUE
cjoebklinbin	TRUE
cjpadmbdendi	TRUE
decmekoadhfn	TRUE
dedpaemjpgof	TRUE
dnncmilmekof	TRUE
dnnhfelfhojo	TRUE
ehmckebemfja	TRUE
eialjfnddmnh	TRUE
fcaccdcfhnfc	TRUE
fcbfpgcdpfpc	TRUE
flnpchaalaai	TRUE
flodkgmboigg	TRUE
gfcbjngobpll	TRUE
gfdehejdjgpb	TRUE
goonahhchbnl	TRUE
gopeimmebpek	TRUE
hijfkfceliho	TRUE
hikapfklmaim	TRUE
iblkoejimobd	TRUE
ibllchbhbofk	TRUE
ilacefgbhfdl	TRUE
ilakpbllinch	TRUE
jflekibgfomj	TRUE
jfmmineikgck	TRUE
kcbijjfbacom	TRUE
kcbkaloojnkn	TRUE
kmeepaaoiigb	TRUE
kmeidbfeghao	TRUE
lfnaooeaalkh	TRUE
lfndklnkamoa	TRUE
lpopkjmodkdc	TRUE
lppdbeikbggo	TRUE
mlcjfgdfhdap	TRUE
mldbmkppnghe	TRUE
negipnpagigm	TRUE
negkhpgplhna	TRUE
nphfcnpcfnip	TRUE
nphmedjkabmf	TRUE
okadppepfioh	TRUE
okaeelheeldh	TRUE
pfegcegjoobf	TRUE
pfenlagghkdh	TRUE
aacjlhmkabab	FALSE
aafailfcabab	FALSE
akmkkgahabab	FALSE
akpgkngkabab	FALSE
bfomigilabab	FALSE
bfonfogpabab	FALSE
bplhnhgfabab	FALSE
bpmjenmbabab	FALSE
ckfpbckkabab	FALSE
ckgeckndabab	FALSE
dehmggakabab	FALSE
dejlfjbpabab	FALSE
doecdicnabab	FALSE
doejbokeabab	FALSE
eijlhdedabab	FALSE
eikajhcnabab	FALSE
fblknlnababp	FALSE
fboffnjlabab	FALSE
flpbdlghabab	FALSE
flpffdikabab	FALSE
gfcamnoiabab	FALSE
gfcgpmhfabab	FALSE
golejjbbabab	FALSE
golpmaniabab	FALSE
hioegnloabab	FALSE
hioklklgabab	FALSE
ibodffmjabab	FALSE
iboojpchabab	FALSE
ilkfnpaeabab	FALSE
ilkgnkppabab	FALSE
jgdemaelabab	FALSE
jgficpgmabab	FALSE
kblfeijdabab	FALSE
kbljmbfcabab	FALSE
klochbnlabab	FALSE
klpemmebabab	FALSE
lggfmlmpabab	FALSE
lgghdfnhabab	FALSE
lplohmcbabab	FALSE
lpmodjhbabab	FALSE
mkgkaaggabab	FALSE
mkhgcklaabab	FALSE
neadhjdcabab	FALSE
nebfghciabab	FALSE
npcphojpabab	FALSE
npedkmbpabab	FALSE
okkgkhhgabab	FALSE
oklfalmpabab	FALSE
pfealnaaabab	FALSE
pfeaocefabab	FALSE
aaanjeofhljmm	TRUE
aabannhdehpbc	TRUE
akcgcekmlfekb	TRUE
akclmacbedaoh	TRUE
bepipcpcdjkge	TRUE
bfaamcnhgechn	TRUE
bpajeocglopbo	TRUE
bpbcgkmmgnpci	TRUE
cjciikfnckffh	TRUE
cjcmcnjlkecch	TRUE
dcajgppkdeilc	TRUE
dcamdianpggac	TRUE
dlgpnococphen	TRUE
dlhjehogiingl	TRUE
egcknapbooklg	TRUE
egedgmgpppnmk	TRUE
fabmldgcfbcih	TRUE
fabofebhikhgb	TRUE
fkdmkjmkicinh	TRUE
fkegghgddkhnp	TRUE
gejldmgiokdcb	TRUE
gelblocnidfop	TRUE
gpbahammpjpef	TRUE
gpcjamflggope	TRUE
hjcfdpkmnmbeg	TRUE
hjcjophjlbnfk	TRUE
idkcabmgabaia	TRUE
idkfallfpicfm	TRUE
inpbidifpfcfe	TRUE
inpgemgnadman	TRUE
jimggbimabdkg	TRUE
jinnpdanbdloa	TRUE
kcndjcieakffg	TRUE
kcnonpoclnipd	TRUE
kmajaakpbbnfk	TRUE
kmalhlfpedaah	TRUE
lghmghpepiodj	TRUE
lghphihnilcij	TRUE
lppajafiilkam	TRUE
lppalhicneail	TRUE
mkelmkdangbem	TRUE
mkhmopapbligk	TRUE
nfheplgkephae	TRUE
nfhmofefhbiin	TRUE
oapcnhlnahhka	TRUE
oaplbnmlidonp	TRUE
olllpmgpbnchb	TRUE
olmjeoncccdff	TRUE
pgckhbodpmbjg	TRUE
pgddbimoplnda	TRUE
aaanjeofhabab	FALSE
aabljmmanabab	FALSE
akbamglohabab	FALSE
akbmgkondabab	FALSE
bfobnkcmpabab	FALSE
bfooflfdcabab	FALSE
bolloghdhabab	FALSE
bonclkeckabab	FALSE
cipmhlfnpabab	FALSE
cjaefmeinabab	FALSE
dbijgjbelabab	FALSE
dbjiajikcabab	FALSE
dlanadphdabab	FALSE
dlcmjadefabab	FALSE
effmmdbdpabab	FALSE
efhibhkobabab	FALSE
facmaialdabab	FALSE
faeinokkababa	FALSE
fkjhoenjbabab	FALSE
fkkcfpmnnabab	FALSE
gfhnpgjbpabab	FALSE
gfiaoajekabab	FALSE
gpcnaldkpabab	FALSE
gpehfbgljabab	FALSE
hipfgeebhabab	FALSE
hjadkgpfjabab	FALSE
idbgjblcoabab	FALSE
idbiogofoabab	FALSE
ioeidjcojabab	FALSE
ioejfohhcabab	FALSE
jhndpdcedabab	FALSE
jhnonbcijabab	FALSE
kdjdglcfdabab	FALSE
kdjpbchlbabab	FALSE
kmdmnafjdabab	FALSE
kmecjcpplabab	FALSE
lfggjmlpnabab	FALSE
lfhjldcaiabab	FALSE
lpkpipkphabab	FALSE
lplkoikbpabab	FALSE
mkimlcflpabab	FALSE
mkjmbknhlabab	FALSE
nfiikhiecabab	FALSE
nfinfmjdiabab	FALSE
oalinldbiabab	FALSE
oanpoipegabab	FALSE
okaadnpmmabab	FALSE
okapoljndabab	FALSE
pgbhgbgcdabab	FALSE
pgcgamgnmabab	FALSE
aaajjindiedini	TRUE
aaakbinmimcagk	TRUE
aipchcblgakppf	TRUE
ajabdkinopkmfj	TRUE
bcgkhckaddaibi	TRUE
bchaeaippdieno	TRUE
bmhmkgknaanihe	TRUE
bmidmdnajeclbg	TRUE
cgkiggjplolkda	TRUE
cglofjflnhldef	TRUE
dakjhpkdfgdibn	TRUE
dakmoibbfgibda	TRUE
dknpjjkanmmono	TRUE
dkoaaoknkcfaga	TRUE
edkildihcmkhbg	TRUE
edleddcjcgfmdh	TRUE
enjaiaplkphoma	TRUE
enkijgieppkdgh	TRUE
fhkfhjfalhlhah	TRUE
fhkgolpgfkoeek	TRUE
gcjdbpfcddlnno	TRUE
gckmnfhlfohfpl	TRUE
gnmecnbjdnnmli	TRUE
gnmffceplmoing	TRUE
hikoonpfikjjpd	TRUE
himglkcjnkenci	TRUE
iegdbjpoalolck	TRUE
iegegpnmcbilab	TRUE
inmbhgikjkcjme	TRUE
inohmiikgldddp	TRUE
jjggakfpnbgdcd	TRUE
jjipjbegimmlcm	TRUE
kecpfgjigfllbn	TRUE
kednkbblgfpbbl	TRUE
koipjelbpmmdjb	TRUE
kojbnbekppikpo	TRUE
ljboidkkfmhmic	TRUE
ljdgphikkljfnm	TRUE
mcphnpgpcbjofk	TRUE
mcpokpifmaalil	TRUE
mngkedkdbgbccm	TRUE
mnhohnpcgjaonb	TRUE
nibojmhfigjadb	TRUE
nicccgaflpjcnd	TRUE
obholleiaeabhd	TRUE
objbjpgdlkmpdd	TRUE
olliohoanmpmoo	TRUE
ollkdabddogdeg	TRUE
pflelmgagabdle	TRUE
pflenkgpnnjhpk	TRUE
aaajjindieabab	FALSE
aaakdinibiabab	FALSE
aiplmijjejabab	FALSE
ajaceeianiabab	FALSE
bcmioehboiabab	FALSE
bcmjdoemmoabab	FALSE
bmnoopfnlgabab	FALSE
bmokjhecpmabab	FALSE
cgegfilfmdabab	FALSE
cgehhlibglabab	FALSE
dahhhkaihpabab	FALSE
daiciendbmabab	FALSE
dkcmbimpjdabab	FALSE
dkdfnamdgnabab	FALSE
eedafbhhafabab	FALSE
eedfkcfmgoabab	FALSE
enmifppmmeabab	FALSE
enmioliagfabab	FALSE
fhiejeioenabab	FALSE
fhiiankfonabab	FALSE
gchpcdcddbabab	FALSE
gcibbkdbflabab	FALSE
gofhocjhmpabab	FALSE
gofnnfjccdabab	FALSE
hjcobeiamlabab	FALSE
hjehkjhmfkabab	FALSE
iefopeaieeabab	FALSE
iejcbihbggabab	FALSE
ioicmpnmmjabab	FALSE
ioknpjmhkhabab	FALSE
jjjlfpbgoeabab	FALSE
jjjmkfnaleabab	FALSE
keedhjphclabab	FALSE
keenfkmakfabab	FALSE
kokfecckgcabab	FALSE
kokgmbmgkiabab	FALSE
ljagfdcbalabab	FALSE
ljbemlelpoabab	FALSE
mcnjmfohfgabab	FALSE
mcnlkjgbpmabab	FALSE
moaegnmejhabab	FALSE
moapliapnoabab	FALSE
nhlonhhbboabab	FALSE
nhoeaalnbdabab	FALSE
obokmmnehgabab	FALSE
obommeidocabab	FALSE
olihbdehfgabab	FALSE
olildlmeidabab	FALSE
pgahjolpbjabab	FALSE
pgbafhnlocabab	FALSE
aaaahdipngfhmdp	TRUE
aaabfmgdiblmmhi	TRUE
akcnhapclenhbja	TRUE
akelnknnmlekcom	TRUE
bfcdopnjndcbhnl	TRUE
bfcojmpnhejbgjb	TRUE
bookmjfnccdaegp	TRUE
bpajoaolhinjmab	TRUE
cjeeoofjoebdpji	TRUE
cjfgmmpkjgajbae	TRUE
debhncpdcdbmlnd	TRUE
debjancgmfjnjkl	TRUE
doekoicogokjkhi	TRUE
doeljchpkcfhpfj	TRUE
eibphdbajbpmlak	TRUE
eidjekaplhkhlal	TRUE
fcaimnkcklpoohh	TRUE
fcanceihpbocbol	TRUE
fmbcddddkeplolg	TRUE
fmbihbkmpjnjnng	TRUE
gehhggilpgblemi	TRUE
gehngmedadfjcmo	TRUE
gnncjdhmbknhbpp	TRUE
goageokleaacjgk	TRUE
hjhjjkeahcnfebc	TRUE
hjicgpfncpjijkl	TRUE
idgdepfdagogcod	TRUE
idggkdennbofdka	TRUE
impnfnmdicaclho	TRUE
inaadbmjcnmglbp	TRUE
jhkfgldoffonfhc	TRUE
jhmcipgmmmbbbho	TRUE
kaoginidljccgbf	TRUE
kaolcikacnhlnmm	TRUE
klfaiibejpaikpf	TRUE
kljjbgmjlmihfhn	TRUE
lgjejidfganbbnk	TRUE
lgjjlbadeiglddb	TRUE
macpknnlofhfiji	TRUE
maeapapamlbhpme	TRUE
mlbmcmgoihempkm	TRUE
mldbfjifnmcofpg	TRUE
nfddmoedgmjmiel	TRUE
nfemdjkdcfcaaek	TRUE
obemdkohhnhcpnl	TRUE
obepoiddkejgdpl	TRUE
olkepehlhacjgan	TRUE
olkhoabokcbadlm	TRUE
penmboibccacjcp	TRUE
peoedmkcnddbjmd	TRUE
aaaahdipngfabab	FALSE
aaabhmdpfmgabab	FALSE
akbhkfmpeieabab	FALSE
akbjamdcdhkabab	FALSE
bekdnopgcdpabab	FALSE
bekhpaicckcabab	FALSE
bpafllccnjdabab	FALSE
bpdnllepnigabab	FALSE
cjdbhnlkmpkabab	FALSE
cjdcdepjdifabab	FALSE
ddgdcekopmgabab	FALSE
ddhchbjcfkpabab	FALSE
dnjjbdpjebaabab	FALSE
dnklajgfmhcabab	FALSE
ehmakkgljeiabab	FALSE
ehmohedpgjhabab	FALSE
fcaejegdomlabab	FALSE
fcahafbnhhaabab	FALSE
flcdkhkboleabab	FALSE
flcgmokhpcababd	FALSE
gfifefejahcabab	FALSE
gfikdkeboababed	FALSE
golhnbhpakoabab	FALSE
golphlfnmomabab	FALSE
hijdoigflpnabab	FALSE
hijemkddmalabab	FALSE
idbhfhlmebjabab	FALSE
idcanjjaeceabab	FALSE
injjcdbnnmbabab	FALSE
injkjfmnnliabab	FALSE
jhflamfnjjlabab	FALSE
jhgnioeiehgabab	FALSE
kbcfjaobbehabab	FALSE
kbdamobiejcabab	FALSE
kmkmleddopaabab	FALSE
kmldjepekahabab	FALSE
lgagbmgjgefabab	FALSE
lgajmlpfkkgabab	FALSE
macfcoikfgpabab	FALSE
macjjemlodiabab	FALSE
mkkdcpibniiabab	FALSE
mkkmlceanheabab	FALSE
nfjkaabdkicabab	FALSE
nfkimfidppeabab	FALSE
oalgeofhljaabab	FALSE
oalgffadiifabab	FALSE
okogcdeneajabab	FALSE
okpcpopjhgnabab	FALSE
pfgnemkdkjjabab	FALSE
pfhbinongflabab	FALSE
aaabmbnlehpndcfo	TRUE
aacapccicjjmkhjn	TRUE
akcbdbcbbgljbpkn	TRUE
akcidoamcpdpmclb	TRUE
bdpkdnakbniodceo	TRUE
beaeipofpfjgdcbf	TRUE
bnfiddiaeogccbek	TRUE
bnfkegnaahdlhopj	TRUE
cikngjhialgajead	TRUE
cilcmielhcnkmfmd	TRUE
ddkimamnohmpgieo	TRUE
ddkmelpnpbgjjbib	TRUE
dokmdnlnpnebajli	TRUE
doknjldpbkpofkml	TRUE
eihbbojfhghcojje	TRUE
eihngepkigojpcmf	TRUE
fdfpcmhibhnlpohb	TRUE
fdgjkofmppoomilf	TRUE
foealiijlkndmcbm	TRUE
foeindoahdgjdlma	TRUE
ghnihdfjniphcdbf	TRUE
ghooogjoiilfelgj	TRUE
hbpgjdjfbeilplja	TRUE
hbppcgmmojbefoce	TRUE
hlgpkmokifidcgeo	TRUE
hlibbgnlkmmfihef	TRUE
iffhnfbobledgnci	TRUE
ifglfgfimhnhplec	TRUE
ipmknolddfjcjnjp	TRUE
ipmlmiijgfofpbif	TRUE
jiljjamdigjaikkb	TRUE
jimecejnmdlpgppc	TRUE
kcogkefbjhiinpnp	TRUE
kcpggnllnmpogdbk	TRUE
koihncojjncjbggb	TRUE
koihpbjhppkhhdda	TRUE
ljcgfolmpejdigel	TRUE
ljcnflifjbmbjjkf	TRUE
mecikpicfmjelagh	TRUE
mecjejpdmohcikkl	TRUE
mnfoeheeldllklid	TRUE
mnfpijpieonpbpno	TRUE
ngoihhddbphnhhma	TRUE
nhagakkmgkedcbkm	TRUE
obhllgnjhllilggn	TRUE
obkhgigfgaalahll	TRUE
omdldknanhfpblch	TRUE
omdlogdkdbaejgnh	TRUE
pggbcfdoafeplhkd	TRUE
pggfknpgbgfdafhp	TRUE
aaagcpnfkagaabab	FALSE
aabcmjgfjbkhabab	FALSE
akgigianpklbabab	FALSE
akgkbjfgakfiabab	FALSE
bffadopillfkabab	FALSE
bfgadfbaifehabab	FALSE
bpbaimmjglfeabab	FALSE
bpbdieocobcdabab	FALSE
cicigiplddnoabab	FALSE
cicjhbplcfmnabab	FALSE
dbihklkgciflabab	FALSE
dbjebhdbaeclabab	FALSE
dmgggedjppaoabab	FALSE
dmjilaakcgojabab	FALSE
egjbkbpbnfejabab	FALSE
eglcoeafncababno	FALSE
fakmfbmbcglcabab	FALSE
famnkhilhmpoabab	FALSE
fkjpjkpjgjmjabab	FALSE
fkkcciifcmjcabab	FALSE
gfeegpdcomjiabab	FALSE
gffdcogpdhgnabab	FALSE
gpmhiahcdmhmabab	FALSE
gpnjfpadiannabab	FALSE
hjnhfmbbaiaeabab	FALSE
hjohhenlaaipabab	FALSE
idleolnkgkecabab	FALSE
idlompcgohiaabab	FALSE
ioibjdhbclkmabab	FALSE
iojgahoenkllabab	FALSE
jhpbifjpdbjmabab	FALSE
jhpnbndlcmmoabab	FALSE
kbmjlkeogfecabab	FALSE
kbnbkincckpoabab	FALSE
kmpjefhckedeabab	FALSE
knabpmjnbdplabab	FALSE
libdkbongabmabab	FALSE
licgkacbaaopabab	FALSE
mcaffbgiomboabab	FALSE
mcbeeapheenoabab	FALSE
mmloodhmhpefabab	FALSE
mmmbbpdlohciabab	FALSE
nginaghemmigabab	FALSE
ngkhcbecddfiabab	FALSE
obfbamkbmmcgabab	FALSE
obffjpgokkjnabab	FALSE
omjjgmkkjpgjabab	FALSE
omjkaggiilpiabab	FALSE
pgklpibnpeepabab	FALSE
pgknbifbeimfabab	FALSE
aaagcpnfkagaklcjl	TRUE
aabfjbkhoeelpffgp	TRUE
akgegblhemonjhfll	TRUE
akgoplnfhpfpgfiej	TRUE
benplifpdgheeaodi	TRUE
beocmpkpjokldpbbm	TRUE
bpclklgfkillhmgfo	TRUE
bpcmaniimajnpgkha	TRUE
chibnpnfnnhljihdn	TRUE
chigenglbnjddmboi	TRUE
dbdanbapagfafpmdj	TRUE
dbemnnbllohdangbd	TRUE
dmboomlclffhmfaod	TRUE
dmcnmngjaghgfdjjc	TRUE
egcmohcbgglijmcmb	TRUE
egdcepafeihjnpjmg	TRUE
fahejhaapbmmikpkm	TRUE
fahpmacjiebpdmkao	TRUE
fkjoiimnfihkcfjha	TRUE
fknbhdgelfioglkjh	TRUE
gfpanligbolekjhbh	TRUE
gfpfihcdakmakjfdc	TRUE
gpjjoigmnbpifofla	TRUE
gpjkalbpdpehifjbj	TRUE
hjbckeklnlfgghlme	TRUE
hjdekicpmljjdbnma	TRUE
ideailkmnkokfidhh	TRUE
idgnpnmfenfdjkgne	TRUE
ionkjanlefdhlegca	TRUE
iooedpjjpdnenbeon	TRUE
jhjkhfngijmaddmpj	TRUE
jhjmlocccdgmpcfei	TRUE
kbochjjkadmmpccmc	TRUE
kbomafoldhmccakbn	TRUE
knaifafplgdkmafeb	TRUE
knbkacibekmnolnok	TRUE
lhefohaodehgglppn	TRUE
lhggefbddfmamdiln	TRUE
mbikdemjblhhgnfnn	TRUE
mbjbdbfbpmagobjag	TRUE
mmfamlgnmpgbkpfpc	TRUE
mmfflkehkaidahgek	TRUE
ngafjobgkemglmmil	TRUE
ngbalieekkmbnabpl	TRUE
oapomeegpidoaeblb	TRUE
obabjbijehhdelffa	TRUE
olddjphkijgaildck	TRUE
oldfoalnjhkakopfe	TRUE
pfpominpehjphlacn	TRUE
pgaiolpoboajloicp	TRUE
aacfjlbknjjgcabab	FALSE
aacnffldneeafabab	FALSE
ajfbfigfgabliabab	FALSE
ajfcccopifaahabab	FALSE
bemghhdnmhpnlabab	FALSE
bemnngiadebieabab	FALSE
bnfoabeponmfcabab	FALSE
bnfpkcfleoibfabab	FALSE
cfpbpdkejmgpgabab	FALSE
cfpfjkmghiabdabab	FALSE
cplhppekbbjchabab	FALSE
cpljeepmmhdgcabab	FALSE
djiogeccjoemfabab	FALSE
djkbohgedfedhabab	FALSE
efbhdenblbhehabab	FALSE
efbmmbodakfpoabab	FALSE
faakjgbflfmomabab	FALSE
fabemaddgiodmabab	FALSE
fmadaifgiggbfabab	FALSE
fmajfapbdgbldabab	FALSE
ggnmjppncmlbgabab	FALSE
ggohgeeboenmhabab	FALSE
halnojekbejkmabab	FALSE
hamdjbhimffiiabab	FALSE
hkclilpmpgfilabab	FALSE
hkdcmpeblmaaiabab	FALSE
idlhhengdbnnhabab	FALSE
idmppngikmjmlabab	FALSE
imnblpicbkgkoabab	FALSE
imolechiknlkcabab	FALSE
jhmkjadijfbcgabab	FALSE
jhnbpoidcemjdabab	FALSE
kbjpldhhhfecgabab	FALSE
kblcfeakfjlgnabab	FALSE
klmiggkdmbndeabab	FALSE
klnicaeagbhkcabab	FALSE
lgfkpnbkodcjdabab	FALSE
lggaphifbekababca	FALSE
maoledkjhnmeeabab	FALSE
mapcnkppaoingabab	FALSE
mlldcalbabfihabab	FALSE
mllfojkemoldiabab	FALSE
nfopohnibhbeiabab	FALSE
ngacimjcopeofabab	FALSE
oacojdeioliadabab	FALSE
oadadlmkfnoddabab	FALSE
okieoiplhjmglabab	FALSE
okjpdkdpdbaakabab	FALSE
pfahlmpalpahpabab	FALSE
pfajleenchingabab	FALSE
aabfgjhjmkfafmoiho	TRUE
aaciebdelkmidecdhh	TRUE
albdbbdkibainghlje	TRUE
albdklklhbilnnfhjc	TRUE
bfhgfpbaddailibghc	TRUE
bfjhbakagldenkcjnl	TRUE
caekofmjbjehdakkjp	TRUE
caeomeopmoegjnidph	TRUE
cjjbfcpnlpaioelfaj	TRUE
cjjeocdkfjadahajkf	TRUE
ddijflamaknainjihe	TRUE
ddjmifjmbdjmclmohm	TRUE
dobeojmbkkbokkhpki	TRUE
dobkbfdckpniooopnk	TRUE
eicncmdnknkbnblcff	TRUE
eidccoecjlmobkhiof	TRUE
fbjgplapkpiagocndj	TRUE
fbjkmldpoihahchgfo	TRUE
flcepgleanfdplgona	TRUE
flchckkcdndedkpjng	TRUE
gfbfebjlldgnngcmfg	TRUE
gfbikcdjcohbcnckfk	TRUE
gomolkbimjonalmgjm	TRUE
gonchegofmlijpifpk	TRUE
hidneeibijhalenjpk	TRUE
hifejiimnojokhobdp	TRUE
iccolppciphpenfloo	TRUE
icdnccbgajdfbaifbe	TRUE
ingpekoljefaefllfc	TRUE
inhapejnoofobjffac	TRUE
jiegnoepnjmhlpbjff	TRUE
jieiikpeleggpjdjeg	TRUE
kckdhdikmlnaepgpkj	TRUE
kclbcedgnneggdbgab	TRUE
kndpeodgnhpjadhjpa	TRUE
knfjnjngamndjolpab	TRUE
lieonmngeehhjohhdo	TRUE
lifojniblabffahipk	TRUE
mchmofmoamlhfainkp	TRUE
mchpmmoeagpalkdbgd	TRUE
mmpdmkaalbmlnlikmc	TRUE
mmpjochhkmajdmogmf	TRUE
ngileakoedhckpjdlk	TRUE
ngkjhdkbebeanopgbd	TRUE
oagiljnhehcljofmml	TRUE
oagkgoajgfojnkanjk	TRUE
okhdmgjjbkdglbccbl	TRUE
okhhpejieglciklkbo	TRUE
pembndcbcambgdldbm	TRUE
pemjdhinipaleablbk	TRUE
aabfgjhjmkfafmabab	FALSE
aacoihoiebdelkabab	FALSE
alcdebhkfcjikbabab	FALSE
aldbbbdkkjmfebabab	FALSE
bflbjakmaencmcabab	FALSE
bfnhnchicmjkkkabab	FALSE
caeaefmebaoognabab	FALSE
caeddpjcmfdmogabab	FALSE
ckfcjdeenfilmlabab	FALSE
ckgaicdngdbmcaabab	FALSE
debjomeehdhmfiabab	FALSE
decdamjobppejgabab	FALSE
dndlbapkiiipnhabab	FALSE
dnegjchkomdhcbabab	FALSE
egoonndogocflgabab	FALSE
ehajfloblidikoabab	FALSE
fbndmlfmigookkabab	FALSE
fbnfcghnbfolclabab	FALSE
flcmfglaogdnkpabab	FALSE
flcpndjgiliefgabab	FALSE
gepinlolgkcomgabab	FALSE
gfbmokjnhijfhpabab	FALSE
gomodhchkahhalabab	FALSE
gonckfpkkhjgijabab	FALSE
higegefjpcoiifabab	FALSE
hiibcdojheolleabab	FALSE
ibncojjmjdmdaoabab	FALSE
ibodafpohpeghgabab	FALSE
infpefniocajpiabab	FALSE
inggkanpdibdheabab	FALSE
jiciadfpkmmjhiabab	FALSE
jicpbgejakelbbabab	FALSE
kcmpihglpdcoipabab	FALSE
kcnlhichbcocbaabab	FALSE
knngjfjglpfmkiabab	FALSE
knngmlgmehlpchabab	FALSE
libebcobjaifkpabab	FALSE
licldhbcmghlejabab	FALSE
mcfigeoojecaababdc	FALSE
mchlocanfnohkgabab	FALSE
mmekejfcihijfkabab	FALSE
mmfjggahliilohabab	FALSE
ngeknjhhboeejcabab	FALSE
ngeoihnadgieafabab	FALSE
oadonlapjlcmkcabab	FALSE
oaejcokpbkoeobabab	FALSE
okdgobcjhakhihabab	FALSE
okdhfmodcjppecabab	FALSE
penillglcgofmcabab	FALSE
penlkcigefgjkoabab	FALSE
aaaeiaddoagdcahefhk	TRUE
aaajcdkmgcehhklbfih	TRUE
ajlkjnndffokhgohmfn	TRUE
ajlnckgoghfnccdbnkg	TRUE
bcmhhpadbacbojjlign	TRUE
bcmhlnlbdihjihicpca	TRUE
bmcmdeohjgemljcfaop	TRUE
bmcnfhjongpdppepefp	TRUE
chhcphejgjnhmfkdego	TRUE
chiacabihlajbaincpc	TRUE
dbedgomnmkdchcldbch	TRUE
dbfdcfimlppdaehippf	TRUE
dljkdjgcblmlllbodjn	TRUE
dlkbjhhnagcoikpoepa	TRUE
efdnnikngagcmaeacom	TRUE
efdolgjngjijejnhnjc	TRUE
eoejacihldnfcipkpip	TRUE
eoenpeppcbmaiohkifk	TRUE
fifmnealdbhdplobgll	TRUE
fighfeblhagcjacnpdp	TRUE
gcdoocnpglejfmjpcoo	TRUE
gcehbcoplpgddpdchbj	TRUE
gmpcakjkjfnldajnddc	TRUE
gmphfbceglibjgmnmao	TRUE
hhinbpkbgfnmlagffap	TRUE
hhmjkgeimljfpdgkcho	TRUE
ibikmmmdchngoddnclh	TRUE
ibikomhjeklahhcolhi	TRUE
inbandhfhmmhdccecgj	TRUE
inbbkkanofhadkinnkb	TRUE
jhfmmchhflmldmdaepe	TRUE
jhgchkmjhomndfeiegi	TRUE
kboidlgnpiliahijlfi	TRUE
kbombjljenphmbcccnn	TRUE
kmjacnmdmokfkgeknad	TRUE
kmknjcobjagnlnbecho	TRUE
lhombbnfgdjcddaomek	TRUE
lhonbfcgdphobdeklmc	TRUE
mbkdflkkglgafcmdfma	TRUE
mbkdghiolbnepkoaepd	TRUE
mlbcnfnkhhjljggmanc	TRUE
mlcdjkehoallgeeckda	TRUE
necpkkpdgncobnjgfdg	TRUE
nefaolghkjdhpabehnp	TRUE
npdgnppmlcjnjbidbpn	TRUE
npeagpolnlkidnkappm	TRUE
okcdondplakklaajine	TRUE
okcikbmfoghegiaafal	TRUE
pfcpcnodnpblmelfeee	TRUE
pfdcjhpblnilcollojb	TRUE
aabkdjlolofpnojabab	FALSE
aabmedmbmdjgbnmabab	FALSE
ajeoogficiigbmfabab	FALSE
ajfjbdbloanhaglabab	FALSE
beaenamnkljifkeabab	FALSE
beakbjhjbjnemfjabab	FALSE
bocilancfochgieabab	FALSE
bodkpopldjohcafabab	FALSE
cimfomndekkaiegabab	FALSE
cimijnebonciblbabab	FALSE
dcojchpdooefafiabab	FALSE
dcokdniajpkoecnabab	FALSE
dnfehnmegehbfioabab	FALSE
dnfnabokjdapfpiabab	FALSE
ehdgpnbaehoolooabab	FALSE
eheikjgbagddcanabab	FALSE
fanllbjdgghpjdoabab	FALSE
faobpgbeodkmnjfabab	FALSE
fkmoldbdeilgbgfabab	FALSE
fkonoahebboffbgabab	FALSE
gfcgnbpaggdakloabab	FALSE
gfdnipepjcgjjeiabab	FALSE
gnnfgnlagccgkheabab	FALSE
gnnfplfbabdaohbabab	FALSE
hjbacbgfafkifbhabab	FALSE
hjbdnckcegabfbcabab	FALSE
ieocojhgkadnlegabab	FALSE
iepbaknkbjohebkabab	FALSE
ioniphiebckjhppabab	FALSE
ionlhenihfgogoeabab	FALSE
jhlikhkdhmemfidabab	FALSE
jhlkdkfmlfjkgdababe	FALSE
kbnjjbgghbnlneeabab	FALSE
kbpceagfhfaaemlabab	FALSE
knbipbegmnclgdoabab	FALSE
knccgloodnmkigpabab	FALSE
lhfoecfkdlmkpldabab	FALSE
lhgeojcjekikjnababc	FALSE
mcioggalnnfdeioabab	FALSE
mcjjmijkaddigmpabab	FALSE
mmjmdgdfjkphfhfabab	FALSE
mmklfkdkfnmeipbabab	FALSE
nhochecfeffjicaabab	FALSE
nhpegcnlkgljphpabab	FALSE
oclkmjeajliifepabab	FALSE
ocmpmaeihakobkcabab	FALSE
omakegfoeapgcmaabab	FALSE
ombaceolmcomhdcabab	FALSE
pgbkgfjlacdigaaabab	FALSE
pgcaeibicmjfpieabab	FALSE
