aaajmjibln	TRUE
aabiaphchb	TRUE
alkdonhjha	TRUE
alkfgchckj	TRUE
bfpclhkkje	TRUE
bgbdnpnmge	TRUE
bpinokillb	TRUE
bpjiijbido	TRUE
ckgcdmmojm	TRUE
ckhhdikohi	TRUE
dehgnahanj	TRUE
deiamaodbh	TRUE
donncpilpf	TRUE
doohoppmhn	TRUE
ejfloelnfo	TRUE
ejgddmpphk	TRUE
fcoceokhkc	TRUE
fcogdgnboa	TRUE
fmhopcifcj	TRUE
fmidhcljhl	TRUE
gfpjbihnhi	TRUE
ggdeemdhhj	TRUE
hamjfjecbi	TRUE
hamjlnefjd	TRUE
hkhohokfad	TRUE
hkjmcgommg	TRUE
ifckedcehi	TRUE
ifddongfdn	TRUE
iopbojenhi	TRUE
ipailinepe	TRUE
jjgdnbflmf	TRUE
jjghaebndg	TRUE
kdmfheaeoj	TRUE
kdogadmppb	TRUE
koifgpfelg	TRUE
kojahepcfo	TRUE
lkabjkpilp	TRUE
lkahbomjab	TRUE
mdpkeffhcp	TRUE
mdpmlfcjba	TRUE
mochjmbace	TRUE
mofafknjej	TRUE
ngjfakipjh	TRUE
ngjlpjgnlg	TRUE
obajacnchm	TRUE
obbecpcpkk	TRUE
oliiglabbk	TRUE
oljghaedah	TRUE
pfjldpghci	TRUE
pfkcoogmcj	TRUE
aaajmjaaaa	FALSE
aabiblaaaa	FALSE
almhdfaaaa	FALSE
almkfiaaaa	FALSE
bgjfneaaaa	FALSE
bgjgdaaaak	FALSE
bpmobeaaaa	FALSE
bpnbfeaaaa	FALSE
cjdjndaaaa	FALSE
cjecdoaaaa	FALSE
debadiaaaa	FALSE
debeijaaaa	FALSE
doflijaaaa	FALSE
dojchpaaaa	FALSE
ejaobpaaaa	FALSE
ejapelaaaa	FALSE
fdaijgaaaa	FALSE
fdbagfaaaa	FALSE
fncnaiaaaa	FALSE
fndgogaaaa	FALSE
ggghenaaaa	FALSE
gggkgkaaaa	FALSE
haompgaaaa	FALSE
hapcphaaaa	FALSE
hkpojdaaaa	FALSE
hlcgopaaaa	FALSE
ifkccfaaaa	FALSE
iflimdaaaa	FALSE
iokkelaaaa	FALSE
iolomnaaaa	FALSE
jinecdaaaa	FALSE
jinphjaaaa	FALSE
kdgomcaaaa	FALSE
kdhcgkaaaa	FALSE
komajlaaaa	FALSE
komemgaaaa	FALSE
lkiodaaaac	FALSE
lkjaakaaaa	FALSE
mebjakaaaa	FALSE
meefjhaaaa	FALSE
mnjfmgaaaa	FALSE
mnjkfoaaaa	FALSE
nheidbaaaa	FALSE
nhhmgkaaaa	FALSE
oalipfaaaa	FALSE
oamfpmaaaa	FALSE
olgjdpaaaa	FALSE
olhjkeaaaa	FALSE
pghjflaaaa	FALSE
pgjagoaaaa	FALSE
aaajmjiblni	TRUE
aabaphchbhg	TRUE
allegbacmoj	TRUE
allplimgplj	TRUE
bfnflacnmnl	TRUE
bfpddhngbcl	TRUE
bpkgdjhbpfn	TRUE
bpkpbiadhch	TRUE
ckglapchcfd	TRUE
ckgnodkfapp	TRUE
degdhloemjc	TRUE
dejbhdjlkff	TRUE
domoeheopof	TRUE
donliaonfji	TRUE
ehlbgdoicog	TRUE
ehlpdkihkpf	TRUE
fdcbflbogcg	TRUE
fdccadfmllp	TRUE
fnciinaioeo	TRUE
fnfephdjfho	TRUE
ggijghoaaom	TRUE
gglpklnocfh	TRUE
hbefoghplfc	TRUE
hbeikjkogkm	TRUE
hkimoaalfee	TRUE
hkkjhebfclc	TRUE
igbmohdgdaj	TRUE
igbndnjdhgl	TRUE
iopojjbkijo	TRUE
ipafgehpblm	TRUE
jjaompcijok	TRUE
jjbgiejfabp	TRUE
kdilfiglkon	TRUE
kdkeeggkgac	TRUE
koegfdanpbi	TRUE
koeofcmfjan	TRUE
ljiaakaglfp	TRUE
ljjmdfbohdg	TRUE
mehlpecpcgf	TRUE
meiabnjifkn	TRUE
mnmcdpajhbk	TRUE
mnmggeinhea	TRUE
nhgijaiolln	TRUE
nhhhfmdmmbc	TRUE
obcijedpkld	TRUE
obdfllakdga	TRUE
olmcjceabjj	TRUE
olmeompccgn	TRUE
pfcpaolfenm	TRUE
pfdlgionlmh	TRUE
aaahdegaaaa	FALSE
aaaokndaaaa	FALSE
akembpcaaaa	FALSE
akeppceaaaa	FALSE
behkgojaaaa	FALSE
bekldceaaaa	FALSE
bpinjfeaaaa	FALSE
bpjmhlaaaao	FALSE
cjhpdnnaaaa	FALSE
cjimigkaaaa	FALSE
declojeaaaa	FALSE
decmooaaaaa	FALSE
dojkgkpaaaa	FALSE
dojnghbaaaa	FALSE
ejablipaaaa	FALSE
ejcjkioaaaa	FALSE
fennmhdaaaa	FALSE
feobckpaaaa	FALSE
fokkoceaaaa	FALSE
folbnbiaaaa	FALSE
gihdllhaaaa	FALSE
gihilegaaaa	FALSE
hbbadfeaaaa	FALSE
hbcjdepaaaa	FALSE
hlpjigaaaao	FALSE
hmakcojaaaa	FALSE
iggigghaaaa	FALSE
iggpbicaaaa	FALSE
jbjekehaaaa	FALSE
jbjpejkaaaa	FALSE
jllmcipaaaa	FALSE
jlmmfbnaaaa	FALSE
kfllldhaaaa	FALSE
kfmcbelaaaa	FALSE
laglobfaaaa	FALSE
lailmgnaaaa	FALSE
lljedlgaaaa	FALSE
lljgmkgaaaa	FALSE
mgdofncaaaa	FALSE
mgepmobaaaa	FALSE
nahdogeaaaa	FALSE
nahebhdaaaa	FALSE
nkahcleaaaa	FALSE
nkbaocoaaaa	FALSE
odhofkbaaaa	FALSE
odidaehaaaa	FALSE
oncieemaaaa	FALSE
ondahfiaaaa	FALSE
pgcbhjnaaaa	FALSE
pgdocmmaaaa	FALSE
aaahdegkndjp	TRUE
aaaoclmhaidp	TRUE
akelhfleeaho	TRUE
akemimahijch	TRUE
belakjfcadii	TRUE
belmkllpflmh	TRUE
bplhdjilhcke	TRUE
bplpahefgfhg	TRUE
cjhdjjkojopo	TRUE
cjhlgoeejegd	TRUE
defiopcjodgn	TRUE
defnddlnaaah	TRUE
dohhkjncfbgc	TRUE
doibaebpiijj	TRUE
ekbdenjjfagk	TRUE
ekbkmbpeooml	TRUE
feficnnlhfoe	TRUE
fefjfgdbcdnb	TRUE
fohfhielkmpf	TRUE
fohfhkaoikmf	TRUE
ghfhfkgfcbpm	TRUE
ghfjijoabgop	TRUE
hbdepjbpnjgn	TRUE
hbemobchklmk	TRUE
hlllbehmiknl	TRUE
hllmiojkmbjc	TRUE
igbifkhoafbk	TRUE
igcikjakgckc	TRUE
jbdickmajnak	TRUE
jbdnjdddbbem	TRUE
jljfbhmlfabe	TRUE
jljhpljjjpfn	TRUE
kgbbpdhbpaei	TRUE
kgbipabeejni	TRUE
laflonbjonpk	TRUE
lahhmihokohg	TRUE
llbgheebhnkl	TRUE
llbohkmekpfb	TRUE
mfoapndjngcl	TRUE
mfojaldoapng	TRUE
naidikpdiocf	TRUE
naikckmeijlh	TRUE
nkaggmjlaoki	TRUE
nkamhhccckba	TRUE
odnlelkohmjc	TRUE
odpaipddcioo	TRUE
onjmejbopjdd	TRUE
onjoffnomncl	TRUE
pgmkbdfhijnd	TRUE
pgncknabhabh	TRUE
aaagpeghaaaa	FALSE
aaagppehaaaa	FALSE
akndndcmaaaa	FALSE
akofhngmaaaa	FALSE
bgbdjacaaaae	FALSE
bgbicafmaaaa	FALSE
bpmiljcpaaaa	FALSE
bpmkdgmgaaaa	FALSE
cjoibiojaaaa	FALSE
cjpceempaaaa	FALSE
ddfjfoakaaaa	FALSE
ddgdkhgkaaaa	FALSE
dmoepfiaaaan	FALSE
dmpjhocbaaaa	FALSE
eflenmbcaaaa	FALSE
eflfdfpbaaaa	FALSE
faighineaaaa	FALSE
fajffeljaaaa	FALSE
fkoekhhlaaaa	FALSE
flamllnlaaaa	FALSE
gfcgollgaaaa	FALSE
gfecebebaaaa	FALSE
gpdlnipaaaaf	FALSE
gpeedjkpaaaa	FALSE
hjlphjhaaaaf	FALSE
hjmicmboaaaa	FALSE
ifhfoglgaaaa	FALSE
ifhklogeaaaa	FALSE
ipcbefniaaaa	FALSE
ipcfdndkaaaa	FALSE
jjdjkiljaaaa	FALSE
jjefjfofaaaa	FALSE
kdchnhboaaaa	FALSE
kdcknainaaaa	FALSE
knienhmdaaaa	FALSE
knipebilaaaa	FALSE
lhghjlejaaaa	FALSE
lhgjojilaaaa	FALSE
mbjmkhcmaaaa	FALSE
mblfkfkfaaaa	FALSE
mlpjmoccaaaa	FALSE
mmaaplngaaaa	FALSE
nflnfjiaaaam	FALSE
nflobiidaaaa	FALSE
oaabnlcaaaah	FALSE
oabjgkifaaaa	FALSE
okcpabpoaaaa	FALSE
okdihgpmaaaa	FALSE
pdljbeblaaaa	FALSE
pdnacadoaaaa	FALSE
aaagpeghehaap	TRUE
aaagppmcbobak	TRUE
akkhbgjkoiona	TRUE
akmgkflmnkkjh	TRUE
bgahnkifpcdai	TRUE
bgbdjpldcdlnn	TRUE
bpnjidmlfohmn	TRUE
bpojjacepjnbn	TRUE
cinhmfbdlmmfn	TRUE
cinjiplfebnkl	TRUE
dcndbdaeimljo	TRUE
dcnjhnhodjolj	TRUE
dlpcglhjefnmk	TRUE
dmaglienokjbm	TRUE
ehgclggbcclod	TRUE
ehgdimpapmgme	TRUE
faokaaeammefm	TRUE
fbbmiofimadfn	TRUE
flaeioglpfifj	TRUE
flbgbmcahlpbm	TRUE
gfcibfbilgige	TRUE
gfdddjanmjhom	TRUE
gpdofdkhigmce	TRUE
gpefgjadmaine	TRUE
hkenaondlfbjh	TRUE
hkepigaapdkjn	TRUE
iepmaoghjmcbj	TRUE
ifacaaacmecnj	TRUE
ipccakfhlgfap	TRUE
ipccpaoldigce	TRUE
jjdaifdjckpll	TRUE
jjdhahdmeiiom	TRUE
kdigmefnbflag	TRUE
kdkaiopegacig	TRUE
knbcgiimbbbgd	TRUE
knbjlealmokeh	TRUE
lhcaflpkkkgdm	TRUE
lhcbaciangppo	TRUE
mblnaeonefkdi	TRUE
mbmcpfdnminfj	TRUE
mlmkfkpppdggh	TRUE
mlmpiffpgopln	TRUE
ngljddinfmecc	TRUE
nglklfipblbga	TRUE
oaabjfbnmbehd	TRUE
oaafbiafjfgpb	TRUE
ojigmbedmckkc	TRUE
ojikmkdoanbpk	TRUE
pemcjoociocnf	TRUE
pepnghdaoabhl	TRUE
aabifadamaaaa	FALSE
aacbipaaaaldf	FALSE
ajmbjghflaaaa	FALSE
ajmooppmdaaaa	FALSE
bdfbfmbkfaaaa	FALSE
bdfhadanpaaaa	FALSE
bofaomideaaaa	FALSE
bofeoiffgaaaa	FALSE
cjmjppippaaaa	FALSE
cjndnblmeaaaa	FALSE
ddeomklfkaaaa	FALSE
ddfjmbcgeaaaa	FALSE
dodcpjlnmaaaa	FALSE
dodgimgbcaaaa	FALSE
eiaklfnioaaaa	FALSE
eianojhbmaaaa	FALSE
fbhhmjmoeaaaa	FALSE
fbhpdepjpaaaa	FALSE
flhbmfbmgaaaa	FALSE
flihaohdcaaaa	FALSE
ggjlcfocaaaak	FALSE
ggjlmbhilaaaa	FALSE
hblgllnekaaaa	FALSE
hbmgpcallaaaa	FALSE
hmfihnfepaaaa	FALSE
hmfkibpbdaaaa	FALSE
igjblpmjpaaaa	FALSE
igkolefcnaaaa	FALSE
jbajilcodaaaa	FALSE
jbbbflicpaaaa	FALSE
jkpaflelhaaaa	FALSE
jkppjnchoaaaa	FALSE
kdgdpclieaaaa	FALSE
kdheddhfcaaaa	FALSE
kndjddcojaaaa	FALSE
kndkbfpljaaaa	FALSE
lifdcodmeaaaa	FALSE
ligaohhhjaaaa	FALSE
mdalalpiiaaaa	FALSE
mdaonbondaaaa	FALSE
mnamckfpaaaak	FALSE
mnanojjlbaaaa	FALSE
nhdgokkkiaaaa	FALSE
nhdmballiaaaa	FALSE
obhagpompaaaa	FALSE
obhdjpgblaaaa	FALSE
okmgieafaaaam	FALSE
oknmjlnodaaaa	FALSE
pfncdgnboaaaa	FALSE
pfocfledkaaaa	FALSE
aabifadambipaa	TRUE
aacaldfpbmjbcd	TRUE
ajncgbpckdimlp	TRUE
ajnmheeaolbeof	TRUE
bdicicdnkgmeaf	TRUE
bdieegcemcdfoi	TRUE
bogdpacjdmlcmc	TRUE
bogpaboieficlg	TRUE
cjjedhccmhobjh	TRUE
cjjichomfmmbee	TRUE
ddhidkgfmfmlkm	TRUE
ddkhkkgjlcmhpa	TRUE
dnpddojdgfkfae	TRUE
dnphnbmidnkbfb	TRUE
ehjgkojoneceff	TRUE
ehjknbjephbigj	TRUE
fbjmdbdllcclnb	TRUE
fbkeicpnejfkcl	TRUE
flmceeliihhljn	TRUE
flmgokpcindnch	TRUE
ghgaedioppicog	TRUE
ghgijgjfdnkmkk	TRUE
hbjpnimchpghdm	TRUE
hblmndplkcheff	TRUE
hldmofikbagjic	TRUE
hlgddlmnlfmlij	TRUE
igjiglojpobalk	TRUE
igjngbfapkhoim	TRUE
jbecdgnmdncfek	TRUE
jbeejkhccmindl	TRUE
jjpagfenaiaibp	TRUE
jjpdekfahkdndi	TRUE
kdgnkogmollccp	TRUE
kdhgciechihdlp	TRUE
kncnkpaemlhded	TRUE
kndofkhcifohhe	TRUE
lighhkcfocagkg	TRUE
liifimnmfckagn	TRUE
mcjjeadommifgk	TRUE
mcjjjfegiblfag	TRUE
mnhknhoendicgp	TRUE
mnhndldnhcbijb	TRUE
ngheejhdgkbieg	TRUE
ngjgooffifcahd	TRUE
obihepjkpjlglm	TRUE
obimkejdbebgjc	TRUE
olpfdhpebjkjff	TRUE
omajplndaliedm	TRUE
pgmffinjjjffia	TRUE
pgnicbaglljiln	TRUE
aablbanhaaaagp	FALSE
aadjnpfcieaaaa	FALSE
akcfllcmhnaaaa	FALSE
akdijfdbchaaaa	FALSE
bdfdbnbmboaaaa	FALSE
bdgfnnfdimaaaa	FALSE
bndgibpjabaaaa	FALSE
bneggobendaaaa	FALSE
cgjpljimeeaaaa	FALSE
cgkbblhpaaaame	FALSE
dbinkdekndaaaa	FALSE
dbjhmbdlhnaaaa	FALSE
dlnjpmakleaaaa	FALSE
dlpjbkdbihaaaa	FALSE
egmopaefncaaaa	FALSE
egnfmmgghcaaaa	FALSE
fbboihdhphaaaa	FALSE
fbcbnehgcnaaaa	FALSE
fmjjjpfbhmaaaa	FALSE
fmknghoommaaaa	FALSE
ggiaddecgfaaaa	FALSE
ggjfmhdebaaaal	FALSE
gpkajaflefaaaa	FALSE
gpkclippchaaaa	FALSE
hjhcmophkkaaaa	FALSE
hjhpfhpijjaaaa	FALSE
idpcgagjhhaaaa	FALSE
ieabbehepfaaaa	FALSE
iohmagaaciaaaa	FALSE
iohnihokihaaaa	FALSE
jhnikcanmiaaaa	FALSE
jhohaccjndaaaa	FALSE
kbnjnbiplnaaaa	FALSE
kbocclimbeaaaa	FALSE
kmoenjamhbaaaa	FALSE
kmpgalkafoaaaa	FALSE
lhmoikfmjkaaaa	FALSE
lhpmhmdjgpaaaa	FALSE
mbpodfecpfaaaa	FALSE
mcajbfghncaaaa	FALSE
mmgjljbjggaaaa	FALSE
mmgpeonjdaaaae	FALSE
ngjojijbknaaaa	FALSE
ngkhgokecnaaaa	FALSE
obgkolbgckaaaa	FALSE
obhcfdgfehaaaa	FALSE
oklagjmgkkaaaa	FALSE
oklkohnkegaaaa	FALSE
pfoagcdomgaaaa	FALSE
pfodbhdiodaaaa	FALSE
aablbanhaagpmpj	TRUE
aadfcieapmdhbkb	TRUE
akfcbanklcifimf	TRUE
akgapdonngopapm	TRUE
bdhhfponjodibfi	TRUE
bdibbodpehdnncd	TRUE
bnidfegfeimelco	TRUE
bnilodgobnpccjg	TRUE
chdilbioelbdocj	TRUE
chdkjcjobckookl	TRUE
dbjconjabppbjlh	TRUE
dbjlcnhgchflaff	TRUE
dliefgfpoimlfck	TRUE
dlijkfjbjeggddi	TRUE
egdojbakhbenalk	TRUE
egfcojiiaecckaa	TRUE
fbckejeopoigkkj	TRUE
fbdddihncdclehp	TRUE
fmaohofhijgnhjf	TRUE
fmbdilccdknbncp	TRUE
ggfnphcnpjhalki	TRUE
gghkdemlncmnifm	TRUE
gphemgbmnpifeeb	TRUE
gphgbekmpmnpghp	TRUE
hjgcjhbollmpgeg	TRUE
hjghloamkebienf	TRUE
ieeoipbmdikggab	TRUE
iefeelllblodmka	TRUE
iojceeaiimdemca	TRUE
iojohkepbooojil	TRUE
jiaffgemmcebaia	TRUE
jibgmidogobnnki	TRUE
kcecioandfcklli	TRUE
kcehgelhccglclo	TRUE
knjejgejjjnfkdp	TRUE
knjiihglmeblgin	TRUE
lijcimndjnlghhj	TRUE
lijeibbnpikalmj	TRUE
mbkhjddajjnkpoj	TRUE
mbkngdgheknanih	TRUE
mmfocoehncbpgbh	TRUE
mminkcgcmidfppi	TRUE
nhbjoidfnibjbhj	TRUE
nhccfdakklkblbe	TRUE
obigadipphbkcim	TRUE
objfhhmohipknpj	TRUE
okpioclckgcodah	TRUE
olaabbboagpdkjb	TRUE
peogjnpgoifpdjl	TRUE
peojhfhbfjmelnj	TRUE
aaakkhjdndoaaaa	FALSE
aaclehbjhcoaaaa	FALSE
ajmbhoohomeaaaa	FALSE
ajmgahiplehaaaa	FALSE
bdhkkclilaaaahg	FALSE
bdhpmflflckaaaa	FALSE
bnjfbiafbcoaaaa	FALSE
bnlekhidobjaaaa	FALSE
chkdeggpgkcaaaa	FALSE
chlefbfflbdaaaa	FALSE
dajpdhllbdpaaaa	FALSE
dakhcclakaiaaaa	FALSE
dmikjcpjkmdaaaa	FALSE
dmjgbidcdgkaaaa	FALSE
efnljpopohmaaaa	FALSE
efofpdamglpaaaa	FALSE
faenmffjfmbaaaa	FALSE
fafhigafdcaaaaa	FALSE
fkpioickbbcaaaa	FALSE
fkpnjikclkjaaaa	FALSE
gfocmbkgnjcaaaa	FALSE
gfpnciepcdhaaaa	FALSE
hbhffkagpcfaaaa	FALSE
hbjdbjiidbcaaaa	FALSE
hklimefnkgkaaaa	FALSE
hkmjlnfjnbjaaaa	FALSE
iemlcbklopgaaaa	FALSE
ienjolcgngaaaaf	FALSE
ionjhmbmbpbaaaa	FALSE
ionjmjgdghfaaaa	FALSE
jkcjkaakpcnaaaa	FALSE
jkibpgpabbdaaaa	FALSE
kejamffinlbaaaa	FALSE
kejcbjjdacdaaaa	FALSE
kocgnnpaijaaaaf	FALSE
kocoibbnojeaaaa	FALSE
liadiglegnoaaaa	FALSE
lialjemafnbaaaa	FALSE
mcfohkgaiphaaaa	FALSE
mcgadkpmkipaaaa	FALSE
mmjbfobfholaaaa	FALSE
mmlaoalmmpkaaaa	FALSE
nffnmmpplliaaaa	FALSE
nfgkbedibklaaaa	FALSE
oandfnlejopaaaa	FALSE
oanikhllfbfaaaa	FALSE
okkdmlipcgoaaaa	FALSE
okkiphdcbdcaaaa	FALSE
pfhijkhkbecaaaa	FALSE
pfjdejdkfclaaaa	FALSE
aaakkhjdndolehbj	TRUE
aachcodfcolfadni	TRUE
ajmmohcdnjenmafl	TRUE
ajmpgoipjbmadplc	TRUE
bdhohikelhfmdndf	TRUE
bdiancaggokcdobi	TRUE
bnkolbchgdmeeock	TRUE
bnkpodelcgpnlmne	TRUE
chedfphgfgchlhmn	TRUE
chgedinblncmolol	TRUE
daobjliebbllgnfa	TRUE
daocmnfabfjdpknp	TRUE
dljebhcpjockcbgg	TRUE
dljnoahnkfmopcbm	TRUE
egeefcfppbhdhaie	TRUE
egencphpfagnhlif	TRUE
faflfdmnocedhmig	TRUE
fagcpogemalokjgl	TRUE
fkldkengoblkbkoi	TRUE
fkldnadpbjafimji	TRUE
ggkkcmaahjobgpff	TRUE
gglghmdncmhnfiod	TRUE
hcajecnlpoecljoh	TRUE
hcanopmddhfihjok	TRUE
hlejflcgiijkmckh	TRUE
hlfbfhdihldldaba	TRUE
iemngmembbcdffnf	TRUE
ieodegkgeloignje	TRUE
iopchacblbpagmig	TRUE
iopfkdigocfjjefe	TRUE
jkknjaofchlgjefg	TRUE
jkkomhjainnfkamk	TRUE
kfhpfjmoobjipaip	TRUE
kfignjjmbdfndlmd	TRUE
kogcpgcoaifagmeo	TRUE
koghdmhmldbjcbla	TRUE
libibiakgmnaogml	TRUE
liblpkfblodkpefc	TRUE
mbngioekcepggppl	TRUE
mbnlikpincloiigk	TRUE
mljgdigkdfihfphk	TRUE
mlkmbecmfbfakeia	TRUE
ngjgelgplmalfijj	TRUE
ngkgpgdblnpcehil	TRUE
oamcckpdaamdaobj	TRUE
oampmimgdnggfnmf	TRUE
olajgmkaholckjng	TRUE
olbojcggbmammckf	TRUE
pgaemmhndoddklak	TRUE
pgakbfcabakmeahj	TRUE
aaajiebebhkhaaaa	FALSE
aabhcpkphkdnaaaa	FALSE
akfalonidpadaaaa	FALSE
akfannlpkfkiaaaa	FALSE
begmmdacppmcaaaa	FALSE
behhiehnhnlaaaao	FALSE
bogacpdpgfooaaaa	FALSE
bogelboliddmaaaa	FALSE
ciepjbhmknhdaaaa	FALSE
ciflkjlffjhfaaaa	FALSE
dcfoidgjjbieaaaa	FALSE
dcgiipblcmneaaaa	FALSE
dmjegjmhlhdfaaaa	FALSE
dmjhdcomabbbaaaa	FALSE
egnfkppnflbhaaaa	FALSE
egnkpnlhabkaaaai	FALSE
fbggagcjajoiaaaa	FALSE
fbgkgcpjhoccaaaa	FALSE
fllpbfppcieaaaag	FALSE
flmbeiloolknaaaa	FALSE
gfjaenhdmiflaaaa	FALSE
gfjcmplmbhciaaaa	FALSE
hadekjidbdfaaaaj	FALSE
hadfmchpmnimaaaa	FALSE
hkapjojepfkoaaaa	FALSE
hkclbfjnojgmaaaa	FALSE
ifijlflhpjhgaaaa	FALSE
ifjadcepggakaaaa	FALSE
jadmaempkkjeaaaa	FALSE
jadnkcdplnanaaaa	FALSE
jkhcnkomfcecaaaa	FALSE
jkipjmmdhljhaaaa	FALSE
kecljgnelfniaaaa	FALSE
kedbieegcoomaaaa	FALSE
kojoaeodnapmaaaa	FALSE
koknhmpgpgfeaaaa	FALSE
ljbdgdeceghdaaaa	FALSE
ljbeeplajlgkaaaa	FALSE
mcmgcpaoeechaaaa	FALSE
mcmkhdnjmbabaaaa	FALSE
mmcikgelapiaaaaj	FALSE
mmdbhibcdgmgaaaa	FALSE
nhaendekicieaaaa	FALSE
nhcojlkfdkmgaaaa	FALSE
ocllgdijcgnlaaaa	FALSE
ocmkckbgoipmaaaa	FALSE
omfboagimfcaaaao	FALSE
omfdolodndfnaaaa	FALSE
pfedghjfpidiaaaa	FALSE
pfhfoeafjdpmaaaa	FALSE
aabfhiipddnchjpni	TRUE
aabfjibggiiekooji	TRUE
alinpggplghpkhjjk	TRUE
aljjimcccaamhiipp	TRUE
bggoliieemkaekeac	TRUE
bghhaecbnkfpkfflc	TRUE
calficbmihlgmadii	TRUE
cambkcaaljbjdgeph	TRUE
cligakolmdncbmdok	TRUE
clioecfphldnolfmd	TRUE
dgbghekejpklifkdh	TRUE
dgbgpmhepkadaciia	TRUE
eadnhngoodbbogkli	TRUE
eaeapchnphankapaf	TRUE
ekeddjienghlfccjf	TRUE
ekemfpjjejhnamhgl	TRUE
femebcbfeohhchlhe	TRUE
femedmlajeopfbdbb	TRUE
foojpmgahpjagcoka	TRUE
foopalicclojijfhp	TRUE
ghjcglghkfbhalnem	TRUE
ghjmdnejadflcljdl	TRUE
hbkeopdkfadfcdocn	TRUE
hblpgmcklmpmpjoeo	TRUE
hlnfedljlhcnmdpdj	TRUE
hlnglioedkmcgeaad	TRUE
ifohlojebbcbmfdih	TRUE
ifpdpknclflfgggfo	TRUE
ipmpoejceadgopmmi	TRUE
ipnemeanifmkpenbf	TRUE
jknhnhgcppmdgbhip	TRUE
jkpajkbnefegklmbi	TRUE
kfcpepicajmnenjce	TRUE
kfepkbghkcojpiano	TRUE
kpkjcmkekknngblnl	TRUE
kplnmmjobeklffpmf	TRUE
ljkdndmcfkaiidgah	TRUE
ljkkadogbhdlagcgo	TRUE
mdikmlioennhofcjg	TRUE
mdjpcgdalpbaigpgd	TRUE
moaecjcolemafgjmh	TRUE
moakifaaokflgceij	TRUE
nijgckkflghfdhika	TRUE
nikchohinmbljbofh	TRUE
ocfjihpmojpokkhhg	TRUE
ocgbckodpiomdmmld	TRUE
ollnlcaiagofaicfd	TRUE
olmkgadbiffkopjgf	TRUE
pfdpdalniaechgfep	TRUE
pfefipbigojjadjah	TRUE
aabfhiipddnchaaaa	FALSE
aabfjjpniibggaaaa	FALSE
alhobphaknodhaaaa	FALSE
alidjfehgcmdeaaaa	FALSE
bgmmgajbcfiobaaaa	FALSE
bgnbjemhijphlaaaa	FALSE
cajkhkaadniogaaaa	FALSE
cajldfmandgnfaaaa	FALSE
clfmkbcapimpaaaah	FALSE
clglklldbkhpaaaal	FALSE
dgaajamgopiffaaaa	FALSE
dgaielmpjlonaaaac	FALSE
eaiiomkbogmkmaaaa	FALSE
eakdhnpmafioeaaaa	FALSE
elaamcdkjmbgoaaaa	FALSE
elahldjidelgbaaaa	FALSE
fehogoodbbogkaaaa	FALSE
feiiapchnphanaaaa	FALSE
foobndbkehpepaaaa	FALSE
foolicegahofpaaaa	FALSE
gilmkhecoljndaaaa	FALSE
gimhhgpikelpmaaaa	FALSE
hccccfnikhencaaaa	FALSE
hccfmniobglhgaaaa	FALSE
hkpbijobgmokoaaaa	FALSE
hlbdnmojlpdniaaaa	FALSE
ifimkcnghdeiaaaaj	FALSE
ifjdinnjkhkeaaaaf	FALSE
ipimakbfbgajkaaaa	FALSE
ipjbjndgkgaopaaaa	FALSE
jkmhgehohikpkaaaa	FALSE
jkmnihmneelcpaaaa	FALSE
kfkceflokacdaaaah	FALSE
kfmmnakdaiilnaaaa	FALSE
kphpkohilefngaaaa	FALSE
kpjdfjjobpepnaaaa	FALSE
ljcgjebicpnoeaaaa	FALSE
ljcocifahhaooaaaa	FALSE
mdoomdooaicncaaaa	FALSE
mdpjplgboccggaaaa	FALSE
mobkjbmojgiogaaaa	FALSE
mocidhaojemeaaaab	FALSE
niicahjfomjnjaaaa	FALSE
nikeipjjjmakhaaaa	FALSE
ockbnglmfhcppaaaa	FALSE
ockdedkddgijnaaaa	FALSE
ommjaopnegnhnaaaa	FALSE
omnbhcbibepocaaaa	FALSE
pflcjdbjgmnmnaaaa	FALSE
pfleldaobeeplaaaa	FALSE
aabbdhhidpjadploin	TRUE
aabcggfegojeicjean	TRUE
aklncmmljnbngfbadg	TRUE
akpdjlcjiloidblgkb	TRUE
bdnbjhjpfmkobipkib	TRUE
bdnhipbjneanpalacp	TRUE
bnaibapcgbeadfiomi	TRUE
bnbffdfpnlnmjidjae	TRUE
chpkpkdhhpelmpnmoe	TRUE
ciacbgldckcfleoaoi	TRUE
dbmamcpcgoioflbjik	TRUE
dbmeljcnoonhjomfoj	TRUE
dliplelfnmalgoofpl	TRUE
dljigahljnfjhekepd	TRUE
egegmkpcnomijikccm	TRUE
egehigpmenocbikmkl	TRUE
faeaanhjkjdcbnfiki	TRUE
fafmmofiabbjeeeodb	TRUE
fkpgidecngebkhkkfi	TRUE
fldkcfefjjhhbjiggi	TRUE
ggbannhgoiffkioiio	TRUE
ggcgnmaknjnandgjkj	TRUE
hakeedfcalfbollple	TRUE
hakkflijdhmmabeadg	TRUE
hliaimagnmegajpbfl	TRUE
hlidelmjldolhdmjhe	TRUE
ifpcbbimljkpgmjjej	TRUE
ifpefjpdjdjdddnidn	TRUE
jalflfppiekbnlpdgk	TRUE
jalienpabfkgojijic	TRUE
jlbpceobiheonjhlmn	TRUE
jlcecgnoacmpkmkkmm	TRUE
kfealmoengbnafaldf	TRUE
kffbponfnnacgjjfap	TRUE
kpcfoafhjfpcjapoac	TRUE
kpcgbegpfponlejngn	TRUE
liogljnpdbifmkbjmp	TRUE
liogmiolgkfbdimfdi	TRUE
meenjfeabemobkjpij	TRUE
mefoebnmooiakejfep	TRUE
mojmlbcbminaeebeah	TRUE
moknefmoglhhoabagd	TRUE
nifbokgmijjbkhioki	TRUE
niffedjchfhepfccgn	TRUE
odcehkikjamljblckk	TRUE
odddjegfpljaaemfdf	TRUE
onmhdnknlaikjgihel	TRUE
onmhgopppildfipojp	TRUE
phcociabgindofcbfp	TRUE
pheeihknpnndokcokh	TRUE
aaaiopeljlocmeaaaa	FALSE
aacackfedlblfkaaaa	FALSE
ajihdgnfemmofpaaaa	FALSE
ajihhnppcjdoakaaaa	FALSE
bdpchfenhdoddaaaab	FALSE
bdpmflgfgelfeeaaaa	FALSE
bogbhbafccfpfpaaaa	FALSE
bogcfanamgbocnaaaa	FALSE
ciikbejjbmaimiaaaa	FALSE
ciiobpogfdpenjaaaa	FALSE
dbjpndnehldiinaaaa	FALSE
dbkocblilbicapaaaa	FALSE
dlgfmoopnjhcclaaaa	FALSE
dlgnddodinbhooaaaa	FALSE
efdghchknmmancaaaa	FALSE
efdlpkhegbpcmlaaaa	FALSE
epkbcdloeglmidaaaa	FALSE
epkbmncdkpcoibaaaa	FALSE
fkemnbgconijklaaaa	FALSE
fkfdjdkddoecfiaaaa	FALSE
gechlpjjbamjikaaaa	FALSE
gedefnflghlhjiaaaa	FALSE
godnbeedfimhdiaaaa	FALSE
godonkdinfkimpaaaa	FALSE
hifkpfanljgmejaaaa	FALSE
higbcljalgmhcaaaab	FALSE
icccknbmpekchcaaaa	FALSE
iccfggeicdehkfaaaa	FALSE
imbmfpeibfaaecaaaa	FALSE
imbnghhiedndicaaaa	FALSE
jgfjdilbaepblpaaaa	FALSE
jgfpdodapkgadaaaal	FALSE
kaeogcbdojlipiaaaa	FALSE
kafmalnpkgdeanaaaa	FALSE
kliadfghemdfaaaanf	FALSE
klioididamoagaaaaf	FALSE
lfnlgjbgmgoplcaaaa	FALSE
lfojoejehkkmmfaaaa	FALSE
lpohcbdkfdmkjgaaaa	FALSE
lppdlldnpopmnaaaai	FALSE
mjlfbfcllalfdnaaaa	FALSE
mjlhcojmknilcnaaaa	FALSE
nejbnhghfgijbcaaaa	FALSE
nekkifelmcllldaaaa	FALSE
nplnmfgogegpacaaaa	FALSE
npmgnnamklfjamaaaa	FALSE
okndnijkcdbnhjaaaa	FALSE
okpcppoiombhiaaaao	FALSE
pfglkbbfdfeihjaaaa	FALSE
pfgmhebaiceihnaaaa	FALSE
aabjlnbglfkgpifblck	TRUE
aacicioggmednhicfba	TRUE
akilainlmpdaiepphcp	TRUE
akjbildfpnmlndliklh	TRUE
bfbinbbdipchcjbglkb	TRUE
bfbjhhencchiodklngk	TRUE
bonbbecbhldgdihgfnl	TRUE
booihkmjlhmjdpegiof	TRUE
cikaljfafedpjjdeeih	TRUE
cilcpbibfnmchgbkmnn	TRUE
ddjdngbcjicjdidfdlm	TRUE
ddjfpcgjkajlgjmgmle	TRUE
dnoclkjacblikoikgmk	TRUE
dnogalemgpdhejkhcff	TRUE
eikjgnpggnffokbjiho	TRUE
eildojhoemmkniemaba	TRUE
fcachicelbkhcbkcehm	TRUE
fcbhpffkdjbdgdhagko	TRUE
fmhleeimacfppoaohbh	TRUE
fmiipioadobikdanfkp	TRUE
ghgciknbmnodgpdhaae	TRUE
ghgdmenanommgnjbpjh	TRUE
hccnolkkblhohlihpgn	TRUE
hcdmlamnhdolkbbgbmo	TRUE
hlmejkcdoglbjfaecfn	TRUE
hlnbchlbjidfifgjofj	TRUE
ifhbobbogcidmnmpifc	TRUE
ifhmabddnnkbcapbkan	TRUE
ipkenpdckokfdpeabif	TRUE
ipmomkilmagempnamka	TRUE
jjleobdcncmebamhfml	TRUE
jjlgpnfhbmffegjfian	TRUE
kdjopbdioaacmgpncck	TRUE
kdlhagdbjicnidbpmio	TRUE
kodeobofdhekaleipno	TRUE
kodpihcmhngjgkfaapg	TRUE
lhjkadicbjblgegkomc	TRUE
lhkhabfdnimljlbeifb	TRUE
mbgeocecnlnkgdincbn	TRUE
mbgjjanmhdlcikilmam	TRUE
mlolfgjmjfedpdlmflj	TRUE
mlooddaepfnpehcbkpi	TRUE
ngklalajbjelcfilojd	TRUE
nglilljodblhckdchnd	TRUE
npmcfjpjjakhbbclndi	TRUE
npmjmigodfalhhfolnj	TRUE
okofadbbbmjkogbnanh	TRUE
okoiblbokffjofadjbi	TRUE
pfccjnhfbijekiihbml	TRUE
pfdcllfoekpoeegaokf	TRUE
aabjlnbglfkgpifaaaa	FALSE
aacbckipcioggmeaaaa	FALSE
akjmdabjlokfpooaaaa	FALSE
akjmnnkdcgklegnaaaa	FALSE
bfdmdkpemfjbcagaaaa	FALSE
bffgcoidkjmefedaaaa	FALSE
boiheaemmbbhooaaaan	FALSE
boiljgabdheabdfaaaa	FALSE
cigjipedfclblkaaaac	FALSE
cigpmmhjkceikeaaaac	FALSE
ddgafifhckgbolfaaaa	FALSE
ddghijedomofnmiaaaa	FALSE
dodbpdjjdkgkgcaaaan	FALSE
doepfiognmepflhaaaa	FALSE
eifnkjdoikgjoflaaaa	FALSE
eigdafbepnjpfjhaaaa	FALSE
fbjjlkaogneigemaaaa	FALSE
fbjnggpjoghdambaaaa	FALSE
flponojhoemmkniaaaa	FALSE
fmafnhfhidkfaobaaaa	FALSE
ggilbblolmenlohaaaa	FALSE
ggjflmkigdpejoaaaah	FALSE
hbhbableaolkheeaaaa	FALSE
hbhbndaegcjaoolaaaa	FALSE
hknokblpiifinagaaaa	FALSE
hkppehkomgiilnkaaaa	FALSE
ifiimnaklmhemipaaaa	FALSE
ifipdajgikhfboeaaaa	FALSE
ipjcmegnkofgdclaaaa	FALSE
ipmbmgecelpnoodaaaa	FALSE
jjgbpmoigelpmoiaaaa	FALSE
jjgmjlekhbaphmhaaaa	FALSE
kdigcminmmagoncaaaa	FALSE
kdjcojckclihjoiaaaa	FALSE
knolhglppckajmdaaaa	FALSE
knphhkadgioapgoaaaa	FALSE
licnkamidbkeapiaaaa	FALSE
lifnboejcfikdoiaaaa	FALSE
mbhjmngagkfeolaaaae	FALSE
mbidndkhcdjlmafaaaa	FALSE
mmbldganicgmkabaaaa	FALSE
mmboknfjfcpdlcjaaaa	FALSE
ngikjajjiebbngkaaaa	FALSE
ngimldeodoabgfoaaaa	FALSE
npjlmioedohamfpaaaa	FALSE
npkeidmmcokddncaaaa	FALSE
okkaalaiadkbmkdaaaa	FALSE
okleophmhajigcfaaaa	FALSE
pejfmohikoajmmbaaaa	FALSE
pejpeaalhnkhgjnaaaa	FALSE
