aaaibjjaja	TRUE
aaakcpfame	TRUE
akloknbnab	TRUE
akmapkdmme	TRUE
beajcaekim	TRUE
beakibopmk	TRUE
bpcejlojjh	TRUE
bpcjlepicn	TRUE
cladgocdcg	TRUE
clagplfnin	TRUE
dfhijacilk	TRUE
dfhkemdjpb	TRUE
dpcidefinf	TRUE
dpcjibhfom	TRUE
eifkboepbn	TRUE
eigllikjjk	TRUE
fbmfllkklf	TRUE
fbmmccenfg	TRUE
flpkjjpmfl	TRUE
fmahndhjml	TRUE
ghabeplpjp	TRUE
ghahlhgmdc	TRUE
hbapmhcbmn	TRUE
hbcmdlllcp	TRUE
hlofbhkjep	TRUE
hlpckofajj	TRUE
igfghlnccn	TRUE
iggkmllgio	TRUE
jaedfnkhkn	TRUE
jafempacbd	TRUE
jjllnbkaif	TRUE
jjnkijbpac	TRUE
keiflhmmpb	TRUE
keiidmgjdp	TRUE
knlojljfko	TRUE
knohbiljpe	TRUE
lhlkdcfanf	TRUE
lhmghoegnp	TRUE
mcjpnofhhh	TRUE
mckfdadmme	TRUE
mngnojknjg	TRUE
mngofbeicc	TRUE
nhjkejndmb	TRUE
nhjkkgkjgn	TRUE
ocafphhnbc	TRUE
ocamfifbni	TRUE
omebbnbijn	TRUE
omejbikplb	TRUE
pggfhjipfk	TRUE
pghmedghcb	TRUE
aaancnaaaa	FALSE
aabbaiaaaa	FALSE
akbncfabab	FALSE
akcikpaaaa	FALSE
bdgdfbaaaa	FALSE
bdgoopabab	FALSE
bnihlbaaaa	FALSE
bnjbniaaaa	FALSE
chochfaaaa	FALSE
choncababi	FALSE
dbheidaaaa	FALSE
dbhfdcaaaa	FALSE
dlmpnmaaaa	FALSE
dlookbaaaa	FALSE
egkginaaaa	FALSE
eglgdjaaaa	FALSE
fbaiccaaaa	FALSE
fbapkjaaaa	FALSE
flofpfabab	FALSE
flojkbaaaa	FALSE
ggpkfjaaaa	FALSE
ggpobmaaaa	FALSE
hbblnnaaaa	FALSE
hbcedjaaaa	FALSE
hkcgeeabab	FALSE
hkcmmfaaaa	FALSE
ifdpfcabab	FALSE
ifebfpabab	FALSE
ipngloabab	FALSE
ipnnlhabab	FALSE
jjmmogabab	FALSE
jjnhhjaaaa	FALSE
kelkoiaaaa	FALSE
kemncpaaaa	FALSE
koicbpaaaa	FALSE
koigfbabab	FALSE
lihcnpaaaa	FALSE
lihdecabab	FALSE
mdkojbabab	FALSE
mdlhnlabab	FALSE
mngihbaaaa	FALSE
mngpomaaaa	FALSE
ngpdfnabab	FALSE
ngpmckaaaa	FALSE
oagjbdabab	FALSE
oagknbaaaa	FALSE
ombelcaaaa	FALSE
ombpndaaaa	FALSE
pgamcpaaaa	FALSE
pgaoadaaaa	FALSE
aaancnkhdba	TRUE
aabiinmkkbm	TRUE
akdcclblfpi	TRUE
akdfjhjfbcp	TRUE
bednkffoedc	TRUE
befcicagalg	TRUE
bnkiihhdlak	TRUE
bnledhbiafc	TRUE
chbjldacpck	TRUE
chbphdndmcd	TRUE
dbllaejgagi	TRUE
dbmjcllakkh	TRUE
dlkfbhbmmki	TRUE
dlmbdcneaci	TRUE
ehbeincppgj	TRUE
ehbfgjaebkc	TRUE
fbhmjnngcck	TRUE
fbijaddnioi	TRUE
fmigfhblkjk	TRUE
fmihgckbfan	TRUE
ghdgfcpepjo	TRUE
ghgahnkbena	TRUE
hbfdldejhgc	TRUE
hbfgheaofdo	TRUE
hlapmmooljf	TRUE
hlbbdoniopd	TRUE
ieoaofakepb	TRUE
ieonchmhlhp	TRUE
ipmadgfomfp	TRUE
ipngajmleea	TRUE
jkibkmfmafh	TRUE
jkjndgmoohd	TRUE
kfeaanbljda	TRUE
kfiigeefahp	TRUE
kochmhjmegh	TRUE
kocngkeoghn	TRUE
ljdijhnhjbc	TRUE
ljdnobhfhip	TRUE
mdgdbopgdll	TRUE
mdgddhoooge	TRUE
mnhiblkjafe	TRUE
mnhlipkaild	TRUE
nhggdhnkamj	TRUE
nhggnciaefm	TRUE
oalgdnabcef	TRUE
oambjfjcnam	TRUE
omdhhaonkhj	TRUE
omeicfenngg	TRUE
pgbcjijgnip	TRUE
pgbilcdamja	TRUE
aaancnkabab	FALSE
aabaiopaaaa	FALSE
akcbcaeabab	FALSE
akcmdmlabab	FALSE
beapdccaaaa	FALSE
bebcfcdaaaa	FALSE
bndaoefaaaa	FALSE
bndeckmaaaa	FALSE
chngblhaaaa	FALSE
chnmjciabab	FALSE
dbepngjaaaa	FALSE
dbfakcbaaaa	FALSE
dlkcdjlaaaa	FALSE
dlkldnhabab	FALSE
egngakiaaaa	FALSE
egnpockaaaa	FALSE
fbfbpkgabab	FALSE
fbfgngdabab	FALSE
flinjbfaaaa	FALSE
flmbjdfabab	FALSE
gghghjeaaaa	FALSE
gghipkaaaad	FALSE
hbpegcdaaaa	FALSE
hbpklfkaaaa	FALSE
hmfimldabab	FALSE
hmfkpbbaaaa	FALSE
ifdpedaaaad	FALSE
ifeoopnabab	FALSE
iponlccabab	FALSE
ippcbddaaaa	FALSE
jjpmebgabab	FALSE
jjppjniaaaa	FALSE
kdpehdfabab	FALSE
kdpkndkabab	FALSE
kogelbkaaaa	FALSE
kogiigfabab	FALSE
ljjccjpabab	FALSE
ljjlfomabab	FALSE
mdmhcdpabab	FALSE
mdmophgabab	FALSE
mnkmfeababj	FALSE
mnllhncabab	FALSE
nhabnlcabab	FALSE
nhbegkjaaaa	FALSE
oamcklpabab	FALSE
obafgmgaaaa	FALSE
omecplnabab	FALSE
omeinkjabab	FALSE
pghjgbcabab	FALSE
pgiaoghaaaa	FALSE
aaajichgickd	TRUE
aaapnjhgdopi	TRUE
aldkpcjfmbmh	TRUE
aldnlfhfgagn	TRUE
bgcekgckcebd	TRUE
bgdocnfnkbmd	TRUE
bpmjhedeocjb	TRUE
bpngjghjakgn	TRUE
ckbdkpmcbbhg	TRUE
ckcigpbadkjk	TRUE
dflhchkoffaa	TRUE
dflpcmgigmnk	TRUE
dppcmemimdei	TRUE
dppfilgabkgd	TRUE
eklchpfmemil	TRUE
eklldlahjcio	TRUE
fflacfloeljl	TRUE
ffldapdebogn	TRUE
fpmlhkcnkphe	TRUE
fpnnoolplhnl	TRUE
gkampjmmladm	TRUE
gkbgomllhgbf	TRUE
hcmompjkmnnm	TRUE
hcnknkfjooih	TRUE
hmeknpcpnkpc	TRUE
hmelghakbind	TRUE
igbeeoaimehb	TRUE
igcdeleogmmj	TRUE
ippgelahcghf	TRUE
jaailpeddhpi	TRUE
jkkaajbfailo	TRUE
jkkbcgphfpmh	TRUE
kfgpfehfeccd	TRUE
kfhffebimnac	TRUE
kpngdacmkdmo	TRUE
kpohphdmclom	TRUE
ljhgdnifmejm	TRUE
ljhkmkjncheh	TRUE
mciekandcblp	TRUE
mcjbcceagkcn	TRUE
mncaefbmedjj	TRUE
mndfijkplcmp	TRUE
nhcahhjaflgp	TRUE
nhcmefdkbhcc	TRUE
ockemammdmci	TRUE
oclefaleagkp	TRUE
onhjmcdijjab	TRUE
onicmhnnooek	TRUE
pfpkniilgkae	TRUE
pgadafeigogi	TRUE
aaajichgaaaa	FALSE
aaapckdnabab	FALSE
aledooamaaaa	FALSE
aleniblfaaaa	FALSE
bfmcpmnjabab	FALSE
bfmdodhhabab	FALSE
bphapfdababl	FALSE
bpjmgbnoabab	FALSE
ckfoimikabab	FALSE
ckhcnkekabab	FALSE
dflcinekaaaa	FALSE
dfleijhoabab	FALSE
dpopjcecaaaa	FALSE
dppamocbabab	FALSE
elfdmfncabab	FALSE
elhbabhdabab	FALSE
fendikblaaaa	FALSE
fenhgeegaaaa	FALSE
fphijljkaaaa	FALSE
fphlfopababi	FALSE
gjibbdjababi	FALSE
gjjghaegabab	FALSE
hdelndoababd	FALSE
hdepnaoaabab	FALSE
hmaioojaaaam	FALSE
hmbcpdaeabab	FALSE
ifogoebaaaai	FALSE
ifokejdjabab	FALSE
ipodfomjabab	FALSE
jaabdiodaaaa	FALSE
jlflcgggabab	FALSE
jlfpdeheaaaa	FALSE
kfcheabkabab	FALSE
kfejmndaabab	FALSE
kpjfehkcaaaa	FALSE
kpmkdfheabab	FALSE
ljhhkfkbaaaa	FALSE
ljjhcpakaaaa	FALSE
mdceknoeaaaa	FALSE
mddfdlclabab	FALSE
mmjcgoeiaaaa	FALSE
mmjdkhbababg	FALSE
nhffdhieaaaa	FALSE
nhfggemcaaaa	FALSE
ocfnhamhabab	FALSE
ocgkigcgabab	FALSE
olihbnhiaaaa	FALSE
oljlpaioaaaa	FALSE
pgckhibfaaaa	FALSE
pgehppehaaaa	FALSE
aaagnkoffiaaf	TRUE
aacdehgglidfd	TRUE
ajakebpnkapcn	TRUE
ajaneepckhjoc	TRUE
bchmfbiknbnbl	TRUE
bchncffmpgmdo	TRUE
bnfnmjdebhghe	TRUE
bngimadenpigh	TRUE
chokgcangphkb	TRUE
chpocehkhlaoj	TRUE
dcjfdncipokca	TRUE
dcjlglhaijnja	TRUE
dmpfnnnpebhil	TRUE
dmpiblgnpljcf	TRUE
efnnfjgjdjecf	TRUE
efogfflfhelij	TRUE
faiapchmgkdel	TRUE
faibdonnjmjac	TRUE
fkfnjomhflmin	TRUE
fkfomeapbgolm	TRUE
gemlmkcmplild	TRUE
gempmmmdimdmf	TRUE
gplgmikacikcj	TRUE
gpllfhoabbohf	TRUE
hkgklkinfplki	TRUE
hkgomgncnfdaj	TRUE
ienkgpcipnjkc	TRUE
iepbjbphdolhn	TRUE
ioghoneiojagi	TRUE
iohoenekgnncj	TRUE
jidijkkbpidgm	TRUE
jidoiboohjgla	TRUE
kdchfngghilca	TRUE
kddookhfjfioe	TRUE
kmkhgacflgngi	TRUE
kmkjifdmjcofc	TRUE
lgeobmbojaelf	TRUE
lgfgpecbbbkfe	TRUE
mbjemfahpfkbp	TRUE
mbjglkkjnkhih	TRUE
mmhmfmmbiocah	TRUE
mmiinadbnocom	TRUE
nghpcbjonhobn	TRUE
nglmdnlphohac	TRUE
oagefcifbgjoc	TRUE
oaggnopbjinlp	TRUE
okeoeeiodacgd	TRUE
okfcdgmmfhobd	TRUE
pffcaejnedkjp	TRUE
pffmhlocjmdhk	TRUE
aaagnkoffaaaa	FALSE
aacaafdehaaaa	FALSE
ajbkmaffaaaac	FALSE
ajbpmackpabab	FALSE
bcdnjdiekabab	FALSE
bceglbohkabab	FALSE
bnkcfomnmaaaa	FALSE
bnkofombaabab	FALSE
cildpgeflaaaa	FALSE
cilnhaibcabab	FALSE
dcfliamafaaaa	FALSE
dcfnhmlfeabab	FALSE
dmmdljeefabab	FALSE
dmnnggmimabab	FALSE
ehelckedfabab	FALSE
ehfcigopjaaaa	FALSE
fanbmjbngaaaa	FALSE
faninikkfaaaa	FALSE
fkbnpmkkcabab	FALSE
fkchpofchaaaa	FALSE
gejdpmcnbaaaa	FALSE
gelbdpklgabab	FALSE
gplepnddiabab	FALSE
gplicalbhabab	FALSE
hknemecnhaaaa	FALSE
hknichcehaaaa	FALSE
idmdgkjgjaaaa	FALSE
idmonmcjababb	FALSE
ioaejdcaaaapp	FALSE
ioafdecbnaaaa	FALSE
jhmoagjihabab	FALSE
jhnofieeiabab	FALSE
kcoidggmkaaaa	FALSE
kcpficipababp	FALSE
kmgjpofahaaaa	FALSE
kmibpcjggabab	FALSE
lhikhcgepabab	FALSE
lhjbbihojabab	FALSE
mbcnkbaheabab	FALSE
mbdiikecpabab	FALSE
mmfmolffcabab	FALSE
mmghjgafiabab	FALSE
ngjelpdagaaaa	FALSE
ngkagclhgaaaa	FALSE
oafjflaihabab	FALSE
oagjafgonaaaa	FALSE
olebjngpaabab	FALSE
olebnookbaaaa	FALSE
pfbbcckniaaaa	FALSE
pfbmpobhlabab	FALSE
aaagalfgmnbpdj	TRUE
aacdligiognlco	TRUE
akjmcjfdeibodo	TRUE
akkjlljjeinckj	TRUE
bgcdiaekbpjjak	TRUE
bgddmogmebjogc	TRUE
caofngginkbcll	TRUE
caoppppldoonlk	TRUE
ckcoljpgcoelhb	TRUE
ckdeneddhmipaf	TRUE
dehjajdojjlaee	TRUE
dehjfjljgnfhmc	TRUE
dooanknjjaemhn	TRUE
doogcngonkgkko	TRUE
ejcmmenejgmkcb	TRUE
ejemnjomghdnae	TRUE
fclglejpdddiej	TRUE
fclkhdojpcppei	TRUE
fmmdheadacikfp	TRUE
fmnglegigbkfmp	TRUE
ggehfkjebnknmf	TRUE
ggfijnpkkhamoc	TRUE
hadbednhjoinda	TRUE
hadjmmjdbbiemb	TRUE
hlaabhfolbgkae	TRUE
hlbfckkjmabhno	TRUE
iejnlpndgogjbh	TRUE
iekiocidlmkokg	TRUE
ipljmbbhgjaoog	TRUE
iplladakghcfkh	TRUE
jijppofnmaccnl	TRUE
jimhcfggggdgfb	TRUE
kdcmalhodpedhn	TRUE
kddcabpmpnnflj	TRUE
knlalnodlcmglp	TRUE
knmhpjnidkehjh	TRUE
lhoobhaojkeiga	TRUE
lhpbdhcjfchjin	TRUE
mcjaedkcldbeij	TRUE
mcjlmmjdlaeghh	TRUE
mnojnpejfhkpgc	TRUE
mnokpehaidpjfk	TRUE
nhmalihihcngkc	TRUE
nhmoefoneamlkl	TRUE
objcacdnbcopih	TRUE
objplhpldljlml	TRUE
olamapjhkgckmp	TRUE
olbcmafgjibahf	TRUE
pfngecehafalpm	TRUE
pfoagbkfkckahh	TRUE
aaagalfgmnabab	FALSE
aacdjddpliaaaa	FALSE
aklingbpboabab	FALSE
aklndfnaeiaaaa	FALSE
bgmgbppgenaaaa	FALSE
bgofhalceeaaaa	FALSE
cbbfghmacmabab	FALSE
cbbphedchjabab	FALSE
ckomagpohiaaaa	FALSE
ckonopcdcjabab	FALSE
delamcbnhdaaaa	FALSE
demfnfmomlaaaa	FALSE
doegkomnkkabab	FALSE
dohdenhmoeaaaa	FALSE
eibkhmlfjmabab	FALSE
eidajomlljaaaa	FALSE
fdclapakjgabab	FALSE
fddmkonapnabab	FALSE
fnhceknddgabab	FALSE
fnhhdaiepiabab	FALSE
ggdcaiokojaaaa	FALSE
ggddefnffgaaaa	FALSE
habfbkdmkmaaaa	FALSE
hacpdjbgghaaaa	FALSE
hjmifnhpfdabab	FALSE
hjmobdpmaaabab	FALSE
ieedgkdjkeaaaa	FALSE
iefegilnejaaaa	FALSE
ipikdlbphhabab	FALSE
ipjidnngapabab	FALSE
jkaaigjhdjaaaa	FALSE
jkacafleaoabab	FALSE
kdjmimmhalaaaa	FALSE
kdllmpccchaaaa	FALSE
knmamikjfbabab	FALSE
knmcagfileabab	FALSE
lhhpmegghpaaaa	FALSE
lhiipkcnodaaaa	FALSE
mdjgipkmdnabab	FALSE
mdjjgbldmpabab	FALSE
mnlejbonehabab	FALSE
mnmoogmggcaaaa	FALSE
ngoemcmhjjabab	FALSE
nhbaopghpdabab	FALSE
oaoaihmljbabab	FALSE
oaocpohfofaaaa	FALSE
omfalceoihaaaa	FALSE
omffonineoaaaa	FALSE
pfhkofalhjabab	FALSE
pfhnoggfkmaaaa	FALSE
aaabdcbplhlpobi	TRUE
aaboadebahpnmmn	TRUE
ajneggielombghp	TRUE
ajnodkhffcilbfo	TRUE
beinoofpjeaghic	TRUE
bejmpolempfccha	TRUE
bpfehlfjcknkdka	TRUE
bpffmmpliafppop	TRUE
ckghnppgbeldgdc	TRUE
ckgibkoccobocdk	TRUE
dfbjelfnidcehaa	TRUE
dfblfhfkpoeeojl	TRUE
dpfmmgpbecglaca	TRUE
dpfpaglggpcbhce	TRUE
ejleanephlikhok	TRUE
ejlpnclnicnanib	TRUE
febgbhghgncneen	TRUE
fecobmhkbdahkco	TRUE
foaknidbcmoijko	TRUE
foedflbpjeiebdo	TRUE
ghbkghfgnniffgk	TRUE
ghbknjbdccoanfp	TRUE
hamkdhjdakphmdk	TRUE
haolebjfmjombho	TRUE
hkmbflpcinjfilj	TRUE
hkmnljnbdbkpbep	TRUE
ieopacellmpbfni	TRUE
iepmkhikpbeddli	TRUE
ipncdndgbjlghne	TRUE
ipnigfnhhlbicgi	TRUE
jiecbkfhdkfbdep	TRUE
jifchaagbegfjko	TRUE
kefbkbkgplfijfe	TRUE
kefjdfpameeboag	TRUE
koidhfnngcekflb	TRUE
kokdjhidnggkfmp	TRUE
likinccihfiojnj	TRUE
likpapagjilgflc	TRUE
mdbhfkmebefoang	TRUE
mdbhlpeimodecog	TRUE
mnccmacihimdlbf	TRUE
mncdammcjdbgfjm	TRUE
nhpdklcmaanfjme	TRUE
nhpmgohjiolldfd	TRUE
obkbgodbjfgfgpb	TRUE
obkfnakbamlaodm	TRUE
omdclcebggnnajp	TRUE
omdjenkenmnbaed	TRUE
pfnnkapinjneohe	TRUE
pfoijkodafmdinj	TRUE
aaabdcbplhlabab	FALSE
aabobioadebaaaa	FALSE
ajnidpfogilabab	FALSE
ajobckbbkmjabab	FALSE
beehigkdneaabab	FALSE
beelkoimcpmaaaa	FALSE
bpepjcldolkabab	FALSE
bphdobdedfkaaaa	FALSE
ckgdhldgmdiabab	FALSE
ckimljcmdcjaaaa	FALSE
depejjeammlaaaa	FALSE
dfcacnfmnnpabab	FALSE
dpomjhiifkgabab	FALSE
dppdcfkpejlabab	FALSE
ejppgcmpdecabab	FALSE
ekbippojdomabab	FALSE
fdghhmlelbiaaaa	FALSE
fdgomlkchjmabab	FALSE
fngflahfaaeaaaa	FALSE
fnghchpebibabab	FALSE
ghhidaapchhabab	FALSE
ghidihmdkcbaaaa	FALSE
hbgafhnfdbiabab	FALSE
hbghneigkdcaaaa	FALSE
hlebkokgfljaaaa	FALSE
hlemliepegeaaaa	FALSE
ifibecpjeecaaaa	FALSE
ifkddpfddigabab	FALSE
ipkaoggoloaabab	FALSE
iplhohnahdfabab	FALSE
jjapllmbgodabab	FALSE
jjbhomaipfjaaaa	FALSE
kcpepdfdmhkaaaa	FALSE
kdacbipijpbabab	FALSE
kopfhknlcmiaaaa	FALSE
kopindoagcfabab	FALSE
lhpbbnmjffiabab	FALSE
lhphifhflalabab	FALSE
mdjoedjehnhabab	FALSE
mdklbapomolabab	FALSE
mneoeooniibabab	FALSE
mneohcenfpeabab	FALSE
niejainceegaaaa	FALSE
nifkmhmcmgnaaaa	FALSE
ocdalgaammpabab	FALSE
ocdhnbalaipaaaa	FALSE
olmdmgicjffabab	FALSE
olmgidfbmokabab	FALSE
pfiiccelmedaaaa	FALSE
pfjpimghohhabab	FALSE
aaaeabheiiicjiab	TRUE
aaahhckabaciebik	TRUE
ajnakldooekipoag	TRUE
ajoipcgedaabbihm	TRUE
bdgdaffngnlilfpc	TRUE
bdhaaepbneafhomg	TRUE
bonbfiihehkndjil	TRUE
boonjneiipgedgpb	TRUE
cigclfcfbdkljmmb	TRUE
cighfgplcgkgicem	TRUE
dclecdgnnmblhcjh	TRUE
dclkhodaiplfehgj	TRUE
dmgoanihginojfdm	TRUE
dmgojcophimmccep	TRUE
ehockbpgldgdcbap	TRUE
ehomeecmahanfepl	TRUE
fcmioipbcbfadcjj	TRUE
fcooenjgcpifjink	TRUE
fmlacgknofeifdmb	TRUE
fmlmgckhhlkjkobj	TRUE
ggdjcnglpbnfigof	TRUE
ggdniinegobmanpo	TRUE
gphlnaibnbdpafdh	TRUE
gphpiffeeejbcdmm	TRUE
hkgfgoelbpopaild	TRUE
hkgflhceehpgldja	TRUE
iemfenkcphdnddbe	TRUE
iemhmedpiejjdplp	TRUE
ippjdnbobpbenehn	TRUE
jaaephhjmaohoege	TRUE
jjhjjajobibpakcf	TRUE
jjihjddooildbgpp	TRUE
kdemdcoeonapdnmc	TRUE
kdfjibfjhpdjkmgo	TRUE
kmoeiebgbechedjh	TRUE
kmpiklkaghilhodn	TRUE
lhkbeodmidgbelnc	TRUE
lhkenjmaefgelhon	TRUE
mbkhjdalkapjklpj	TRUE
mbknammmddihppld	TRUE
mlnoiijcoknaogao	TRUE
mloahfilgplejbhe	TRUE
ngjbjeegjngnnkcf	TRUE
ngjnhcappmfhadac	TRUE
odbkgbiclhhdlbge	TRUE
odcomdnmgcnbblcj	TRUE
onfpdkidoaamcobe	TRUE
ongfdffcpgdhaden	TRUE
phbgkadpcnkgpdjp	TRUE
phbgojokoonknpkm	TRUE
aadgfkfbkpemabab	FALSE
aadodholaepnabab	FALSE
akdjecgmkjhkabab	FALSE
akfopnmimbabaaaa	FALSE
bflegmbdhohbabab	FALSE
bfmbmhfioamjabab	FALSE
cafjgphfcjopaaaa	FALSE
cagjlbgnnlcmabab	FALSE
clnjnoplgoboabab	FALSE
cmadipaoelhhaaaa	FALSE
dfdielnonhbhaaaa	FALSE
dfdjpjjkfnkeaaaa	FALSE
donkngcphnokabab	FALSE
donknladlcnoabab	FALSE
ejbegiepghifaaaa	FALSE
ejbjijpbiajnaaaa	FALSE
fcmmagndmianabab	FALSE
fcmpidbjekdbaaaa	FALSE
fmjfoagjnbpnaaaa	FALSE
fmkblfnoiihaaaan	FALSE
ggbdcacgdkeiabab	FALSE
ggbmlmfdmkppabab	FALSE
hadjgngfamjhabab	FALSE
haenaglihijdabab	FALSE
hkbldeanmhdjabab	FALSE
hkcoofhllaepaaaa	FALSE
idgfdknebaakabab	FALSE
idggphcfjojoaaaa	FALSE
impijmncihigabab	FALSE
impinihcbbcpabab	FALSE
jhonpgekgmogabab	FALSE
jhooeoahdbphaaaa	FALSE
kcikpadieoinabab	FALSE
kcjodclhhllbaaaa	FALSE
knghdhkammgiaaaa	FALSE
knhmcccgaankaaaa	FALSE
liienhjpmjmdaaaa	FALSE
liifhbdkcfocaaaa	FALSE
mcdcpaelkenpabab	FALSE
mcdeohfcfjjhaaaa	FALSE
mmnodflmnineabab	FALSE
mmocchdlmghgaaaa	FALSE
nhajbaimpicgaaaa	FALSE
nhajpkhiidliaaaa	FALSE
obhbgccpfbgeabab	FALSE
obhgijodplmnaaaa	FALSE
olhgocfmmemmabab	FALSE
olhmmhmpefjmaaaa	FALSE
pficmihnophnabab	FALSE
pfkahgoipcdcabab	FALSE
aadgfkfbkpemdmdho	TRUE
aadoaepnhcjmkahpo	TRUE
akbdmakefmellopna	TRUE
akcgebcmchcnlhgme	TRUE
bfhpnjekdcejgdbaj	TRUE
bfildakieojllaagn	TRUE
cacnpgkcaimgofejd	TRUE
caegahbbcnicopmlk	TRUE
clljlajckbhifohop	TRUE
clmmfolbjiendikjj	TRUE
dflonmlkpbiplondl	TRUE
dfmgegmlcpdommcim	TRUE
dpcoeefeikkeoihkd	TRUE
dpdnfpmdgbnkmkgjf	TRUE
eiopfcnbjcpgkpgjh	TRUE
eipdbaoodgoiknbhn	TRUE
fcknnmihfhoamlmfc	TRUE
fclnjepcbdboigacj	TRUE
fmcbpjaioielndobc	TRUE
fmddmllnonkocckac	TRUE
ggjlgccenpiacckji	TRUE
ggkkdkialkbicgmhj	TRUE
habanackpjmnflhah	TRUE
habbhilohpbgemble	TRUE
hjmilocnddpjnlbif	TRUE
hjmplpfogbghomcph	TRUE
idmhoajekmgmipcpi	TRUE
idnhhgoogmdhknlia	TRUE
inamipobjdgeceena	TRUE
inbpmmeohjcldefmp	TRUE
jhgocmenlecdoiohf	TRUE
jhidaffnghobkdegd	TRUE
kckaemiljfilgoelg	TRUE
kcmjamjofokbkjeob	TRUE
knmmlcimadknicfhg	TRUE
knmnipcognjmoopcl	TRUE
lhljinjigofechdpl	TRUE
lhmeldmblmpchiejl	TRUE
mcacohggnbddimppg	TRUE
mcahkojpimplffdad	TRUE
mmdfboeahineghfpb	TRUE
mmdoaekdkapbnaonk	TRUE
ngpifkmkdgoiciena	TRUE
nhafkfccnlfpljhia	TRUE
obnjnlncbkplbikin	TRUE
obnkoddollifgbnap	TRUE
ompoicbhighhhfgfa	TRUE
onadikghkolbhpigd	TRUE
pfnpedfdlodoggpml	TRUE
pfopeanikgnjffnfl	TRUE
aaceoiddbgdmcabab	FALSE
aadldgbeeompfaaaa	FALSE
akcddjjpkmiiababb	FALSE
akeiodefmladiaaaa	FALSE
bdoojaljfgjjababa	FALSE
bdopboikhhonkabab	FALSE
bnigjlcokaijhabab	FALSE
bnjkeidmalialaaaa	FALSE
ciaocnceabbknabab	FALSE
cicndbffncfilabab	FALSE
dbhemmgaennklabab	FALSE
dbiebioicpjdfaaaa	FALSE
dncgblgkmlohjaaaa	FALSE
dndaaefapikbdabab	FALSE
ehfcffckjfldcaaaa	FALSE
ehjncnblcmhmnaaaa	FALSE
fccohgeglnpggabab	FALSE
fcdjliglnooklabab	FALSE
fmfegblflbfclabab	FALSE
fmffijkckofocaaaa	FALSE
ggcmnindllkjdaaaa	FALSE
ggdgnfdehbcjlabab	FALSE
hbaohcdkgbnjcaaaa	FALSE
hbbgfemgnphpdabab	FALSE
hlnkcfbjcemnnabab	FALSE
hlnneibmmhmbdaaaa	FALSE
ielbfjodfobphabab	FALSE
ielmkojkgmjfpabab	FALSE
iomjighgjgbkpabab	FALSE
ioonofkeecfonaaaa	FALSE
jjomkhekjeghdabab	FALSE
jjpbfmbnbglahaaaa	FALSE
kemnjklgegpbhabab	FALSE
kempnjheacaeiabab	FALSE
knochpfoijkdfabab	FALSE
knpaadaibmhehabab	FALSE
liaeemdoeaiafabab	FALSE
liaeiobhnbmcjaaaa	FALSE
mbncfkejbhilpabab	FALSE
mbobjahmhgkdlaaaa	FALSE
mmflielcjdgfeaaaa	FALSE
mmgkbdljlnoagabab	FALSE
nhakmdmdgjighaaaa	FALSE
nhbfjjlhcfbljabab	FALSE
ocbifcaaiknneabab	FALSE
occeghbcgmbclabab	FALSE
omfgphgbghphbaaaa	FALSE
omfkpnmldbbicabab	FALSE
pflpclnncdnceabab	FALSE
pfmdmomginbmbabab	FALSE
aaagkokhhgcpgfcgke	TRUE
aaalnkfplafopgdafm	TRUE
akikaghobmnfdiopah	TRUE
akjnjlphklpehgnpfb	TRUE
bemiopoggcfaceghnp	TRUE
bennilipbimamfbdni	TRUE
bpkiindcehefidikbf	TRUE
bpklmohkmnghgnjmho	TRUE
cjghenhdohljifomen	TRUE
cjgpfnfhhobilmfapp	TRUE
ddpfhceekfgclaliig	TRUE
deaehpohcgienimkcf	TRUE
dnlnkgapbokimioaba	TRUE
dnlpoelmjohkggfnog	TRUE
ehabjdpnlijgpobode	TRUE
ehappkkfjdokbegehl	TRUE
fcgoebnbiiadnehbeh	TRUE
fchmipdlhhhbckanac	TRUE
fmhnlhoeepoebbgefc	TRUE
fmikfjaeikpdcpmnfl	TRUE
ggmhonfnlpbhnbkmjb	TRUE
ggnfeeffgjidbpghmf	TRUE
hajbgcobiobnjkeenc	TRUE
hajfaadopfmapppmbf	TRUE
hkgngicnihgpkgemid	TRUE
hkhcokpghmgncekahp	TRUE
idffppaecikpdaoipm	TRUE
idfohiknkcekgljnna	TRUE
inhnhdcnplbphmoiob	TRUE
inhobbflmfillgphhn	TRUE
jinfbikfmimklbmeko	TRUE
jioeifkoakbakhmmbe	TRUE
kbfcjamejmnfadaaci	TRUE
kbfibpaggbfldofcgd	TRUE
klobjfcijnhongkmlj	TRUE
klpajdnbkldlmjmcnf	TRUE
lhfmckcgagmbmklldi	TRUE
lhgdlegnblkackcidd	TRUE
mccihhdaklkhlfgdgi	TRUE
mceigclpajkhkbbode	TRUE
mmaildmjhjfibiniob	TRUE
mmalenkdcaenlhkmcm	TRUE
ngkhfefnlflclflaag	TRUE
ngkibglainkdamhpgi	TRUE
obkijdlaoikkklfmag	TRUE
obljglilinggekfocn	TRUE
onelofbccnbkigdfpg	TRUE
onenpelganfmndjjle	TRUE
phciaimmffabcndhbn	TRUE
phdgjjdkjffidiajii	TRUE
aaagkokhhgcpgfaaaa	FALSE
aaalgkenkfplafaaaa	FALSE
akladpakmanmbjaaaa	FALSE
akllljnnocpkgnabab	FALSE
bfdcpbknhojineaaaa	FALSE
bfdnffoifhmeicaaaa	FALSE
bpilgejmgjnkeoabab	FALSE
bpjdgmojaeabmlabab	FALSE
cjdajahlhfejnhaaaa	FALSE
cjecfceppjaamiaaaa	FALSE
deaihgkdohpccdaaaa	FALSE
deaopncdmkebmhaaaa	FALSE
dnkkmpnmbpgfobabab	FALSE
dnmdchihiemiioaaaa	FALSE
eiefnlfnhbdngeaaaa	FALSE
eieijjijogiefiaaaa	FALSE
fcpjdimdpjcajjaaaa	FALSE
fcppdcdogkbofcaaaa	FALSE
fmlalnijceejnbabab	FALSE
fmlgmoicmdcpmdaaaa	FALSE
ghkbnkgdngegmcaaaa	FALSE
ghkdlkcmcogiflaaaa	FALSE
hagdcndpfakbfjaaaa	FALSE
hahjiiejejnbdhaaaa	FALSE
hjckhddbamiegeaaaa	FALSE
hjeeemanjglgkjabab	FALSE
idmpeiileckkjmabab	FALSE
idnnpjpakkaggpaaaa	FALSE
inmjjnilnhgbdhaaaa	FALSE
inmmfhmiffgkpiaaaa	FALSE
jhphmafdofkahoabab	FALSE
jhpjhnpfakmccpaaaa	FALSE
kbaaeapaokbiaaabab	FALSE
kbabbalelnepgbabab	FALSE
klhejohfdfaiddaaaa	FALSE
klhifejhjnbampaaaa	FALSE
lhcllacnmgkfjoabab	FALSE
lhdbcckclomjoeabab	FALSE
mbnpknmhelgoliaaaa	FALSE
mbodnafofmcfghaaaa	FALSE
mmehconilalibeaaaa	FALSE
mmknnijjejcdimabab	FALSE
ngjfadfapecdpkabab	FALSE
ngknjfhncfieomaaaa	FALSE
oblacpiaphoilcaaaa	FALSE
oblnjhobcggkbfaaaa	FALSE
ongicehmdkgclbaaaa	FALSE
onhphhlbfdidjmabab	FALSE
pgmbkadfchoofnabab	FALSE
pgmnmepphkijeoabab	FALSE
aabkhhelhbdjmeomjdg	TRUE
aadggcmaonafgabobkm	TRUE
akgbomlpclkebeloggc	TRUE
akgbonkhkdiahbbjpkg	TRUE
behhodpfkeiiaehnakj	TRUE
beiigbclogblemgafno	TRUE
bnhfociccenniaabmad	TRUE
bnjggkmgfclbmmbkeig	TRUE
cicgachclbjlpaloihk	TRUE
cicgbmngcjfpadkgghl	TRUE
ddjhamcmcikgpkaelpe	TRUE
ddjhomddhlfgngdhjce	TRUE
doeddopbhdgeiacnkki	TRUE
doffbcjheoibbjfcfjf	TRUE
ehikcknmlhllnnfbmlg	TRUE
ehllaagonloeennmkge	TRUE
fbhkjhgfdikjoekjnfk	TRUE
fbikiimfpclpbpngacn	TRUE
flohbigobhhlmhdlihk	TRUE
fmblphehjhhmchchacp	TRUE
gfpifmicgdnemgjbeef	TRUE
gfpmlodoeihpaafendp	TRUE
gpmdakclkgcbmcelham	TRUE
gpmdbmonpmongllhgmh	TRUE
hklbcmgdnjdcnadocef	TRUE
hkljpnngagmogjkjcai	TRUE
ifabkhdpfcenimomhhn	TRUE
ifbldallgboaookgjlk	TRUE
japnmileagooidapmck	TRUE
jbadladphjejfjndokm	TRUE
jlgiaaecohpgcanjjfl	TRUE
jlhpclafkeeedgoijon	TRUE
kekgjnlflbomhfolgio	TRUE
kepcgiphhfnfgobcahj	TRUE
knjmdgfeopdbppflkni	TRUE
knkjdlfbnefnioikmnk	TRUE
lipnamnmeommkjjbadg	TRUE
ljchbmhclgcbnlokaif	TRUE
mdngpphfppoainijbhf	TRUE
mdnkbakadicpjeflgdj	TRUE
mnpmgamcimljchommli	TRUE
mnpndnpiggnckplccip	TRUE
ngpdadoopegnkofkhjn	TRUE
nhachbjgnaknpcoimjd	TRUE
oaeeklipiogoimakkdm	TRUE
oagchobliapmphnlplp	TRUE
oljlaoeomolbelanodg	TRUE
olkcjopgiioibdmmapd	TRUE
pfnbaojhfkjbahbhjnp	TRUE
pfnifobeaokolboiidh	TRUE
aaboiggiobbckgjaaaa	FALSE
aacapfhclpggddgabab	FALSE
akfojjjnjhjlfeababd	FALSE
akfonofibhiflbhabab	FALSE
beeiijjbmkkkkiababg	FALSE
beelhanmjknaaabaaaa	FALSE
bnnlgfjfnnmnnnlaaaa	FALSE
bnnlifmpkoamkgmaaaa	FALSE
chokgdiclcnjoaeabab	FALSE
chpidbkegojbmakaaaa	FALSE
dbfbmcnlohdgmccaaaa	FALSE
dbghjdllnggeblnabab	FALSE
dlphoeppjcggjeoabab	FALSE
dlpnnobhaphgeocaaaa	FALSE
efjfiamlccmoegbaaaa	FALSE
eflagdbapfimffiaaaa	FALSE
epoehlicgmckmfkabab	FALSE
epoiegngckpgmokaaaa	FALSE
fkgkpalpihabjoiaaaa	FALSE
fkiebcjnlffjhmjabab	FALSE
gehbeajpfjpmkpoabab	FALSE
gehjpkeamfejcofabab	FALSE
gnpnmglafjaghkgabab	FALSE
gobjkooinfcjgokabab	FALSE
hjbfbjfllnnomgcaaaa	FALSE
hjbhllneedgmbcoabab	FALSE
idkealmacgeeddeaaaa	FALSE
idngibngjfdlnpnaaaa	FALSE
incemcecelicoldabab	FALSE
incijeamecmmlnhabab	FALSE
jgkdoheoklhegelabab	FALSE
jgkgpihomkkpfmbaaaa	FALSE
kaiggmncaofeikgaaaa	FALSE
kajddmcalkeleklabab	FALSE
klgfhghfnekjkicabab	FALSE
klglnfemhkenmolabab	FALSE
lhhhecbkacpkmajabab	FALSE
lhhpampjbadjpgmabab	FALSE
mbffjgfeoejggkfaaaa	FALSE
mbflkhmkoolhdgoabab	FALSE
mmnkenecigdgnooaaaa	FALSE
mmoejopjnkhhcmlabab	FALSE
ngnilelkhhcgokoabab	FALSE
ngnlplmpaeneadpaaaa	FALSE
obgnlgbpfjcbfjdaaaa	FALSE
obhakidkdcdapmbaaaa	FALSE
olancafoikkgoenaaaa	FALSE
olcclebpfonmnbgabab	FALSE
pgbmdclhlefpnebabab	FALSE
pgcboelljpiopkhabab	FALSE
