aabifpgbcd	TRUE
aadfajliij	TRUE
ajmacbfgaj	TRUE
ajmfgehhnd	TRUE
bflajkbilk	TRUE
bfnfppahje	TRUE
bocnffldeh	TRUE
bodakecilo	TRUE
cihjfnpknj	TRUE
ciihmfhnbp	TRUE
dckhgimdph	TRUE
dckpnejjei	TRUE
dmlmiaoghd	TRUE
dmnknglijg	TRUE
egjnnpldgd	TRUE
egkakpgpmh	TRUE
famadomoik	TRUE
fanbfkaiee	TRUE
flmibbjamm	TRUE
flmmmelkgp	TRUE
ggnppicmem	TRUE
ggofmppgdk	TRUE
hagffncano	TRUE
haiabgffcd	TRUE
hmkeeahagh	TRUE
hmklolagbe	TRUE
ighkbkonfa	TRUE
igiblicdhg	TRUE
jbcdejgmni	TRUE
jbchblpign	TRUE
jlhncclbmk	TRUE
jlhngilkpp	TRUE
kfhaohgfem	TRUE
kfhcboondl	TRUE
kohhjpgdaa	TRUE
kojfebfifb	TRUE
ljghopbklo	TRUE
ljhkmgdiei	TRUE
mdhboffakk	TRUE
mdhpmmogpk	TRUE
mnkjgbffig	TRUE
mnkkemofpe	TRUE
ngkeljmdng	TRUE
ngljhkicdl	TRUE
obcmdlajdm	TRUE
obdebfglll	TRUE
omgjdjknod	TRUE
omgnlpeikp	TRUE
pfoebhcohi	TRUE
pfonigcaig	TRUE
aabifpgbfa	FALSE
aadjliijab	FALSE
ajnggllnab	FALSE
ajnhhmajab	FALSE
beladagkab	FALSE
belendagab	FALSE
bnocfiedab	FALSE
bnohkabbcj	FALSE
cibnkeldab	FALSE
cidpajgnab	FALSE
dcnllhlfab	FALSE
dcnmppahab	FALSE
dmffkpngab	FALSE
dmgncpjmab	FALSE
egihadlaab	FALSE
egihlamgab	FALSE
fbbnehlmab	FALSE
fbdobpboab	FALSE
fkociinbab	FALSE
fkoddhnaab	FALSE
ggbbfonhab	FALSE
ggbdekbmab	FALSE
haccmgkoab	FALSE
hacjmaimab	FALSE
hmckbffbab	FALSE
hmdiekicab	FALSE
ihepbkbjab	FALSE
ihfnlggoab	FALSE
jbgfdjnmab	FALSE
jbglfbdlab	FALSE
jlllpnkdab	FALSE
jllpfkfnab	FALSE
kfgnkfndab	FALSE
kfhdmijfab	FALSE
kojnhcpfab	FALSE
kombfldmab	FALSE
lipickfbab	FALSE
ljaeaopcab	FALSE
mdcfiniaab	FALSE
mddhnkcoab	FALSE
mmoabcimae	FALSE
mnandaphab	FALSE
nhnoodoiab	FALSE
nhoaeeliab	FALSE
obcmgigbab	FALSE
obdcgdpdab	FALSE
omacomjeab	FALSE
omaigiahab	FALSE
phblenblab	FALSE
phblpndjab	FALSE
aabifpgbfcd	TRUE
aadajliijjm	TRUE
ajljgkekche	TRUE
ajlnaibnadi	TRUE
beighihgiag	TRUE
beipeibbfbc	TRUE
boiipbajgni	TRUE
bojmejfedcn	TRUE
chijiemmlhi	TRUE
chkajchfpaf	TRUE
dcbnioeciga	TRUE
dccabahfkcd	TRUE
dllnijnbkbi	TRUE
dlomjmokkki	TRUE
egkhknncbhg	TRUE
egkmgbfgkbl	TRUE
fakliomkdfj	TRUE
falkambdhbg	TRUE
fleikldljdl	TRUE
flemlppacmm	TRUE
gflkhhiamni	TRUE
gflpkgllfmi	TRUE
hadpjkcehfi	TRUE
haelgbojbdl	TRUE
hmajnhkcgge	TRUE
hmbdpfkefca	TRUE
ihdplnlegid	TRUE
ihenejgjflf	TRUE
japgmpkpepj	TRUE
jbalombhjdc	TRUE
jmahkjifnek	TRUE
jmajlofijjd	TRUE
kfghplajgdf	TRUE
kfhamgbjhkm	TRUE
kogkdpchkme	TRUE
kogolhaloja	TRUE
ljpbacaleof	TRUE
lkadlafiifj	TRUE
mddeiomcjna	TRUE
mddpjahmdap	TRUE
mndlojckaji	TRUE
mnebaelddaa	TRUE
niffpkbhnnl	TRUE
nihgenjkmce	TRUE
obgokaeicnc	TRUE
obgomdlkafm	TRUE
olocmoljfgi	TRUE
omadpkcaifd	TRUE
pfolpeglanp	TRUE
pfpbcdfgdel	TRUE
aaaffbclbab	FALSE
aaagmdcanab	FALSE
akeaklbgnab	FALSE
akfanoiicab	FALSE
bekghbiigab	FALSE
bekmaagahab	FALSE
bpdjobidgab	FALSE
bpedplhnlab	FALSE
cklllncmjab	FALSE
cklpjacknab	FALSE
deglheejnab	FALSE
dehbamdfbab	FALSE
dnmlhfjjeab	FALSE
dnnjhdjokab	FALSE
ehkhaakniab	FALSE
ehlhbdccabg	FALSE
fbhikpcpkab	FALSE
fbjbdcgpcab	FALSE
flocgjhkbab	FALSE
flomccgacab	FALSE
gfpkhphngab	FALSE
ggaahcnepab	FALSE
hafnpflpdab	FALSE
hahngmhnfab	FALSE
hlgodgoimab	FALSE
hlgogahicab	FALSE
igbgljigeab	FALSE
igecepgplab	FALSE
jabileeodna	FALSE
jacjgoljkab	FALSE
jkembbjppab	FALSE
jkeooejhhab	FALSE
kfigkkhbpab	FALSE
kfjfibiomab	FALSE
lalfkmddhab	FALSE
lalhdnfihab	FALSE
lklihegbmab	FALSE
lkmdbddimab	FALSE
mejdnanmnab	FALSE
mellnafaoab	FALSE
mojmnbplgab	FALSE
mokpnhnlpab	FALSE
nicaneolpab	FALSE
nicbfpjkjab	FALSE
occaegdiaab	FALSE
occbeomkpab	FALSE
omdapehllab	FALSE
omfliapjoab	FALSE
pgmjcgjlfab	FALSE
pgmocjlodab	FALSE
aaaffbckbmdc	TRUE
aaaganefhcjm	TRUE
akcmmmcaemea	TRUE
akddefmpimih	TRUE
beinpemmjbpp	TRUE
bejgpbcpgncc	TRUE
bpblhhlmhepl	TRUE
bpcbbeakkflo	TRUE
cjgjognonaop	TRUE
cjiejjggkibc	TRUE
ddleoibfejog	TRUE
ddlndmpdklbl	TRUE
dnoidefiopke	TRUE
dnolakelcdeg	TRUE
ehkknkjppdol	TRUE
ehmafkjpaheg	TRUE
fbdaecamnbdn	TRUE
fbdfpcoacjle	TRUE
flbhdbpjfhoe	TRUE
fldcockelcdg	TRUE
ggddklbdggem	TRUE
ggebdeliemfg	TRUE
hafgdkhenmkf	TRUE
hageoeldjega	TRUE
hlmchmhdcbjf	TRUE
hlnkkijbfpcd	TRUE
ifhfcfdfgkdc	TRUE
ifhldghiojbn	TRUE
jaapmnphhbbo	TRUE
jabkjlojepcd	TRUE
jkjncllgmfjj	TRUE
jkkhnfpidhll	TRUE
kfnmegiondkg	TRUE
kfpmhipelimk	TRUE
laiiibhebkmd	TRUE
laijpnlhnlag	TRUE
lkdnbkincomc	TRUE
lkgddjmgodjo	TRUE
megjcmjklmko	TRUE
mehjaeimllkp	TRUE
moalfjegcked	TRUE
moclgonbadeh	TRUE
nioniicndaih	TRUE
nipnhpgpfajn	TRUE
ocinjhmefodi	TRUE
ocjadhpcmbdg	TRUE
omfbhdaidhgi	TRUE
omfdmpnlamdo	TRUE
pgffglcmilpf	TRUE
pghccapmcpmk	TRUE
aaaldndkekab	FALSE
aabbnhbkapjm	FALSE
ajebckogfcab	FALSE
ajelhobbfoab	FALSE
bdmkmbgmllab	FALSE
bdokkckagoab	FALSE
bnnjjmanehab	FALSE
bnnpaabikckj	FALSE
cjnckmhmenab	FALSE
cjnedffajjab	FALSE
ddjkllobfmab	FALSE
ddjpddlfnbab	FALSE
dojojipehnab	FALSE
dolmhaplppab	FALSE
eildgmphmgab	FALSE
eimgmdhjemab	FALSE
fcemdfhcngab	FALSE
fcfiijkbgiab	FALSE
flffhgbffmab	FALSE
flgjfjmcpgab	FALSE
gekicbblfcab	FALSE
gekkkbokbdab	FALSE
gpealfbackab	FALSE
gpfcajjlpnab	FALSE
hkielcigfgab	FALSE
hkjcnpdiclab	FALSE
ifafhccbhkab	FALSE
ifahpdggdfab	FALSE
ioopoacnbnab	FALSE
iopdglocnnab	FALSE
jjfbodnjooab	FALSE
jjfmpfdjldab	FALSE
kcgjpliofgab	FALSE
kcgnbnegbpab	FALSE
kmejkhnidmab	FALSE
kmfffkebhhab	FALSE
lhdjchihmkab	FALSE
lhdohpppaeab	FALSE
mclbdmjmofab	FALSE
mclgclgijpab	FALSE
mlpkpdcfamab	FALSE
mmaadajmebab	FALSE
ngccpdgfniab	FALSE
ngcpiojlebab	FALSE
objffbolaeab	FALSE
obkcebagpaab	FALSE
omlcnnekooab	FALSE
omoimdjcjiab	FALSE
pgbcjhmkehab	FALSE
pgbkbcblhhab	FALSE
aaaldndkekbdn	TRUE
aabbkapjmaacd	TRUE
ajbojidlpiboi	TRUE
ajcjboocpeloi	TRUE
bdjnadhfoepgf	TRUE
bdkhdopjjjlli	TRUE
bnhmebgkflamp	TRUE
bnhogmcehalgh	TRUE
ciiacpocooeei	TRUE
ciidblbiikfnn	TRUE
degelkiedbcff	TRUE
deidebigogjgf	TRUE
donkdllacnbci	TRUE
dooadpgdlnmkd	TRUE
eimjmbpiopaen	TRUE
einfpagpdibch	TRUE
fcbbdfnjafibg	TRUE
fccgghdjhlfld	TRUE
flgccfplcekhe	TRUE
flgmfanobaopc	TRUE
gfimgloccnkjf	TRUE
gfimkompljfgi	TRUE
gpdimmajbhnpm	TRUE
gpdogkpkecflo	TRUE
hkdcbkbmmjedi	TRUE
hkdhlkfonomcb	TRUE
ifafokdocblek	TRUE
ifbhdfilcbmpj	TRUE
ipeiiafhkpkji	TRUE
ipeobgkcmehmp	TRUE
jipbeglmepgfc	TRUE
jjapdkibjabcd	TRUE
kclclfanmpiga	TRUE
kcmcdhnjefkif	TRUE
kncnpfeipihef	TRUE
knehnlcghogjk	TRUE
lhdajcchjdche	TRUE
lhdggbafonnbc	TRUE
mbophdlanfclb	TRUE
mbpfadccjfgip	TRUE
mlhooppndlhgg	TRUE
mlkgleopmekpn	TRUE
ngdahcbkbofoo	TRUE
ngeildlkcedmm	TRUE
obekfmbmbgded	TRUE
obfgjgjgjjckh	TRUE
olpjfajocjmfo	TRUE
olpoifooleihm	TRUE
pgbanlclhiibm	TRUE
pgbknfhpnpmmb	TRUE
aaaldndkekbab	FALSE
aabdhbkapjmaa	FALSE
ajgbigbgmboab	FALSE
ajibjcmglcmab	FALSE
bedglodghcjab	FALSE
beedjbigodhab	FALSE
bnplljbbopnab	FALSE
boabkifgmpllh	FALSE
cjhncjpigjkab	FALSE
cjiiiiobmkjab	FALSE
ddmnbebpgahab	FALSE
debmjjjplleab	FALSE
dojmlpdbafcab	FALSE
doldaapnihbab	FALSE
ejaaefnalehab	FALSE
ejaagjmmlpkab	FALSE
fbnebkfigneab	FALSE
fbojhdmfkhkab	FALSE
fkpobpbcmojab	FALSE
flbdcpoagjabd	FALSE
gegdhckmlbhab	FALSE
gegmbailjcbab	FALSE
gphckhlbenpab	FALSE
gphjoniancnab	FALSE
hkhifehngmiab	FALSE
hkhkckbooalab	FALSE
iefnencacmgab	FALSE
iegnagpodljab	FALSE
iphjjihdidkab	FALSE
ipigddbkmpjab	FALSE
jilabjilaehef	FALSE
jilikjcmfcfab	FALSE
kdcajboioaeab	FALSE
kdclhhhjphaab	FALSE
knbphadhmgeab	FALSE
kncicjjdcgiab	FALSE
lhaokjnbjfmab	FALSE
lhbpiklpbkjab	FALSE
mbohjgldnfdab	FALSE
mboodmbchpbab	FALSE
mlimgpnpapmab	FALSE
mljchonmngbab	FALSE
ngipkomhilnab	FALSE
ngjcgenkdanab	FALSE
obhlklnccgkab	FALSE
obiifeogoohab	FALSE
omilomohggkab	FALSE
omimcipjadnab	FALSE
pglaelnpdfdab	FALSE
pglbiefineoab	FALSE
aaabejafijnecd	TRUE
aaaoeafhkcjbpo	TRUE
ajddncefkikfko	TRUE
ajdjnljjgdodcd	TRUE
becolijmjgpcde	TRUE
bedkeckgboeamk	TRUE
bnmapamjchnidp	TRUE
bnnceenmkmcnpg	TRUE
ciapacomkenecg	TRUE
cibjkgaielgepa	TRUE
dbondifhgankkn	TRUE
dbpggnnobecnbm	TRUE
dmmbncedldfaej	TRUE
dmmiafghempcng	TRUE
eghccggigalfdo	TRUE
eghhifhifdlgof	TRUE
fbbgikoelpbnmo	TRUE
fbbkddchielndf	TRUE
fmcdgidednjfmb	TRUE
fmcgkeffakphbk	TRUE
ghilbpbgfkknhh	TRUE
ghjhgiimfdigbj	TRUE
hcddkcnmealijh	TRUE
hcebkbkamofjjp	TRUE
hmknmgglcmbicd	TRUE
hmllcjjgejdlhp	TRUE
igmiamipjgfonf	TRUE
igmiohnmgkhpag	TRUE
jackaokcnffmii	TRUE
jaepopnhioflnj	TRUE
jkgakjgkempoli	TRUE
jkgooaoeplocff	TRUE
kelbllgcbkhcoc	TRUE
kenggmhngpkfpd	TRUE
kocbobdjfkjlaj	TRUE
kocncanalcckip	TRUE
lhkpeifbhnnkff	TRUE
lhllmjcjioamle	TRUE
mcoodhljgldmpf	TRUE
mdajlcmbckadgf	TRUE
mmjepohlocapag	TRUE
mmjokgmpmdghal	TRUE
nhonjbfgmfddda	TRUE
nhopkgbfdelhjh	TRUE
ocglpdikpkjagc	TRUE
ocheddbphmejol	TRUE
omdbacdankhbid	TRUE
omdpgfgilkdajn	TRUE
pgblchmfcoloon	TRUE
pgddilhfdideii	TRUE
aaabejafijneea	FALSE
aaaofhkckbpoab	FALSE
ajagcbhjphcnab	FALSE
ajbhifpcebhhab	FALSE
bekbjcfeimofab	FALSE
bekhogpkohbmab	FALSE
bnpfaklijigjab	FALSE
boacabmjnkmghd	FALSE
chjillmjlociab	FALSE
chkfidpbfpeoab	FALSE
dbfmniannmbkab	FALSE
dbgpihdlmbcnab	FALSE
dmcaipfjjbapab	FALSE
dmcgepdpilpfab	FALSE
eggiegmibfmjab	FALSE
eghodomhfdciab	FALSE
fbkggalfdoifab	FALSE
fbkihifdlgofab	FALSE
flpcedimoeibab	FALSE
flpejfjlmhcfab	FALSE
ghnkdakpnngpab	FALSE
giacnnloenjpab	FALSE
hclofebofpcfab	FALSE
hcmcoljgblebab	FALSE
hmpkceomfcbaab	FALSE
hmpkmbfmggahab	FALSE
igjepinakddiab	FALSE
igjkacgomnhmab	FALSE
jaenmcllnkgaab	FALSE
jagobmklbnbhab	FALSE
jjngkhpafefeab	FALSE
jjnmhoglgbjfab	FALSE
kepkkimdomlaab	FALSE
kfagninfillhab	FALSE
kohfjfeckfepab	FALSE
kohkgbpbfogjab	FALSE
lhfmdchpolblab	FALSE
lhfpfbecchniab	FALSE
mchgimpnmkgabn	FALSE
mchmaiklogjbab	FALSE
mlobmcenijoaab	FALSE
mlocodbnjmppab	FALSE
nhengdmnifgnab	FALSE
nheokjkobcilab	FALSE
ocejfhedfdhiab	FALSE
ocfeeieajbjmab	FALSE
omlkflkianpdab	FALSE
omlonamhebpmab	FALSE
pfnnnnajbgdpab	FALSE
pfnockpcikcbab	FALSE
aaaflgjdbnoffmn	TRUE
aaambcehokohbni	TRUE
akiaopgibckljff	TRUE
akkafhgbaffjloh	TRUE
beljjagebaedcck	TRUE
bellomdgncfpomp	TRUE
caefjfgagphbpcn	TRUE
cafihooefpmcfmm	TRUE
ckomcmheeibcmoc	TRUE
ckpebeihbkfkmeb	TRUE
dglkbmpnhjifdgb	TRUE
dgnfhdldhjehfaa	TRUE
ebgdbbchfahjehi	TRUE
ebhnpdcfeamfidf	TRUE
ekgnfjjbloiahaf	TRUE
ekhjfaociffeehj	TRUE
fdpdibnlknmndak	TRUE
feailhkljlgameh	TRUE
focclifbaigpfhp	TRUE
foceaimpmcidbck	TRUE
gjeonlhipijajlp	TRUE
gjfadilhmhnphdp	TRUE
hdkgdfkhnooilbm	TRUE
hdlagnneabpebcd	TRUE
hocijhadngcbhnm	TRUE
hodhmlbicbmfaaj	TRUE
ihpcplhcmmnicca	TRUE
ihppgbdpfepiach	TRUE
jcegmdjnkpdeajk	TRUE
jcgolfnkpheiiek	TRUE
jlodjfjlmkllpfb	TRUE
jlpdobfhililonc	TRUE
kfilnokemfedddm	TRUE
kflbpmfgedabacd	TRUE
kpijjjgbbnbmmgk	TRUE
kpjchhemaiomcgm	TRUE
lkamconlfceogbj	TRUE
lkchocfobhpflmo	TRUE
megaflgelednddi	TRUE
mehpedgieoljbnh	TRUE
molojjkliihpjdm	TRUE
momelndnooblala	TRUE
nioiafmifimldai	TRUE
nipbnjldobngeaa	TRUE
ocgcllhfcphndda	TRUE
ocglhnkkbgbiiib	TRUE
omfbmkdebkhjbnd	TRUE
omfdfdpjocddbel	TRUE
peogbcmimkeliip	TRUE
pepbecfbnkfmahn	TRUE
aaaakjfhgjgplab	FALSE
aaajbimomdahaab	FALSE
aipjilhhcpedfab	FALSE
ajaoaaiegdgjhab	FALSE
bdaoaahaakajdab	FALSE
bdbajincpononab	FALSE
bngolnhjjiclaab	FALSE
bnhfhbpjcffkfab	FALSE
chlcmogbhjgfcab	FALSE
chlecpgikbjfnab	FALSE
dclgijhnpcedgab	FALSE
dclhmocllcpooab	FALSE
dmnbajdieahcoab	FALSE
dmnlllcokcpepab	FALSE
efphmkfagakciab	FALSE
egaabokeplfdnlg	FALSE
fakcajnjahbmaab	FALSE
falliaplmghljab	FALSE
flbadilonikgjab	FALSE
flcbmebgbkabndo	FALSE
gekfccgpcelapab	FALSE
gelganohadkhabe	FALSE
gonfkpkmldfmfab	FALSE
gpappcocagdjhab	FALSE
hjkipelokfmfcab	FALSE
hjlackcedoejlab	FALSE
idciebgapadnjab	FALSE
idddgdmcmkjlbab	FALSE
ingfdbldijfneab	FALSE
inladeodkdkkbab	FALSE
jgpkgemdejhdaab	FALSE
jhapllhmejiklab	FALSE
kbhnedkibnabndo	FALSE
kbicpcifkccflab	FALSE
knaddmbmmhmicab	FALSE
knaillonjcjgkab	FALSE
lgmfgglkclpdiab	FALSE
lgngofdaepjejab	FALSE
mbjbdddihimkgab	FALSE
mbkmdmjlfkglmab	FALSE
mmcjnmimhebcpab	FALSE
mmcoaphljkbfkab	FALSE
nfobmoopblikiab	FALSE
ngbiabeddhkpebb	FALSE
oadfibifnnnhbab	FALSE
oaemahdehbfilab	FALSE
olfmlejenakanab	FALSE
olgbmjadbomboab	FALSE
pfkaoojkabmnjfi	FALSE
pfkkmfpjcbbbbab	FALSE
aaaakjfhgjgplbim	TRUE
aaajomdahaefccnk	TRUE
aipleliiepnhgllm	TRUE
ajbfglhpncbdocnm	TRUE
bcfdfkhofmklclki	TRUE
bcggpjpihfpacmlk	TRUE
bngpgppjccmllbbc	TRUE
bnihobmnadedbhjc	TRUE
ciijiiooigomiflm	TRUE
ciimamfohipkidfd	TRUE
dchppddacnflckch	TRUE
dciffgcnpcfnhmlm	TRUE
dnchnjhnpnhchpbk	TRUE
dndancncmpalkenf	TRUE
egniaccbgmphdcgk	TRUE
egobjpognpcocccl	TRUE
faekekkedolgodmn	TRUE
fagjppiaedhmmpbj	TRUE
fledggobgoidlhfl	TRUE
flejnggfjnighbnc	TRUE
gfeipmepniagcllf	TRUE
gfelphgcflldklpl	TRUE
gpecjhgaaanchadb	TRUE
gpeedpopmickkbbf	TRUE
hjkfalpakgdblchk	TRUE
hjkjndifeclmfddf	TRUE
icngiegjhlomnnlh	TRUE
icogpojjccilcipp	TRUE
iocbedcfhphfikoh	TRUE
iochajdggcljfbgh	TRUE
jiabhjgjdkkkdpcd	TRUE
jiajbjlgijmalnch	TRUE
kbfgliikmkfllibd	TRUE
kbioehhpkheifiee	TRUE
klhgoofhgchcjfnh	TRUE
klidoboaccdhjfme	TRUE
lgbakhgeeifeocie	TRUE
lgbhmhcpcngndcbh	TRUE
mblpaphiabjaomcd	TRUE
mblpojablekbkjcd	TRUE
mmbihdbjkakajelk	TRUE
mmbjfclhjagjdlci	TRUE
ngbjjhabofhgfcdg	TRUE
ngdedkmegicaecee	TRUE
oagldfihdoljknhd	TRUE
oagmabkflmcpnhcd	TRUE
olecflknibdfdpdd	TRUE
olekffaaeehlfdfh	TRUE
pfnafbbchaiefmog	TRUE
pfnaommmgjbgnmfp	TRUE
aaampanabcmgmbac	FALSE
aabmcbomfijpffol	FALSE
alceglkglajednab	FALSE
aldepmlhbdkgglab	FALSE
beceldbphlpaoeab	FALSE
becigkofnbjgekab	FALSE
cacgjjodoakiogab	FALSE
cacigjhhmkaplhab	FALSE
ckdbdldkkmajfbab	FALSE
ckfplbhldnjmkfab	FALSE
ddidlacealdfkhab	FALSE
ddkchidfieihigab	FALSE
dnkomibkkcaiamab	FALSE
dnlnfbpealheleab	FALSE
eigecokpbdogpdab	FALSE
eihcagnembenbbab	FALSE
fbamdolkfppjboab	FALSE
fbaolacoopljjaab	FALSE
flpeipkihihpciab	FALSE
flpnbkcihbiafjab	FALSE
gemkkgpnppgggcab	FALSE
geojcihedmndcpab	FALSE
gnpjpemhmgbhpmab	FALSE
gnpocfnehghpnbab	FALSE
hhohbiedlkogddab	FALSE
hhoiaeephhjhlnab	FALSE
icimglleindgohab	FALSE
ickamlbimjmmgoab	FALSE
ilphgfgmcnniflab	FALSE
imagmecgolmjkaab	FALSE
jhflclcfnlldllab	FALSE
jhhapldnjifegkab	FALSE
kbaiijifpibdfjab	FALSE
kbajlfocbanjhkab	FALSE
kmfepoklegoidjab	FALSE
kmffdjnlncghkeab	FALSE
lgnlmemhkfpbigab	FALSE
lgnncchkgmbnmbab	FALSE
manebnikkhpngfab	FALSE
maoocfjajdblndab	FALSE
mkihfagkahddndab	FALSE
mkjjcaoiohadpjab	FALSE
nfcfombfeihgidab	FALSE
nfcolhkdplgodlab	FALSE
npjkgboflkecfpab	FALSE
npkfimbhpeoefnab	FALSE
okhmhokaeojcelab	FALSE
okiegnkmoalbbdab	FALSE
pgcpnlnipoocmgab	FALSE
pgdmokpnnfkglmab	FALSE
aaaclkphpkmfnojhc	TRUE
aabbhbgjjjdnkiccd	TRUE
aknfgdcaakmckjeli	TRUE
aknfhcdkmpoodichb	TRUE
bfoanjglaepiahili	TRUE
bfpiaebibhicegmpi	TRUE
bokmaebhmgjakopic	TRUE
bolnbhhafkbfoleep	TRUE
ciopdogcpbfacemla	TRUE
cipageadfkgiidhne	TRUE
ddndalilhcipbhkgk	TRUE
ddpbbjjjplijbickh	TRUE
dngcfbifpnkneajof	TRUE
dnhamefjklegeebik	TRUE
ehialifioajggnbhc	TRUE
ehimimmgcplfnnfdn	TRUE
fbcacnjpoagaldgff	TRUE
fbcohjhbpmhifgfha	TRUE
fmbcicllcklocgmgf	TRUE
fmbgfmfndaimajjfh	TRUE
ggchcpomocjbbinic	TRUE
ggdkhifhoneghjgbb	TRUE
gpcahhilpkhfefkkn	TRUE
gpciffkmlhkpilipn	TRUE
hkfaeheenkffgmchd	TRUE
hkfglfmedcmgjjglo	TRUE
iegcnicgmjhchkogg	TRUE
ieggpgkohnkgocefc	TRUE
inhmpfniaichaeici	TRUE
injbdacbnfpgohhdk	TRUE
jimffcbcfjgghnmcp	TRUE
jimpijhaonaencjhm	TRUE
kdeppmjgcikcodoph	TRUE
kdgbhkioomkfknind	TRUE
kmhegjohomplcgihg	TRUE
kmiapibnlnplknhgm	TRUE
lgglgfkgpjmhgdjej	TRUE
lghgoijailcnlhdba	TRUE
mbmnbiajibjhnmikg	TRUE
mbnjbgjbgmdeabbcd	TRUE
mlnbmcdfmgbciedph	TRUE
mlnfimjfalijiodad	TRUE
ngfabpgeijgaflpcd	TRUE
ngfaodepnnfiiobch	TRUE
obdlbjmgkccgnhipi	TRUE
obedpendlghhdgfpp	TRUE
olgipgmbhdkeclife	TRUE
olhdbbeifjcjdlonm	TRUE
pflacgcefphopineb	TRUE
pfljaoddpfmjdofgb	TRUE
aaacmkphpkmfnojab	FALSE
aabchbhbgjjjdnkic	FALSE
akihikmfmkehddbab	FALSE
akioikkddbdhdagab	FALSE
bejpmcgigglahioab	FALSE
bekdockhglijhoiab	FALSE
bobloccopgbjeeeab	FALSE
bocfgiapmkmfldnab	FALSE
cjlenofcpbfnoblab	FALSE
cjmeogbpmfommobab	FALSE
ddkdanplalmhhjdab	FALSE
ddlfofbloeiiccmab	FALSE
dnjajokgejiaeimab	FALSE
dnkdhijclmcfkcnab	FALSE
ehagecohaeindfdab	FALSE
ehamadcekmopijhab	FALSE
fapceigjjbkckpaab	FALSE
fapknnmlhmighkoab	FALSE
fljeganmnpckhdnab	FALSE
fljffijgfeggldlab	FALSE
gfidegnfodpiknnab	FALSE
gfifolkccaljmbmab	FALSE
gpcjcgdpemphmejab	FALSE
gpclecikllmhmbgab	FALSE
hkfflifjeinafllab	FALSE
hkficllhfmpafgkab	FALSE
iefgckabkamljddof	FALSE
ieflhghlmcpamieab	FALSE
inepohgajbinnjoab	FALSE
ingfeclkiipcobpab	FALSE
jiampdoiiicanmpab	FALSE
jibkmglbjfiepbmab	FALSE
kchajgnndmlbcpjab	FALSE
kchbdkpmkpbickdab	FALSE
kmmekfcfamolmfmab	FALSE
kmmjdnkefcgchpabl	FALSE
lhfmacmhlekjngdab	FALSE
lhgpajbjjbpiefmab	FALSE
mbmcjjlloiionbcab	FALSE
mbmeiloclgcebdiab	FALSE
mlgmgodebaajllpab	FALSE
mlheplklhgodohgab	FALSE
ngpefbibjdjfhaoab	FALSE
nhbbagmppdjiallab	FALSE
obddebiplcihebabf	FALSE
obdedogkclenjboab	FALSE
olaimomciebiakdab	FALSE
olbamlehnehlmdhab	FALSE
pffaohdpekbcebiab	FALSE
pfgcafophioiofdab	FALSE
aaabkcbnlcpmjbcgcd	TRUE
aabmnhepcelnbijacd	TRUE
ajpkelogiimngcimod	TRUE
akaaloecapfimblgkk	TRUE
bcpddnjlekbhkibpke	TRUE
bdaagcfcbgmoecfdck	TRUE
bnmdpdobiocgnpddcj	TRUE
bnmloebjjapfmdjhip	TRUE
ciakmmlnnjkodkcicg	TRUE
cibipncimdkddcjpkd	TRUE
dboofihjehihodjeik	TRUE
dcdlmkinakooflkdhd	TRUE
dmijcikkffeobilpja	TRUE
dmkmngdojniiejdkoc	TRUE
ehdbpijbanoaojdaik	TRUE
ehehciphfjfgndcbfi	TRUE
fcghenmhflkijknpeo	TRUE
fcgpfmongceajcjidb	TRUE
fnipkpcaffclloinhl	TRUE
fnjjckjfgdbfckoalp	TRUE
ggpcmifglimhcapkki	TRUE
ggpgkdolcacjdhgdom	TRUE
hamkgeobjaohmmnoai	TRUE
hampjobbheleejgcmc	TRUE
hljbfgejgfaohghdof	TRUE
hlkccfaenmemchjhjb	TRUE
igencaccelficpimmh	TRUE
igepoffblcllakcmpf	TRUE
iplbgolannlbjeaghi	TRUE
ipmjkbokdhdhgnagaj	TRUE
jjbbbpmpjgioafmdeb	TRUE
jjbnpfokocibcgbhep	TRUE
kcgnnaiiafdpplodhe	TRUE
kchcckmfoalhpdbchl	TRUE
knfipamoenbmoipefc	TRUE
knihibkpbmeeonfgja	TRUE
lhnlbcnjfpklcppkml	TRUE
lhnpdmfonjhocacjka	TRUE
mbnkdjipcmampnlide	TRUE
mbojknckjbeagbppip	TRUE
mngnnpolkmalnpgnpm	TRUE
mngpolgghjdelndcek	TRUE
niejplpjibogmoabcd	TRUE
nifkjjceahnaccicai	TRUE
ocbpmiabngjkikckcd	TRUE
occdmhgbeflbjdlgdk	TRUE
ondfpdjoknhfhhnggn	TRUE
oneiljljfolmogilcg	TRUE
pggfbjnhckmgplolii	TRUE
pggglbegkmgmgbgomp	TRUE
aaakjdkafifdeahkab	FALSE
aaaohhgbnkcgfjnhab	FALSE
akfghjeicmahepccab	FALSE
akfmkcifopfkklnbab	FALSE
beoloangekdjeehjab	FALSE
bepacfdfdfhihjapab	FALSE
bphlmopedjogmaaaab	FALSE
bphmkbemedomgnbfab	FALSE
cklcmlpodfjhfhdcab	FALSE
cklklnnackjhecpiab	FALSE
dflgcgifojdgooifab	FALSE
dfmademogfphinmjab	FALSE
dpmcflmgdhaplnodab	FALSE
dppcpoafnekgdnefab	FALSE
ekiioicbebklgibpab	FALSE
ekjnilnphjodefngab	FALSE
feiaieecpbkopcacab	FALSE
feiddkidioeljfbkab	FALSE
fokmaodjjkngiiocab	FALSE
fomlbcfknjkgjbckab	FALSE
gihoenejdggjnmkaab	FALSE
giibdpeeikikdnpmab	FALSE
hbojccgbohagdmlaab	FALSE
hbpappkhaakjabdlcm	FALSE
hmdbmombpdjlcklgab	FALSE
hmeokejhhhiienieab	FALSE
ihahhohmfjobhodmab	FALSE
ihbmnodohlcepaplab	FALSE
jbbdkiiioikinjodab	FALSE
jbbklabdpjfdlanble	FALSE
jlmmgnijhbbodafiab	FALSE
jlnfnafgaibgaojabm	FALSE
kfhdmkibjbmanldgab	FALSE
kfhpdcgmphjpmbnjab	FALSE
kpmgppecpkacldpdab	FALSE
kpncghckohehagedab	FALSE
lkdnnooplboplpppab	FALSE
lkdpdpmjjhgponpkab	FALSE
melfbhhjbbaabaeojg	FALSE
menkpiffpnfbbimlab	FALSE
moembhcfnifjmgkgab	FALSE
mogfgkjfeipmmehpab	FALSE
nhkfdbdjealmlnmkab	FALSE
nhlaagomfmjolhjlab	FALSE
ocohdockpnbbnkahab	FALSE
ocoigfhclenpeieeab	FALSE
onhdhnedmnpmcnbbab	FALSE
onhkpjakoblcepccab	FALSE
pgojjhoedjohjaajab	FALSE
pgompjlplienhdafab	FALSE
aaakjdkafifdeahkhhg	TRUE
aaaobnkcffjnhoandel	TRUE
akgokgmkkdbhiokenhh	TRUE
akhephfemlgcamjhcfl	TRUE
belklbpcbdcddnlkcpk	TRUE
belogaheepbfihodiii	TRUE
bpjnbfkfbehikmfnhbb	TRUE
bpknbbnamfhllkeddmm	TRUE
ckdndcjefimcfinnedj	TRUE
ckgnpaeellbbiglimca	TRUE
dfjeeehapfgifgdcljb	TRUE
dfmhfcfokjiabcpeicd	TRUE
dploepfnhicgdiaepob	TRUE
dpofhgcmheboicbebkl	TRUE
ekjoclpjdkmcdibclkd	TRUE
eklmibpekfincbgdlek	TRUE
feijjenfmplgdonljmh	TRUE
feiokckkhmigdldpoci	TRUE
fokeanmdbojnhfkbepc	TRUE
fokpafjihfdbgaihhcg	TRUE
ghkmkklakcmpjaaeedg	TRUE
ghlfepeolmmdjddedjl	TRUE
hckhkjhbndbiebbdhgg	TRUE
hckkpcknaofadpdajno	TRUE
hmiilpepipkmflddmal	TRUE
hmjanfbpnefbmjmodah	TRUE
ihhjnbngibkmklamopi	TRUE
ihjggljbikimgmgljii	TRUE
jbfhlmapimpjlmiofdb	TRUE
jbflkjojkocmoodjlnc	TRUE
jllijkdmkndmdaajbjo	TRUE
jlloiacfllmfccllpbc	TRUE
kfhecicgcnfjaagmpoa	TRUE
kfikjlchkjahhdjigkc	TRUE
kphiabpdgbigdfeapcd	TRUE
kpibljgdkajmleniojd	TRUE
lkflglnagpipofnillf	TRUE
lkhjcodalmheaiahjnf	TRUE
meopkpgbajccffmhdag	TRUE
meppdikcfnaajpopadc	TRUE
moilaklgklkicffekdn	TRUE
mojaopaaikjbdnilaob	TRUE
nigpilnlklhikkdloib	TRUE
nihfpmckodfkdmofbki	TRUE
ochegeodbhlgklfmcdk	TRUE
ocjogdlhepefkmeamdo	TRUE
onbgbdbffjajaepkpnn	TRUE
onbohpmomjcjbjfcefh	TRUE
pfnkkcldmchemjdoggj	TRUE
pfofeblifdgfndloiem	TRUE
aaacjnpcfgcbjkpicab	FALSE
aabhailfppliecjalmb	FALSE
ajjfehfmidbenmjddab	FALSE
ajjolcpdmbfiaedooab	FALSE
bdikdgpfaijhniklbab	FALSE
bdkkhifhfdefecpgkab	FALSE
bopbheedfigkgkmhkab	FALSE
bopgobhipljfacpahab	FALSE
cjbmnaddbgphmeocfab	FALSE
cjcecnlhccmpnpdinab	FALSE
dchgjiicighfbpobhab	FALSE
dchlahcpljmegdobiab	FALSE
dmmjdbjjpbeiilejoab	FALSE
dmmmppfhbangamdmeab	FALSE
eiecnfljipbncbonabc	FALSE
eiepdcloennnajkgfab	FALSE
fclhbpgkophlgmphcab	FALSE
fclhhdilmamffbhpmab	FALSE
fmlkenchbfbmgjkeoab	FALSE
fmmedhjcnobmiignkab	FALSE
ggiekfdjfofhekogbab	FALSE
ggjdccggecejjghhgab	FALSE
hamgjddnemkbcghlhab	FALSE
handjjhgmicegbcnpab	FALSE
hmbbgnhldpoljlehdab	FALSE
hmcigbppfedfnlhfgab	FALSE
igbmdmmnnopobjhkaab	FALSE
igcepgojjelkeceaiab	FALSE
ipkbgpemigpninpdlab	FALSE
ipkhidcekockomnacab	FALSE
jkfjikmkkjidebihpab	FALSE
jkfkbnfichieccknfab	FALSE
kfbfijdphdfknchffab	FALSE
kfbgggcgfkejjocpgab	FALSE
kohldohccfmdlfdjnab	FALSE
koidipjanioaaoekcab	FALSE
lhglnancjpdeggpciab	FALSE
lhiihmjpeijnnfejlab	FALSE
mbgkbmjaaclpmhkdjab	FALSE
mbikklechcfmhpjgfab	FALSE
mmnbdhoaaamddhhanab	FALSE
mmnjkgicgoocanliaab	FALSE
nhffjlccnaooiobdaab	FALSE
nhfgdbpenanjehajnab	FALSE
obhnbomaohkljnbolab	FALSE
obiimmdoepdeplnhfab	FALSE
olejfpalfclcfopgdab	FALSE
olfdfnapgchjbpefkab	FALSE
pfohhljmjochillcgab	FALSE
pfolgiigmelpggeljab	FALSE
