ababababab	TRUE
ababababab	TRUE
ababababab	TRUE
ababababab	TRUE
ababababab	TRUE
ababababab	TRUE
ababababab	TRUE
ababababab	TRUE
ababababab	TRUE
ababababab	TRUE
ababababab	TRUE
ababababab	TRUE
ababababab	TRUE
ababababab	TRUE
ababababab	TRUE
ababababab	TRUE
ababababab	TRUE
ababababab	TRUE
ababababab	TRUE
ababababab	TRUE
ababababab	TRUE
ababababab	TRUE
ababababab	TRUE
ababababab	TRUE
ababababab	TRUE
ababababab	TRUE
ababababab	TRUE
ababababab	TRUE
ababababab	TRUE
ababababab	TRUE
ababababab	TRUE
ababababab	TRUE
ababababab	TRUE
ababababab	TRUE
ababababab	TRUE
ababababab	TRUE
ababababab	TRUE
ababababab	TRUE
ababababab	TRUE
ababababab	TRUE
ababababab	TRUE
ababababab	TRUE
ababababab	TRUE
ababababab	TRUE
ababababab	TRUE
ababababab	TRUE
ababababab	TRUE
ababababab	TRUE
ababababab	TRUE
ababababab	TRUE
aaakikbceh	FALSE
aabneijjpi	FALSE
akoeokeafc	FALSE
alafjmkcoc	FALSE
bfeibmegni	FALSE
bfenadggoc	FALSE
bomjmpambn	FALSE
booekbbmjj	FALSE
ciiapopcha	FALSE
ciiepfhcdb	FALSE
dcnbkffjne	FALSE
dcnifneohb	FALSE
dmkcehhkpj	FALSE
dmlnpjnggh	FALSE
eienienefc	FALSE
eifffmmpbm	FALSE
fcoeefhjom	FALSE
fdgmbbdjci	FALSE
foaeofhgnh	FALSE
foajandahc	FALSE
gialnfopnc	FALSE
giamncgkcf	FALSE
hbkhjbmcnd	FALSE
hbkkiggafp	FALSE
hnahdmglea	FALSE
hnakgfhmdf	FALSE
iiemklofcb	FALSE
iiffhfneld	FALSE
jbkcmnplhk	FALSE
jbkjcallnb	FALSE
jljfkenhmm	FALSE
jloedcnhfd	FALSE
kgimaceinm	FALSE
kgjioegbfc	FALSE
laheekelbg	FALSE
lahfhiondh	FALSE
llgegjmnfn	FALSE
llhcpikfek	FALSE
meonkidpco	FALSE
mfaopkineb	FALSE
mpmmaemgna	FALSE
mpmpebeagp	FALSE
njkniejpfh	FALSE
njlcnaffop	FALSE
odbiodgoeo	FALSE
odbpdbenei	FALSE
ompckenejm	FALSE
ompephnppa	FALSE
pggmpdkjeg	FALSE
pgihgbmnfd	FALSE
aababababab	TRUE
aababababab	TRUE
abgabababab	TRUE
abgabababab	TRUE
bababababab	TRUE
bababababab	TRUE
bababababab	TRUE
bababababab	TRUE
cababababab	TRUE
cababababab	TRUE
dababababab	TRUE
dababababab	TRUE
dababababab	TRUE
dababababab	TRUE
eababababab	TRUE
eababababab	TRUE
fababababab	TRUE
fababababab	TRUE
fababababab	TRUE
fababababab	TRUE
gababababab	TRUE
gababababab	TRUE
hababababab	TRUE
hababababab	TRUE
hababababab	TRUE
hababababab	TRUE
iababababab	TRUE
iababababab	TRUE
jababababab	TRUE
jababababab	TRUE
jababababab	TRUE
jababababab	TRUE
kababababab	TRUE
kababababab	TRUE
lababababab	TRUE
lababababab	TRUE
lababababab	TRUE
lababababab	TRUE
mababababab	TRUE
mababababab	TRUE
mababababab	TRUE
mababababab	TRUE
nababababab	TRUE
nababababab	TRUE
oababababab	TRUE
oababababab	TRUE
oababababab	TRUE
oababababab	TRUE
pababababab	TRUE
pababababab	TRUE
aaakikbcehn	FALSE
aabeijjpiih	FALSE
akobfpmcmin	FALSE
alcjiipnkfn	FALSE
bfjllmojaek	FALSE
bfkefjklnlc	FALSE
bopmgaohclk	FALSE
bpadlpppkhc	FALSE
ciddgmbehcp	FALSE
cifdccbnblm	FALSE
ddaicpnlaid	FALSE
ddbdigkmppf	FALSE
dmpmcbpeeon	FALSE
dnbcfoecdpp	FALSE
ehmhifcdcol	FALSE
ehmigfifcdh	FALSE
fdfaknjojeo	FALSE
fdfcfhgnhan	FALSE
fojlahmobkl	FALSE
folkoebocpd	FALSE
gihnnkmlihe	FALSE
giiclopflmg	FALSE
hboldgmcaio	FALSE
hcaikblmock	FALSE
hndojaokcdb	FALSE
hnghpfkmoao	FALSE
ihljicjdelp	FALSE
ihlkdkgacpj	FALSE
jbhcooanfel	FALSE
jbiblknlgio	FALSE
jmgpcknjlcd	FALSE
jmhdmpbgknf	FALSE
khafibolill	FALSE
khbbhjpaonh	FALSE
lainiikielj	FALSE
laknnhdhaek	FALSE
llclajmoiel	FALSE
lldjdhimoje	FALSE
mfikjgiebfj	FALSE
mfkdoopkihp	FALSE
mphcnmeakfp	FALSE
mphjahjeegn	FALSE
njcmcgehama	FALSE
njegjkniafm	FALSE
odcccffbnim	FALSE
odcdllnhkdh	FALSE
ommmnemmekk	FALSE
omnfdfgopei	FALSE
pglnabklahd	FALSE
pgmfjnjnodm	FALSE
aaababababab	TRUE
aaababababab	TRUE
ajababababab	TRUE
ajababababab	TRUE
bcababababab	TRUE
bcababababab	TRUE
boababababab	TRUE
boababababab	TRUE
ciababababab	TRUE
ciababababab	TRUE
dcababababab	TRUE
dcababababab	TRUE
dmababababab	TRUE
dmababababab	TRUE
ehababababab	TRUE
ehababababab	TRUE
fbababababab	TRUE
fbababababab	TRUE
flababababab	TRUE
flababababab	TRUE
ggababababab	TRUE
ggababababab	TRUE
hbababababab	TRUE
hbababababab	TRUE
hmababababab	TRUE
hmababababab	TRUE
igababababab	TRUE
igababababab	TRUE
jabgabababab	TRUE
jabhabababab	TRUE
jkababababab	TRUE
jkababababab	TRUE
keababababab	TRUE
keababababab	TRUE
kpababababab	TRUE
kpababababab	TRUE
liababababab	TRUE
liababababab	TRUE
mdababababab	TRUE
mdababababab	TRUE
mmababababab	TRUE
mmababababab	TRUE
ngababababab	TRUE
ngababababab	TRUE
ocababababab	TRUE
ocababababab	TRUE
olababababab	TRUE
omababababab	TRUE
pfababababab	TRUE
pfababababab	TRUE
aaaepbkmehbe	FALSE
aabblhhagknc	FALSE
ajicenchmnel	FALSE
ajjcljocjkdi	FALSE
bcphanlhmngb	FALSE
bcppahndafkd	FALSE
bnofmknehpic	FALSE
bnpgeoghjkck	FALSE
cibjbgllhbmj	FALSE
ciciheffkbkf	FALSE
dcjpajehhkbl	FALSE
dckdndcefckk	FALSE
dmfdikjhlicg	FALSE
dmgaaljnhdmj	FALSE
egjelgnchlip	FALSE
egkcggpackjg	FALSE
fbgcgbolodne	FALSE
fbilccmddhfi	FALSE
flpglekeljoh	FALSE
flpjldgdmfgi	FALSE
gfmjomkibmgl	FALSE
gfpapjfcodij	FALSE
hbdjgegpccdn	FALSE
hbdncgilglod	FALSE
hmdghpehfgfj	FALSE
hmefjlocifek	FALSE
ifhjllmimbkj	FALSE
ifhnagjndbdn	FALSE
jaglkopdcnmk	FALSE
jahjldeihepe	FALSE
jjnjnfdfkadb	FALSE
jjohpimbnlll	FALSE
kecnpfkbocae	FALSE
keedgjhgeile	FALSE
knpppjledbjh	FALSE
koibhokoojgg	FALSE
lihkgehpobnj	FALSE
liinfmceaaoj	FALSE
mckokjcbclaf	FALSE
mcldaminbkhl	FALSE
mmeacknepfej	FALSE
mmefnpijhmnh	FALSE
nheobkdmclki	FALSE
nhfaobdjonlj	FALSE
ocbngchfnllk	FALSE
ocboehfaagnb	FALSE
olnbimdenijm	FALSE
olnphkjhikbk	FALSE
pfmgcajkmaln	FALSE
pfnfpejaomof	FALSE
aaaababababab	TRUE
aabbkabababab	TRUE
ajjababababab	TRUE
ajkababababab	TRUE
bdmababababab	TRUE
bdmababababab	TRUE
bodababababab	TRUE
bodababababab	TRUE
cifababababab	TRUE
cigababababab	TRUE
dcgababababab	TRUE
dchababababab	TRUE
dmjababababab	TRUE
dmkababababab	TRUE
ehcababababab	TRUE
ehcababababab	TRUE
fbabgabababab	TRUE
fbbababababab	TRUE
flgababababab	TRUE
flgababababab	TRUE
gggababababab	TRUE
gghababababab	TRUE
hbfababababab	TRUE
hbfababababab	TRUE
hmeababababab	TRUE
hmeababababab	TRUE
ighababababab	TRUE
igiababababab	TRUE
jafababababab	TRUE
jagababababab	TRUE
jkmababababab	TRUE
jkmababababab	TRUE
keiababababab	TRUE
keiababababab	TRUE
kokababababab	TRUE
kokababababab	TRUE
limababababab	TRUE
linababababab	TRUE
mcaababababab	TRUE
mccababababab	TRUE
mlpababababab	TRUE
mmaababababab	TRUE
ngfababababab	TRUE
ngfababababab	TRUE
obfababababab	TRUE
obgababababab	TRUE
olablabababab	TRUE
olbababababab	TRUE
pgbababababab	TRUE
pgbababababab	TRUE
aaaajhekhfehn	FALSE
aadnldadjkoom	FALSE
ajdahlljacfpp	FALSE
ajdckbnaiibho	FALSE
bdkmnaljobjjj	FALSE
bdlcioknobbpj	FALSE
bobppomijigbf	FALSE
bodeeoahlkkef	FALSE
cieliigdmccna	FALSE
cifbfjnjajdha	FALSE
dcehbjnlhkeoc	FALSE
dcfaalhkkbfjp	FALSE
dlncoadkelefn	FALSE
dlnjmjlembkem	FALSE
efjmcjmkdfhhn	FALSE
efklkgglmdoea	FALSE
fafkjffjobnke	FALSE
fafpaemdjehmk	FALSE
fkleobgdgocmd	FALSE
fkmmgmibcpjok	FALSE
gfgkccpjfnkgf	FALSE
gfgopnoofokdp	FALSE
hbafhaiclgeka	FALSE
hbahhjokdiebe	FALSE
hmelcjdjjnpie	FALSE
hmfbmfccgloem	FALSE
ihefompgihcop	FALSE
ihegkodjhhdpf	FALSE
jbiffomelcifn	FALSE
jbipdipbfjmke	FALSE
jkgnboaddflfk	FALSE
jkgnclpajpgjk	FALSE
kfppmcchdkifd	FALSE
kgalckkgdgnbc	FALSE
laankednadofe	FALSE
labebdgfmeahd	FALSE
lkdaolapnmobh	FALSE
lkdfdbolkcmkd	FALSE
meifhjcmddncc	FALSE
meimdacdemgoe	FALSE
mofbmmjcoblba	FALSE
mogggpkdlbaol	FALSE
nicbaglpolinf	FALSE
nicegpjcmmpip	FALSE
ocbafohllkodd	FALSE
ocdfhafokmipk	FALSE
omegegbjcaeha	FALSE
omfpegocgdggo	FALSE
pgbhidcmieich	FALSE
pgbjgkejagjda	FALSE
aaaabhabababab	TRUE
aadeababababab	TRUE
ajdhababababab	TRUE
ajefababababab	TRUE
bdkbababababab	TRUE
bdkdababababab	TRUE
bolnababababab	TRUE
bomabiabababab	TRUE
cijmababababab	TRUE
cikhababababab	TRUE
dcigababababab	TRUE
dcjaababababab	TRUE
dlkeababababab	TRUE
dlkgababababab	TRUE
eganababababab	TRUE
egbfababababab	TRUE
fafabiabababab	TRUE
fagaababababab	TRUE
fkjmababababab	TRUE
fkkcababababab	TRUE
ggdhababababab	TRUE
gggjababababab	TRUE
hanfababababab	TRUE
hankababababab	TRUE
hldjababababab	TRUE
hlfmababababab	TRUE
ifkkababababab	TRUE
iflkababababab	TRUE
jbdiababababab	TRUE
jbdoababababab	TRUE
jlhdababababab	TRUE
jlhjababababab	TRUE
kfdpababababab	TRUE
kfehababababab	TRUE
laanababababab	TRUE
laanababababab	TRUE
lkfnababababab	TRUE
lkgeababababab	TRUE
membababababab	TRUE
menmababababab	TRUE
mocnababababab	TRUE
moddababababab	TRUE
nihjababababab	TRUE
nihlababababab	TRUE
ocdjababababab	TRUE
ocdnababababab	TRUE
omifababababab	TRUE
omihababababab	TRUE
pfnmababababab	TRUE
pfohababababab	TRUE
aaaajhekhfehnn	FALSE
aadldadjkoomjf	FALSE
ajdlncdgoemclh	FALSE
ajdpicnmoipnhn	FALSE
beajinodhemhaf	FALSE
becdlccfnlhnbj	FALSE
bomkifgcjflcdd	FALSE
boncfnaajnakfe	FALSE
cipbmgfjkpceln	FALSE
cjacebbbhbdgoa	FALSE
dcfcehcpjcadjf	FALSE
dcfgebaoabfied	FALSE
dmibaajldbplil	FALSE
dmjgliokmhellk	FALSE
efjollcfpkgnjb	FALSE
efkaacoifmbbhg	FALSE
faecjagkcnclad	FALSE
faedpljnfmimme	FALSE
flccgcbmehnagn	FALSE
flcekfbhggjmip	FALSE
gfhikkkgmlidnm	FALSE
gfhkfhokjfocgj	FALSE
haoghpomjkcpel	FALSE
hapglaglcjdjjn	FALSE
hlkggmjeolihce	FALSE
hllpompekedikn	FALSE
igkplbgnpnhbeo	FALSE
igloakjljeaffc	FALSE
jbbheaidoijahh	FALSE
jbbkogaadnfdfe	FALSE
jldkcnhmlbpmkp	FALSE
jldnoceplkehdn	FALSE
kgafelbedbbhpa	FALSE
kgajliplcfiagm	FALSE
lacccdadfgpmgo	FALSE
ladoiakcnpalfi	FALSE
lkmodhaecgopho	FALSE
lknamopajmnklb	FALSE
mekickmhoddemh	FALSE
melfonggaffodg	FALSE
moghgjmkfpnpfo	FALSE
mogkkadanobign	FALSE
nihpoaaihgihen	FALSE
niibclhjjnnbpk	FALSE
ocefmkblecobhi	FALSE
ocfajpfahndcmi	FALSE
omcbbmooodomhm	FALSE
omcohnffoalhpf	FALSE
pfphgkdglbclcd	FALSE
pgcbnjnnjliklh	FALSE
aaaccababababab	TRUE
aabomdiabababab	TRUE
akjgpababababab	TRUE
akkipababababab	TRUE
bdomnababababab	TRUE
bdoopababababab	TRUE
bngecababababab	TRUE
bnijnababababab	TRUE
cgclfababababab	TRUE
cgeaablabababab	TRUE
cplafababababab	TRUE
cplioababababab	TRUE
dkjekababababab	TRUE
dkjffababababab	TRUE
efakjababababab	TRUE
efaknababababab	TRUE
eoinhababababab	TRUE
eoiohababababab	TRUE
fjbjeababababab	TRUE
fjbpeababababab	TRUE
gdjbhababababab	TRUE
gdmbeababababab	TRUE
gngdlababababab	TRUE
gngmaababababab	TRUE
hiigfababababab	TRUE
hiilpababababab	TRUE
icapmababababab	TRUE
icccjababababab	TRUE
imiiiababababab	TRUE
imjboababababab	TRUE
jholkababababab	TRUE
jhpmhababababab	TRUE
kbnjmababababab	TRUE
kboinababababab	TRUE
kloijababababab	TRUE
kloklababababab	TRUE
lgmpoababababab	TRUE
lgnbfababababab	TRUE
mbjjdababababab	TRUE
mbkfaboabababab	TRUE
mmbomababababab	TRUE
mmcpoababababab	TRUE
nhbnnababababab	TRUE
nhcpabnabababab	TRUE
oabfnphabababab	TRUE
oabpkahabababab	TRUE
olhibababababab	TRUE
olihbababababab	TRUE
pfleaababababab	TRUE
pfllhababababab	TRUE
aaaccomdiaepcao	FALSE
aabfabenkknnibc	FALSE
akipofkfpalmbke	FALSE
akknpkofmkedigh	FALSE
beiljdcmjojipej	FALSE
bejfpknignnmbll	FALSE
bmmphokigeoodak	FALSE
bmnldjhoaoippph	FALSE
chckbabhgijpane	FALSE
chdjhgbfbelphcb	FALSE
cpmpifkbnifpgbo	FALSE
cpnplneaeoilogh	FALSE
djekmglehnickhl	FALSE
djfldijfpeanjph	FALSE
eelkdgjhegohngi	FALSE
eenffilafglhdbo	FALSE
eonpmmbpecfkefb	FALSE
eoookhinnkaklcn	FALSE
fjbjjnnigjjkfoa	FALSE
fjccjiaamkemagb	FALSE
gdgpmlplcepladg	FALSE
gdibbebkjdeobom	FALSE
gnfodfebjjckhed	FALSE
gnhmjebpladgpoh	FALSE
hhiknmoniaobgbm	FALSE
hhljedmpfpkonbh	FALSE
ibngjadnjhcahpl	FALSE
iboaepngnlghbef	FALSE
illidfnfnpaibfn	FALSE
ilmjjfoioohdgid	FALSE
jhlodihmbnfalnp	FALSE
jhlomddboalcphj	FALSE
kcadacljbeamjgl	FALSE
kcadpfdlnjgbcal	FALSE
kmeknmgkkodkjdo	FALSE
kmelmpllenjhkgc	FALSE
lgphhiegpdgnpmg	FALSE
lhamkohglpnfcen	FALSE
mbbipghnbfdkkim	FALSE
mbcdjeoihloeolb	FALSE
mmcmhaiphcondhd	FALSE
mmdkgakdjfmmgjl	FALSE
ngaiepdnbhibgik	FALSE
ngbnmhdgeimfdjl	FALSE
oabbdfnoglgogdo	FALSE
oabcglidaepipgp	FALSE
olbbiocikodhmmh	FALSE
olbejohofopmbpo	FALSE
pfjfdopabjpjdnf	FALSE
pfjnjmjccfoigia	FALSE
aaafmabgabababab	TRUE
aaaiflababababab	TRUE
ajjencababababab	TRUE
ajjineababababab	TRUE
bdlfneababababab	TRUE
bdmfdpababababab	TRUE
bmonhcababababab	TRUE
bmopalababababab	TRUE
chimmnababababab	TRUE
chjfoeababababab	TRUE
dbjjneababababab	TRUE
dbjpmjababababab	TRUE
dlfbaiababababab	TRUE
dlfbomababababab	TRUE
efdgkkababababab	TRUE
efeikbababababab	TRUE
epodhjababababab	TRUE
eppbkaababababab	TRUE
flbafkababababab	TRUE
flbckfababababab	TRUE
gfhefpababababab	TRUE
gfhlfmababababab	TRUE
hacgaiababababab	TRUE
hacgcaababababab	TRUE
hjogfmababababab	TRUE
hjpmehababababab	TRUE
ieofikababababab	TRUE
ieojkmababababab	TRUE
ioikecababababab	TRUE
ioioghababababab	TRUE
jkcfpaababababab	TRUE
jkcjpnababababab	TRUE
kdecjiababababab	TRUE
kdegkkababababab	TRUE
knbcogababababab	TRUE
knblpcababababab	TRUE
lgepddababababab	TRUE
lgfmdoababababab	TRUE
maboambabjababab	TRUE
maceijababababab	TRUE
mkbpndababababab	TRUE
mkckocababababab	TRUE
nfhmgbababababab	TRUE
nfjcehababababab	TRUE
oalggbababababab	TRUE
oamcbiababababab	TRUE
okjgolababababab	TRUE
okjohnababababab	TRUE
pepckgababababab	TRUE
pepcknababababab	TRUE
aabbojdhhmbnibca	FALSE
aabnodokoododiid	FALSE
akgliagbpjempcap	FALSE
akhdlbbhhabkmodb	FALSE
bechehifhbcdcmgj	FALSE
becidklflickmohm	FALSE
bofmhabbpbdieiol	FALSE
bohfakbjmcgoaipn	FALSE
cijimnjopdggohce	FALSE
cikmoghchimbgjlo	FALSE
dcimkhhjhopkakan	FALSE
dcjdcpmfeghhgjkn	FALSE
dmpgplpfkglpgndg	FALSE
dmpjnebjdncfkhkg	FALSE
ehgkhnmjlipfdblp	FALSE
ehhjakcgefhnnedn	FALSE
falkelkckenaoecd	FALSE
faocjodgehhanlnd	FALSE
fkmcdknfhbnfgngb	FALSE
fknemfjdfnldfhba	FALSE
gefdpmkeacgiifdc	FALSE
gefgpanebcoejpcl	FALSE
gnkkeobdjcjchjfo	FALSE
gnkmhhalfnmdabio	FALSE
hhppnnbekjahfipd	FALSE
hiapclenmglglaoj	FALSE
icghidmjmhfcojdd	FALSE
icgkkcjfapmhmhim	FALSE
infmnamcoafmhjbc	FALSE
ingfdpdngjhhblae	FALSE
jiffigchimeknjfk	FALSE
jifhmcmiooiifboj	FALSE
kclkakhpnplidpdj	FALSE
kcneiekdhmifhadd	FALSE
kmipekggmjaeeidj	FALSE
kmjpahgadkiifpmb	FALSE
liaokchhhfkbljdd	FALSE
libieglngbcgokec	FALSE
mbpjfkmehkfenbln	FALSE
mbpmkbpeckbbjohc	FALSE
mmhcoiidpemfpkkm	FALSE
mmhemjhebgbchldb	FALSE
ngjgeamojobokkci	FALSE
ngjmjnhedhhmfhke	FALSE
obdlhjfggfodkjkc	FALSE
obeijgnlplfcikgj	FALSE
omfjmmblfofimgmm	FALSE
omghimiolflkkeoc	FALSE
pfofijnmipjaphfo	FALSE
pfpcaphiialobala	FALSE
aabbojdhhabababab	TRUE
aabnmbnibabababab	TRUE
akjaapcababababab	TRUE
akjhicjababababab	TRUE
bfcjkacababababab	TRUE
bfdbinkababababab	TRUE
bofihkpababababab	TRUE
bojdlbpababababab	TRUE
cimafpeababababab	TRUE
cimffobababababab	TRUE
dcdifbaababababab	TRUE
dcfgpodababababab	TRUE
dninjmdababababab	TRUE
dnjkjljababababab	TRUE
egliaddababababab	TRUE
eglnogiababababab	TRUE
fahaokiababababab	TRUE
fahfjdfababababab	TRUE
fkodeonababababab	TRUE
fkoffhiababababab	TRUE
geinpmgababababab	TRUE
gejieelababababab	TRUE
gofmfjlababababab	TRUE
gogkbilababababab	TRUE
hijbjegababababab	TRUE
hilddjpababababab	TRUE
idlkdndababababab	TRUE
idndiofababababab	TRUE
ioahagoababababab	TRUE
iobfdbpababababab	TRUE
jiagecpababababab	TRUE
jibicpeababababab	TRUE
kdafjflababababab	TRUE
kdahdhjababababab	TRUE
koamnbaababababab	TRUE
koaoalfababababab	TRUE
libgehlababababab	TRUE
lidbhgiababababab	TRUE
mbnabkpldabababab	TRUE
mbnfiniababababab	TRUE
mnambdfababababab	TRUE
mnaodllababababab	TRUE
ngekchaboabababab	TRUE
nggkdioababababab	TRUE
obekaabicabababab	TRUE
obeojnkababababab	TRUE
olfgoloababababab	TRUE
olheaehababababab	TRUE
pfmobpcababababab	TRUE
pfoadcdababababab	TRUE
aaahpghnfkjojjkai	FALSE
aaaihdgmfefhjpaci	FALSE
ajpphmcelhamennii	FALSE
akchcfdoigjjfngdd	FALSE
bdlpngniongppbdjb	FALSE
bdmajcpninknbfakb	FALSE
boehnhnnmoijipaoh	FALSE
boflgdbmfgfleimcc	FALSE
cigaaaobkgibnbkmo	FALSE
cigacmhkgadmdpkjj	FALSE
dcfdoepdnamcppnai	FALSE
dcfdolhkodkncelfn	FALSE
dncjippeojfpmogif	FALSE
dnckbpnckdddjjkaa	FALSE
ehiahjeflmnajhdlg	FALSE
ehiebfelkdaifbmff	FALSE
fbbkdddimjcjlhhmh	FALSE
fbccdffclodhfeggo	FALSE
fkmgkcbkcggkdafdn	FALSE
fkmnneheimncemphp	FALSE
gfbgplcgcchcaakkg	FALSE
gfccplhljhpcfobkb	FALSE
gpcpamkinhmoognpe	FALSE
gpelbdjafkddbbefa	FALSE
hjgnboddckklkkneo	FALSE
hjgodmipneglicanj	FALSE
ichijgogmaaclejci	FALSE
icidajkjbmkcpcmmm	FALSE
infjhllncmjgcdooe	FALSE
infmfoffnaccfgcfi	FALSE
jhoeejijpacknbkic	FALSE
jhonbdmbkmiombfdd	FALSE
kcjnfocnecihhkgao	FALSE
kclnifeelleeodped	FALSE
kmingcfldkkknmagh	FALSE
kmipcgpelodabaekc	FALSE
lghofmjgphddjhdpj	FALSE
lghpecfjjohbhikpi	FALSE
mbnadbomapcknpceh	FALSE
mbnpbhafbgimgcgmj	FALSE
mmenlabjkdaplfpbk	FALSE
mmfedpadnhkefabbg	FALSE
ngffiiifggopabfbc	FALSE
ngfjpjibailfoegkh	FALSE
obgcdipmgmimfcgel	FALSE
obhjjhfeliophlgmi	FALSE
olffjfnjdjkbcbfic	FALSE
olfpkbjigpldmdeml	FALSE
pgaealjnjojeoomgo	FALSE
pgafakkaiaehpfkno	FALSE
aabhkfjgekabababab	TRUE
aabimkebdbabababab	TRUE
akbflnpcababababab	TRUE
akbnooefababababab	TRUE
beepgeepababababab	TRUE
befcjimpababababab	TRUE
bobmgmffababababab	TRUE
boboghgnababababab	TRUE
cjhodpcbababababab	TRUE
cjiihelabmabababab	TRUE
dcjncindababababab	TRUE
dclbhcnmababababab	TRUE
dmnnaoipababababab	TRUE
dmpcdondababababab	TRUE
ejddcmhgababababab	TRUE
ejecmmhgababababab	TRUE
fegpaakpababababab	TRUE
feieggeoababababab	TRUE
foopankhababababab	TRUE
fopbemlbababababab	TRUE
giemeenjababababab	TRUE
gihoeeihababababab	TRUE
hcggmolbababababab	TRUE
hcihikfiababababab	TRUE
hmlakjifababababab	TRUE
hmmafkbgababababab	TRUE
igjcipfiababababab	TRUE
igjjcpjkababababab	TRUE
jamidgelababababab	TRUE
jamjidmkababababab	TRUE
jljfmdbbababababab	TRUE
jlkeagpcababababab	TRUE
kgbiebklababababab	TRUE
kgbinneiababababab	TRUE
kpfdbnfkababababab	TRUE
kpfdgnkmababababab	TRUE
liegpbicababababab	TRUE
liehlofabpabababab	TRUE
mchbdefnababababab	TRUE
mchifliabdabababab	TRUE
mnhgafbabbabababab	TRUE
mnhmkagiababababab	TRUE
nhhjgnkkababababab	TRUE
nhhohgmfababababab	TRUE
oalcnfmhababababab	TRUE
oangpjfeababababab	TRUE
okichdecababababab	TRUE
okifjhedababababab	TRUE
pfalcngkababababab	TRUE
pfbggegabbabababab	TRUE
aabhkfjgekmkebdbhn	FALSE
aabinombkcccfgknhh	FALSE
akcfkglnkkhldcfkdk	FALSE
akckbghgaiahcfceok	FALSE
bekfbfcbpjnomahfaa	FALSE
bekmpebfkcogncjhob	FALSE
bomkcellhjmkebicnd	FALSE
booaiciidhonjmdmoa	FALSE
cilgfcchknbdabbnjp	FALSE
cimgpmakbffganfoie	FALSE
dddcdlndbjddoblhji	FALSE
dddmgkknjaddhgkcdg	FALSE
dnjejjaiphcjmokgae	FALSE
dnkamocgffabcjfeld	FALSE
eifliaajoopjcpdbpp	FALSE
eiibhifimlgnbgdeim	FALSE
fegjfgieodccdheopk	FALSE
feioiinhocgdljfipk	FALSE
foihlompilcoijfgpj	FALSE
fokeaokjaaehedmjbp	FALSE
giaopomgbacbbfjimc	FALSE
gibefnkmgaccfgmjpi	FALSE
hcomlaogclebbckena	FALSE
hdbelifngnlpbonjbc	FALSE
hndaldfklhemlapcoa	FALSE
hndllcofadccpbcmef	FALSE
ihjpkapcdibofamldn	FALSE
ihkmakleliafgiolee	FALSE
jajghflehckmnmekin	FALSE
jakbiomnmchlpcdlko	FALSE
jlbjjmcdclphglooio	FALSE
jlbnknjagmnoipgfih	FALSE
kfljfadddglocecoel	FALSE
kflojgecobkbdlacde	FALSE
kpejomhhdibcnjfjdn	FALSE
kpfbofkapndiccfhap	FALSE
ljakedjnclapepflin	FALSE
ljaklkcimmblfckong	FALSE
mckepojgnjofgnebgd	FALSE
mclagfgkccmojfcgmm	FALSE
mmnlcfmcogbnffgekg	FALSE
mmnoljdmpakjlhmhkl	FALSE
nghodcbcbnbnhajjkc	FALSE
ngiflamlkiganmckel	FALSE
obacbdejcdacmhapgp	FALSE
obadblbaenbggblajn	FALSE
olbapnkhpkajdmkkeh	FALSE
olbpcdbfglmnnbgmab	FALSE
peplminfcccnoaeekf	FALSE
pepoaaemibbhiehahb	FALSE
aaacncdblababababab	TRUE
aaadgiohpababababab	TRUE
alghhnlckababababab	TRUE
alheganonababababab	TRUE
bememjigjababababab	TRUE
benibibnpababababab	TRUE
bokpnnhmhababababab	TRUE
bolenkgjcababababab	TRUE
ciaohiccbababababab	TRUE
cibbodjcmababababab	TRUE
dcopmilgdababababab	TRUE
ddalnabldgjabababab	TRUE
dofoggaalababababab	TRUE
dojjnakopababababab	TRUE
eiifahmclababababab	TRUE
eiknocoimababababab	TRUE
fcijaeikpababababab	TRUE
fcjbedcmmababababab	TRUE
fngfkpihabnabababab	TRUE
fnghmknhiababababab	TRUE
gjeapfilhababababab	TRUE
gjeeomlejababababab	TRUE
hedlhnihfababababab	TRUE
hedmlfaaaababababab	TRUE
hnmodfmcjababababab	TRUE
hnnmmhaimababababab	TRUE
igpfinkelababababab	TRUE
igpgfnhlbababababab	TRUE
jbigfokhfababababab	TRUE
jbkomkcneababababab	TRUE
jmjcjofgnababababab	TRUE
jmjfpkdbiababababab	TRUE
kggccefoaababababab	TRUE
kggjfpcfcababababab	TRUE
kpinaidamababababab	TRUE
kpjpbodjlababababab	TRUE
ljpekpncoababababab	TRUE
lkankmbmeababababab	TRUE
medmmpjecababababab	TRUE
meehcfecnababababab	TRUE
mpmmjglkbababababab	TRUE
mpnfnicblababababab	TRUE
nikmpendeababababab	TRUE
nineikicdababababab	TRUE
oddiodbkcababababab	TRUE
oddjkpicjababababab	TRUE
omkclelkmababababab	TRUE
omkganhnpababababab	TRUE
pgllnkdoiababababab	TRUE
pglopgmpeababababab	TRUE
aaajaoijdfhbkkkiicf	FALSE
aabmghcncjhfliiggoh	FALSE
akaphhcgbnokgiokmkh	FALSE
akdgnjlnoelceijnjgj	FALSE
bejkcfleopkiellgdpj	FALSE
bekeddlpanehmgfhanl	FALSE
bpepkekmhjiojkenbfk	FALSE
bpgemdlmfpgdapahigg	FALSE
cjpkdodccolmeohoeca	FALSE
ckcaeaejahnmfmopogg	FALSE
deallpfcimpniidncjd	FALSE
decfccgnlcdjjmbcakl	FALSE
dpmbmheklcidldogenj	FALSE
dpnmefpfflkjlekiijh	FALSE
ejeijbfmagmoadgjagl	FALSE
ejengjempcckhaalcbo	FALSE
ffejaaphiinfapnihjb	FALSE
fffegeeonkkgflpdgbh	FALSE
galgdpkedpakajgamei	FALSE
galkdcmipjlgppifjei	FALSE
gkonckjcpgapkddgdmh	FALSE
glalhefagjkpoejilff	FALSE
hemnkfgamodaejolkgc	FALSE
henklkhadmmojhhnmma	FALSE
hnnmbpnpipjhbegfkci	FALSE
hnnnemndkoeimacpngi	FALSE
iijelomdooeamojdach	FALSE
iiklgnphchcfhlbhpbi	FALSE
jccpmajjcggofhjiiod	FALSE
jcddlihhljdipnbefbi	FALSE
jmedaddldmolgcjmcin	FALSE
jmgdjpmelbnjaejcgff	FALSE
kgmmolmgmngfhegblhp	FALSE
kgnaappokbbgncceaga	FALSE
laojcgpboopjgjndone	FALSE
lapibabpfmkoackneil	FALSE
lmmnjdbfaihdafamggl	FALSE
lmnebadeapaiaogmgnn	FALSE
mfkhfinakkbhjpdccpn	FALSE
mfliofikijcjclhdgke	FALSE
mpjpcidikmdmdhmlmle	FALSE
mplnllceljkbkhabolm	FALSE
njenfehioklnkflcnlh	FALSE
njfkbbbgbojjgfgpcen	FALSE
odlhnbimgpmjonbmnbo	FALSE
odlpmoogaljjgidicce	FALSE
oofnjafelfojjncbegp	FALSE
oohfdedpeoldjejffoi	FALSE
phlinkbicjbafieplgg	FALSE
phmaoihholaobbkbndj	FALSE
