aaaabmaaaa	TRUE
aaaaceaaaa	TRUE
akaaaaaaaa	TRUE
akaaaaaaaa	TRUE
beaaaaaaaa	TRUE
beaaaaaaaa	TRUE
boaaaaaaaa	TRUE
boaaaaaaaa	TRUE
chaaaaaaaa	TRUE
chaaaaaaaa	TRUE
dbaaaaaaaa	TRUE
dbaaaaaaaa	TRUE
dlaaaaaaaa	TRUE
dlaaaaaaaa	TRUE
ehaaaaaaaa	TRUE
ehaaaaaaaa	TRUE
fbaaaaaaaa	TRUE
fbaaaaaaaa	TRUE
fmaaaaaaaa	TRUE
fmaaaaaaaa	TRUE
ghaaaaaaaa	TRUE
ghaaaaaaaa	TRUE
hbaaaaaaaa	TRUE
hcaaaaaaaa	TRUE
hlaaaaaaaa	TRUE
hlaaaaaaaa	TRUE
ifaaaaaaaa	TRUE
ifaaaaaaaa	TRUE
ipaaaaaaaa	TRUE
ipaaaaaaaa	TRUE
jlaaaaaaaa	TRUE
jlaaaaaaaa	TRUE
keaaaaaaaa	TRUE
keaaaaaaaa	TRUE
koaaaaaaaa	TRUE
koaaaaaaaa	TRUE
liaaaaaaaa	TRUE
liaaaaaaaa	TRUE
mbaaaaaaaa	TRUE
mbaaaaaaaa	TRUE
mmaaaaaaaa	TRUE
mmaaaaaaaa	TRUE
nhaaaaaaaa	TRUE
nhaaaaaaaa	TRUE
obaaaaaaaa	TRUE
ocaaaaaaaa	TRUE
omaaaaaaaa	TRUE
omaaaaaaaa	TRUE
pgaaaaaaaa	TRUE
pgaaaaaaaa	TRUE
aabmekjiej	FALSE
aacmmbipmh	FALSE
akcdmbdjhm	FALSE
akdgcglapb	FALSE
begkimpfmn	FALSE
beiddcofoc	FALSE
bohfegpemi	FALSE
bohnnnmmhf	FALSE
chihhiiolh	FALSE
chiiddlfcb	FALSE
dbjcachgan	FALSE
dbjdemncob	FALSE
dmlaiaplce	FALSE
dmlbgiclaj	FALSE
ehceiifkpg	FALSE
ehgcjgjfnp	FALSE
fcajaokkao	FALSE
fcalocejnp	FALSE
fmchcnkbha	FALSE
fmckgcciok	FALSE
ghehedbefp	FALSE
ghemngcdkc	FALSE
hccjialkbn	FALSE
hccljdheem	FALSE
hlhkgbdfnk	FALSE
hlinmdoecp	FALSE
iflkmodngm	FALSE
ifobfaojkf	FALSE
ipgdffbnlm	FALSE
iphdeiphio	FALSE
jkcebcppjc	FALSE
jkdnenpelj	FALSE
kejfchjkcd	FALSE
kekpojiegd	FALSE
kohelmglbk	FALSE
kohgnjhlde	FALSE
ljajfffibb	FALSE
ljalkheomf	FALSE
mcbpppbnpi	FALSE
mccdhhkkgf	FALSE
mmikllglai	FALSE
mmkblppgjp	FALSE
ngmpmkhbik	FALSE
ngnmkkjpjo	FALSE
obiobijnce	FALSE
objpdcdhhd	FALSE
okoeohbgef	FALSE
okpnndhcac	FALSE
pggdfmbfih	FALSE
pghjmiahhd	FALSE
aabaaaaaaaa	TRUE
aacaaaaaaaa	TRUE
akeaaaaaaaa	TRUE
akfaaaaaaaa	TRUE
begaaaaaaaa	TRUE
begaaaaaaaa	TRUE
boeaaaaaaaa	TRUE
bofaaaaaaaa	TRUE
cilaaaaaaaa	TRUE
cilaaaaaaaa	TRUE
dbkaaaaaaaa	TRUE
dbkaaaaaaaa	TRUE
dlmaaaaaaaa	TRUE
dlnaaaaaaaa	TRUE
ehbaaaaaaaa	TRUE
ehbaaaaaaaa	TRUE
fbmaaaaaaaa	TRUE
fbnaaaaaaaa	TRUE
fmgaaaaaaaa	TRUE
fmiaaaaaaaa	TRUE
ggkaaaaaaaa	TRUE
gglaaaaaaaa	TRUE
hbnaaaaaaaa	TRUE
hboaaaaaaaa	TRUE
hmaaaahaaaa	TRUE
hmaaaajaaaa	TRUE
igfaaaaaaaa	TRUE
igfaaaaaaaa	TRUE
ipiaaaaaaaa	TRUE
ipjaaaaaaaa	TRUE
jkbaaaaaaaa	TRUE
jkbaaaaaaaa	TRUE
kepaaaaaaaa	TRUE
kepaaaaaaaa	TRUE
kojaaaaaaaa	TRUE
kolaaaaaaaa	TRUE
lidaaaaaaaa	TRUE
lieaaaaaaaa	TRUE
mccaaaaaaaa	TRUE
mcdaaaaaaaa	TRUE
mlnaaaaaaaa	TRUE
mlnaaaaaaaa	TRUE
ngjaaaaaaaa	TRUE
nglaaaaaaaa	TRUE
oceaaaaaaaa	TRUE
ocfaaaaaaaa	TRUE
omgaaaaaaaa	TRUE
omgaaaaaaaa	TRUE
pgpaaaaaaaa	TRUE
pgpaaaaaaaa	TRUE
aabmekjiejm	FALSE
aacmbipmhcm	FALSE
akfjijpolae	FALSE
akhlfaakddk	FALSE
beldobeiiac	FALSE
belmgagdbhn	FALSE
bobmfncnjhk	FALSE
bocoebhpjmn	FALSE
cifblaeimea	FALSE
cifdpbliobl	FALSE
dchfmnfolhf	FALSE
dchmbmemgmg	FALSE
dmdfackaaij	FALSE
dmdgpgiodap	FALSE
ehmkejcnbed	FALSE
ehnkjdmcmid	FALSE
fcbekhcnkbh	FALSE
fcbfagcciok	FALSE
flpfpafpkmj	FALSE
fmbeclepolc	FALSE
ghfgjckgpep	FALSE
ghgifmfjfej	FALSE
hbpfhgddkai	FALSE
hbpgoghojdn	FALSE
hleikcggpgm	FALSE
hlenagejdmn	FALSE
ifckbfgdapi	FALSE
ifckikgmnkk	FALSE
iplghbpmfef	FALSE
iplnefaeonk	FALSE
jkdbdajinpb	FALSE
jkddhipdcfe	FALSE
kempjifehhf	FALSE
keoonageekj	FALSE
koljhanpmld	FALSE
komiamaflml	FALSE
ljfdckljkoe	FALSE
ljghhaimabk	FALSE
mcamcdbcefd	FALSE
mccfcebjhcb	FALSE
mljdjfnpmbd	FALSE
mlkfolokfne	FALSE
ngldphpkoho	FALSE
ngmnmkpcfak	FALSE
ocgcbnbnbhj	FALSE
ochbhlenkhn	FALSE
olplegaingg	FALSE
omcdkpphmoj	FALSE
pfjjgacmhoj	FALSE
pfkclednfpd	FALSE
aaalaaaaaaaa	TRUE
aabiaaaaaaaa	TRUE
akomaaaaaaaa	TRUE
akopaaaaaaaa	TRUE
bgaiaaaaaaaa	TRUE
bgapaaaaaaaa	TRUE
cbkjaaaaaaaa	TRUE
cbmeaaaaaaaa	TRUE
cmamaaaaaaaa	TRUE
cmcbaaaaaaaa	TRUE
dgplaaaaaaaa	TRUE
dgpnaaaaaaaa	TRUE
eamnaaaaaaaa	TRUE
eaofaaaaaaaa	TRUE
ekfdaaaaaaaa	TRUE
ekfjaaaaaaaa	TRUE
fdcaaaafaaaa	TRUE
fdcfaaaaaaaa	TRUE
fmghaaaaaaaa	TRUE
fmgmaaaaaaaa	TRUE
ghdlaaaaaaaa	TRUE
ghefaaaaaaaa	TRUE
hccoaaaaaaaa	TRUE
hccoaaaaaaaa	TRUE
hmjbaaaaaaaa	TRUE
hmkkaaaaaaaa	TRUE
ihieaaaaaaaa	TRUE
ihlkaaaaaaaa	TRUE
jbpfaaaaaaaa	TRUE
jcaeaaaaaaaa	TRUE
jlofaaaaaaaa	TRUE
jlogaaaaaaaa	TRUE
kfidaaaaaaaa	TRUE
kfkiaaaaaaaa	TRUE
lahmaaaaaaaa	TRUE
laidaaaaaaaa	TRUE
lkjmaaaaaaaa	TRUE
lkkbaaaaaaaa	TRUE
meooaaaaaaaa	TRUE
meopaaaaaaaa	TRUE
mpljaaaaaaaa	TRUE
mplnaaaaaaaa	TRUE
njjdaaaaaaaa	TRUE
njkgaaaaaaaa	TRUE
oedeaaaaaaaa	TRUE
oeegaaaaaaaa	TRUE
oofiaaaaaaaa	TRUE
ooggaaaaaaaa	TRUE
phalaaaaaaaa	TRUE
phbfaaaaaaaa	TRUE
aaaliggflama	FALSE
aablgfdjldaf	FALSE
akmbijihmkje	FALSE
akpapladfpdk	FALSE
bfnhpdbhmgca	FALSE
bfohaebgpcoh	FALSE
cbpbojhalmik	FALSE
cbpnjapobnbj	FALSE
cmaogblnjcea	FALSE
cmcdgpciddjh	FALSE
dfliifedgcgc	FALSE
dfmgmdpmmnpo	FALSE
ealhfdanffae	FALSE
ealhodjjnlbh	FALSE
elegcbdppgjc	FALSE
elfldpcmkmoc	FALSE
fdijgheheffb	FALSE
fdimnliefffo	FALSE
fnifjmndihjo	FALSE
fnjldenndkag	FALSE
ghnmhjpkjkbn	FALSE
ghpedgkgpkpg	FALSE
hcmpaefaaeko	FALSE
hcoafajjgmni	FALSE
hmmafkcahall	FALSE
hmmjjenogidb	FALSE
ihafohdlinmd	FALSE
ihbfegklngjc	FALSE
jcfodcgnghjo	FALSE
jcgdgmmijanh	FALSE
jmehpjippflk	FALSE
jmfdmcjhfcja	FALSE
kglmbfmkhbla	FALSE
kgnecekpompp	FALSE
laifekmeojap	FALSE
laijecaginkf	FALSE
llgeichdmpdn	FALSE
llggpnoafefk	FALSE
mfabkdfpfijb	FALSE
mfaccijjgkdk	FALSE
mpjaaphfjmgi	FALSE
mpkolgadfhna	FALSE
nioahmogcgkg	FALSE
nipelgkadgna	FALSE
odgfmbpoejin	FALSE
odikelhbknkg	FALSE
onkfeaklapff	FALSE
onkmchjoabkc	FALSE
pgokdbcboiip	FALSE
pgpejgjhlhoe	FALSE
aaaliaaaaaaaa	TRUE
aabggaaaaaaaa	TRUE
akpahaaaaaaaa	TRUE
akpfiaaaaaaaa	TRUE
bgpfkaaaaaaaa	TRUE
bgplnaaaaaaaa	TRUE
cbfalaaaaaaaa	TRUE
cbhmiaaaaaaaa	TRUE
cmejaaaaaaaah	TRUE
cmeoaaaabaaaa	TRUE
dghpiaaaaaaaa	TRUE
dgiooaaaaaaaa	TRUE
eammfaaaaaaaa	TRUE
eaoboaaaaaaaa	TRUE
ejlmpaaaaaaaa	TRUE
ejmkdaaaaaaaa	TRUE
fdkhaaaapaaaa	TRUE
fdmkbaaaaaaaa	TRUE
fnagfaaaaaaaa	TRUE
fnbjnaaaaaaaa	TRUE
ghifbaaaaaaaa	TRUE
ghiikaaaaaaaa	TRUE
hcandaaaaaaaa	TRUE
hcbdfaaaaaaaa	TRUE
hmfepaaaaaaaa	TRUE
hmgfpaaaaaaaa	TRUE
ihapkaaaaaaaa	TRUE
ihcddaaaaaaaa	TRUE
jbppaaaaeaaaa	TRUE
jcakbaaaaaaaa	TRUE
jlpjhaaaaaaaa	TRUE
jlplpaaaaaaaa	TRUE
kgclkaaaaaaaa	TRUE
kgdagaaaaaaaa	TRUE
lajfbaaaaaaaa	TRUE
lakkaaaakaaaa	TRUE
lkoamaaaaaaaa	TRUE
lkpbiaaaaaaaa	TRUE
mfeoiaaaaaaaa	TRUE
mffikaaaaaaaa	TRUE
mpioeaaaaaaaa	TRUE
mpmdoaaaaaaaa	TRUE
njmkiaaaaaaaa	TRUE
njncgaaaaaaaa	TRUE
odibcaaaaaaaa	TRUE
odieaaaamaaaa	TRUE
onjpcaaaaaaaa	TRUE
onkagaaaaaaaa	TRUE
phfaoaaaaaaaa	TRUE
phfbkaaaaaaaa	TRUE
aaadlkaadmflj	FALSE
aaamfofmppdcp	FALSE
akobnaommblbl	FALSE
akomipmmadgbp	FALSE
bggnjdpnbfdfh	FALSE
bghmncmbmmgjm	FALSE
caonmpfefdfmk	FALSE
cbampfbhgoale	FALSE
clfkbpalohfda	FALSE
clfnfkdmbmkdp	FALSE
dgdhhmpapjogd	FALSE
dgebeleajnako	FALSE
eaeobfellmaoo	FALSE
eaepdldkpgekp	FALSE
ekoahdchpdjkj	FALSE
ekojcnjeiofdm	FALSE
fdpngilodmbim	FALSE
feajhkcmjmmhb	FALSE
foidpabjolmpg	FALSE
foiffmcmbhlkc	FALSE
ghmgaoanmgfpn	FALSE
ghngfhodfjago	FALSE
hcbmafpnlajjk	FALSE
hccgbelfmhefd	FALSE
hlpannhjpcena	FALSE
hmalopklaplkp	FALSE
ihlnbhkmejpae	FALSE
ihmamdglpiejh	FALSE
jbhobbjogcgko	FALSE
jbinjlkipgenk	FALSE
jlfajpcanoekh	FALSE
jlfkjmnlneodp	FALSE
kekdembcacdjk	FALSE
kekhdophagneb	FALSE
kngkkhoefobeh	FALSE
knhnjaibikocp	FALSE
linedogehgfef	FALSE
lioeomiilcipg	FALSE
mcdidjkgagcmg	FALSE
mcehhpbiknkki	FALSE
mllcnhdkpnfec	FALSE
mlngdemhjmeeo	FALSE
nfmdgmkgfmmml	FALSE
nfmhofhcllclf	FALSE
obgfldbkhbefj	FALSE
obidoagjbjnai	FALSE
oldndkaojgjmj	FALSE
olfedjidbfegb	FALSE
pfegnolofgfdp	FALSE
pfehhhgkahapa	FALSE
aaadlkaaaaaaaa	TRUE
aaamaaaadmaaaa	TRUE
aklannaaaaaaaa	TRUE
aklehgaaaaaaaa	TRUE
bgbdgiaaaaaaaa	TRUE
bgbgdeaaaaaaaa	TRUE
cbdngpaaaaaaaa	TRUE
cbeebkaaaaaaaa	TRUE
clgcedaaaaaaaa	TRUE
clgmkaaaakaaaa	TRUE
dgffiaaaanaaaa	TRUE
dgfiibaaaaaaaa	TRUE
eafpjnaaaaaaaa	TRUE
eagbdhaaaaaaaa	TRUE
ekhgfnaaaaaaaa	TRUE
ekhjmmaaaaaaaa	TRUE
fdncngaaaaaaaa	TRUE
fdnomdaaaaaaaa	TRUE
fnplgdaaaaaaaa	TRUE
fnpogfaaaaaaaa	TRUE
ggodaoaaaaaaaa	TRUE
ggoipiaaaaaaaa	TRUE
hcdmfkaaaaaaaa	TRUE
hcdogoaaaaaaaa	TRUE
hnjklcaaaaaaaa	TRUE
hnkfelaaaaaaaa	TRUE
ihohejaaaaaaaa	TRUE
ihpeagaaaaaaaa	TRUE
jcbgelaaaaaaaa	TRUE
jcbmelaaaaaaaa	TRUE
jlkadmaaaaaaaa	TRUE
jlldkpaaaaaaaa	TRUE
keimbfaaaaaaaa	TRUE
keippdaaaaaaaa	TRUE
knmjhaaaamaaaa	TRUE
knmjikaaaaaaaa	TRUE
lgpogkaaaaaaaa	TRUE
lhaceeaaaaaaaa	TRUE
mbjafgaaaaaaaa	TRUE
mbjllhaaaaaaaa	TRUE
mlonjdaaaaaaaa	TRUE
mlonkbaaaaaaaa	TRUE
ngnnifaaaaaaaa	TRUE
ngnolgaaaaaaaa	TRUE
obfmifaaaaaaaa	TRUE
obfpajaaaaaaaa	TRUE
oknphhaaaaaaaa	TRUE
okoaliaaaaaaaa	TRUE
pekjniaaaaaaaa	TRUE
pekoliaaaaaaaa	TRUE
aaaohmcmiodphc	FALSE
aabmapdamihcdk	FALSE
akfaefgnkpaedg	FALSE
akfgkhjahmjljg	FALSE
bejaapeligknbk	FALSE
bekddolbnobfgb	FALSE
bodbaddjlgjhcg	FALSE
bodhpgnmcbhnia	FALSE
chncnibcjhaohn	FALSE
chpoobofmpmdgd	FALSE
dbpnipojidngbh	FALSE
dcapbejeieokpp	FALSE
dnfmheappfncmg	FALSE
dngabecdibcadg	FALSE
ejalhagaoimmba	FALSE
ejddejlnobhnca	FALSE
fedndckcioinhi	FALSE
feeglchnbanhde	FALSE
fonbgpnfofdcdc	FALSE
fonggeihgpkbcp	FALSE
ghnjhaoekldfne	FALSE
ghodimjoogjdbk	FALSE
hcnmjcoekmehic	FALSE
hcomekgjkpdgof	FALSE
hnkdcmdkebijhh	FALSE
hnmdmccilidace	FALSE
iihhbnadaglcfp	FALSE
iihppakbdjepdn	FALSE
jcbhbclhjngaib	FALSE
jcccnbkfcphacp	FALSE
jmggcajfbcbedc	FALSE
jmhihiphmomldl	FALSE
kfmffcdmfcgmno	FALSE
kfnccgnfoechdj	FALSE
kppdaohpajngco	FALSE
laaalobpbmeinj	FALSE
llbhbakoifggni	FALSE
llblgklbbpjgim	FALSE
mfbnliajeflied	FALSE
mfdgahkmjdcgel	FALSE
molicmcemlogmp	FALSE
molodjhckkocbi	FALSE
nhgemmbhfjipne	FALSE
nhgklagjcpmnao	FALSE
ocepoeaalpchpn	FALSE
ocfdijilefhgfi	FALSE
omgegjgflahdmf	FALSE
omgjkglcpmcjbm	FALSE
phamepmlkemcli	FALSE
phbghlboficoin	FALSE
aaaekodaaaaaaaa	TRUE
aacbjpgaaaaaaaa	TRUE
alcchdhaaaaaaaa	TRUE
aleanmkaaaaaaaa	TRUE
bfgccdhaaaaaaaa	TRUE
bfhafbcaaaaaaaa	TRUE
bpndmdeaaaaaaaa	TRUE
bpnibegaaaaaaaa	TRUE
cjfenjgaaaaaaaa	TRUE
cjfpechaaaaaaaa	TRUE
dckljlgaaaaaaaa	TRUE
dcknijkaaaaaaaa	TRUE
dmaaolaaaapaaaa	TRUE
dmacbkmaaaaaaaa	TRUE
eghfdcgaaaaaaaa	TRUE
egifcajaaaaaaaa	TRUE
fbblbdiaaaaaaaa	TRUE
fbdjjccaaaaaaaa	TRUE
flbomlmaaaaaaaa	TRUE
flcoegaaaabaaaa	TRUE
gfoakndaaaaaaaa	TRUE
gfpgeckaaaaaaaa	TRUE
hbdegpjaaaaaaaa	TRUE
hbdkildaaaaaaaa	TRUE
hlkngbiaaaaaaaa	TRUE
hlmfnoaaaacaaaa	TRUE
ifmjbkgaaaaaaaa	TRUE
ifninhaaaajaaaa	TRUE
ipdfanmaaaaaaaa	TRUE
ipdjmfgaaaaaaaa	TRUE
jjkefahaaaaaaaa	TRUE
jjkjcmeaaaaaaaa	TRUE
kekdmenaaaaaaaa	TRUE
kekljadaaaaaaaa	TRUE
konoekjaaaaaaaa	TRUE
kooajkiaaaaaaaa	TRUE
liclbojaaaaaaaa	TRUE
lieeofpaaaaaaaa	TRUE
mcblmmkaaaaaaaa	TRUE
mcdpjplaaaaaaaa	TRUE
mlmlpmmaaaaaaaa	TRUE
mlnengiaaaaaaaa	TRUE
nglhkbgaaaaaaaa	TRUE
ngloljjaaaaaaaa	TRUE
oabjeniaaaaaaaa	TRUE
oacdfdhaaaaaaaa	TRUE
olhfdkhaaaaaaaa	TRUE
olhgpceaaaaaaaa	TRUE
pgcainoaaaaaaaa	TRUE
pgdjmahaaaaaaaa	TRUE
aaaekodbjpgihha	FALSE
aacojphnkcggcpi	FALSE
alaiippifjghkll	FALSE
alcgjhhjcknkngg	FALSE
bgbeppbknhdnhik	FALSE
bgcdiknfdbjfbka	FALSE
bpmcjceofjcijej	FALSE
bpmnpdicfbignpb	FALSE
cilmdomlcgonifh	FALSE
cilmeblfnhfebne	FALSE
dclmfododifffjh	FALSE
dcmnmhicbfmbfab	FALSE
dmlnogpemkiield	FALSE
dmnkmelccekkhca	FALSE
egkkeackfmjeblh	FALSE
eglddoflellikaj	FALSE
fbidiagkgfiofpk	FALSE
fbieoifihflefjg	FALSE
flailpaknblmmkp	FALSE
flalphodhmhkonj	FALSE
ggfmedmmmdldnod	FALSE
gghadjonohbionc	FALSE
haldldnmamiomng	FALSE
hamcmhoghklkjgk	FALSE
hlonijbhllknjkh	FALSE
hlpdggfaficpdbb	FALSE
ighomeoojppjjih	FALSE
igilhbnfoogikmn	FALSE
ipfaegcfpkeimkf	FALSE
ipfmbgljnmdnpci	FALSE
jkfkfelpcefbobf	FALSE
jkgagjdiakbhoam	FALSE
kfemigpjjbjhpfa	FALSE
kffahlmifajjcmd	FALSE
konffhpinilggke	FALSE
konmncopoohdocn	FALSE
lifgcfnemigaami	FALSE
lifkcllelgijpmg	FALSE
mbpfochlangmdbc	FALSE
mcabegdihdamdje	FALSE
mmjagjdgpmcepma	FALSE
mmjpchekkafpnba	FALSE
nhfppbokmpkcnni	FALSE
nhggloligcbhbim	FALSE
oacomlgdcecjifb	FALSE
oaggmbnlbddkblk	FALSE
olomnohfflbhcjo	FALSE
olopjplikofdhmm	FALSE
pfokicfdbbpnhjo	FALSE
pgakjmjknefekcm	FALSE
aaabbegbaaaaaaaa	TRUE
aaafoddmaaaaaaaa	TRUE
ajffedcjaaaaaaaa	TRUE
ajfmhjjdaaaaaaaa	TRUE
bdanhaloaaaaaaaa	TRUE
bdcbomnlaaaaaaaa	TRUE
bnlipclhaaaaaaaa	TRUE
bnmmeeblaaaaaaaa	TRUE
chiddgflaaaaaaaa	TRUE
chijacgoaaaaaaaa	TRUE
dbhabhngaaaaaaaa	TRUE
dbhahehbaaaaaaaa	TRUE
dlgabgmpaaaaaaaa	TRUE
dlheaclhaaaaaaaa	TRUE
efdinjhhaaaaaaaa	TRUE
efeahniaaaabaaaa	TRUE
epglmjpfaaaaaaaa	TRUE
ephpekmjaaaaaaaa	TRUE
fkocahlfaaaaaaaa	TRUE
fkpdagacaaaaaaaa	TRUE
gfbapbnhaaaaaaaa	TRUE
gfbkadheaaaaaaaa	TRUE
gofefbpmaaaaaaaa	TRUE
gofncmaaaanoaaaa	TRUE
hjnclopmaaaaaaaa	TRUE
hjollakpaaaaaaaa	TRUE
idoohpbgaaaaaaaa	TRUE
ieaebdeoaaaaaaaa	TRUE
ipelnmlfaaaaaaaa	TRUE
ipepmddgaaaaaaaa	TRUE
jjjjfcjgaaaaaaaa	TRUE
jjjkdmncaaaaaaaa	TRUE
kdemckpjaaaaaaaa	TRUE
kdgbbkdiaaaaaaaa	TRUE
kopapeccaaaaaaaa	TRUE
kpaaipjeaaaaaaaa	TRUE
lkaachdcaaaaaaaa	TRUE
lkbplelkaaaaaaaa	TRUE
memncmiiaaaaaaaa	TRUE
menbefehaaaaaaaa	TRUE
mokohpfiaaaaaaaa	TRUE
molcmhcjaaaaaaaa	TRUE
njifihjfaaaaaaaa	TRUE
njiobkdbaaaaaaaa	TRUE
odijmlanaaaaaaaa	TRUE
odjfdemlaaaaaaaa	TRUE
omphgkhmaaaaaaaa	TRUE
ompjjchoaaaaaaaa	TRUE
pgohmmonaaaaaaaa	TRUE
pgojeallaaaaaaaa	TRUE
aaabbegboddmmknm	FALSE
aaafmgfmnonbbida	FALSE
ajgefafeojjippcj	FALSE
ajghfbkockojbemp	FALSE
bdgknfgnalcgencm	FALSE
bdhepebhaocbikob	FALSE
bnlnfmcgjheaidfp	FALSE
bnmjhmghpghpkhbk	FALSE
chflelachbcplggh	FALSE
chflgmhoefapblal	FALSE
dbapmhakcigpidgj	FALSE
dbbaloadiohfgein	FALSE
dkghfjioombdijnf	FALSE
dkgpjccgojagonoc	FALSE
efknhjcdhaoidlci	FALSE
efmbehjokiojghlm	FALSE
epjcjifgjhofklge	FALSE
epkkfbebnckkpgka	FALSE
fliclgjkofannoen	FALSE
fljkkncmiibefehh	FALSE
genjcfldbkdcmgcj	FALSE
gepjkljmbodebjfi	FALSE
gohjhdokpkonjlcc	FALSE
goiamakihebdakkm	FALSE
hkdhcenocomplajf	FALSE
hkeefejmleienecg	FALSE
iegpngnmjbapnadl	FALSE
iehdilkfllamochc	FALSE
ipblddeelomckngj	FALSE
ipcicmlpgoainpfe	FALSE
jimmlgpmmpbdigom	FALSE
jinmddkfknmompja	FALSE
kdgechkieidekoab	FALSE
kdgpdfnlagkajebn	FALSE
koiemklmfachbjif	FALSE
koimmppiegajoief	FALSE
ljginngafheoiimg	FALSE
ljgjepkdlpdjbnaa	FALSE
mepfhmeghfjgjimj	FALSE
mfaekmilmnlmghdm	FALSE
moipojacobpbcfdf	FALSE
mojacchcdolladgg	FALSE
nilicdceolnkfkkp	FALSE
nillbaecphojcbck	FALSE
ocgjdojfojpolhaa	FALSE
ochhlgiehemcfblb	FALSE
ondfhhkiejiiobdh	FALSE
oneicplpmldgonhm	FALSE
pgnjcbegmgohdcob	FALSE
pgpdcpkdgcedfgnm	FALSE
aabpampanaaaaaaaa	TRUE
aacbifnbpaaaaaaaa	TRUE
akjhdipmgaaaaaaaa	TRUE
akjlfnfofaaaaaaaa	TRUE
bejnhioacaaaaaaaa	TRUE
bekbokhkkaaaaaaaa	TRUE
bofbmmdkmaaaaaaaa	TRUE
bojanoedfaaaaaaaa	TRUE
cikjjcnlpaaaaaaaa	TRUE
cikoacfbgaaaaaaaa	TRUE
dbipgigjaaaaoaaaa	TRUE
dbjhkcfceaaaaaaaa	TRUE
dlpoobkcgaaaaaaaa	TRUE
dmcfnanddaaaaaaaa	TRUE
ehcdmegohaaaaaaaa	TRUE
ehdfanjmnaaaaaaaa	TRUE
fbilomjbaaaajaaaa	TRUE
fbjoeodkjaaaaaaaa	TRUE
flnjnbjcjaaaaaaaa	TRUE
flokmmlbhaaaaaaaa	TRUE
ggjnlebghaaaaaaaa	TRUE
ggkkimgigaaaaaaaa	TRUE
hbaagejblaaaaaaaa	TRUE
hbbgjenkgaaaaaaaa	TRUE
hloelnklgaaaaaaaa	TRUE
hlpahlcmhaaaaaaaa	TRUE
ighfloppaaaaeaaaa	TRUE
ighjjbdioaaaaaaaa	TRUE
jahkkhajoaaaaaaaa	TRUE
jaijbcfokaaaaaaaa	TRUE
jjniejbomaaaaaaaa	TRUE
jjoijkejjaaaaaaaa	TRUE
kedbomdicaaaaaaaa	TRUE
keeaeildcaaaaaaaa	TRUE
kpcfonmnnaaaaaaaa	TRUE
kpciphollaaaaaaaa	TRUE
libgkledbaaaaaaaa	TRUE
lifkbbnibaaaaaaaa	TRUE
mbgklancjaaaaaaaa	TRUE
mbijpamhpaaaaaaaa	TRUE
mlfkedcokaaaaaaaa	TRUE
mlglgknpiaaaaaaaa	TRUE
nfajhlgifaaaaaaaa	TRUE
nfbahhkijaaaaaaaa	TRUE
oahipgnefaaaaaaaa	TRUE
oajnpmfodaaaaaaaa	TRUE
okgclmcmmaaaaaaaa	TRUE
okgdfiobpaaaaaaaa	TRUE
pfhmpbeocaaaaaaaa	TRUE
pfjakgphcaaaaaaaa	TRUE
aabcclkkfaogcmooa	FALSE
aabggdmdofdfpjmkc	FALSE
akgbemleeabmddkpg	FALSE
akgclbbldllepmkmf	FALSE
bdkgfhhbpifgogakf	FALSE
bdkhgmhadbanpofde	FALSE
bnipeoebffieandbd	FALSE
bnjgbchbghagibdhk	FALSE
chldlggemggklemnc	FALSE
chngealglimmfcomo	FALSE
dapmdenhcjcccoepc	FALSE
dbahbahbgcbilaepk	FALSE
dknnkjhheiobhpich	FALSE
dkoaadbklelhnbmkb	FALSE
efabhaadbnebiilkn	FALSE
efaknkdcefapdliml	FALSE
eojfiiehhhjgikbjh	FALSE
eojjelccdonbooeok	FALSE
finlgpdeaekfjakpf	FALSE
fioicenobinjdcgea	FALSE
gdkdnkmlkgnnkohfh	FALSE
gdmajgllhmdjdbcip	FALSE
golijkejkbkkgddef	FALSE
golopaekmpangoinm	FALSE
hiindfojeebjhdeoi	FALSE
hijafcakknbkodiaf	FALSE
icaedliplndldhakp	FALSE
icaldbkkpahhgoekc	FALSE
inccldpcfdmfmafaf	FALSE
indgdnkfcpojlkopb	FALSE
jiccdhhdfhpgepmmp	FALSE
jiclipecdodkhngbd	FALSE
kcgceniinldjgehod	FALSE
kchgmfjhghmfdcfmh	FALSE
kmopbcgbahlenemlo	FALSE
kmpaendefgmdpobpa	FALSE
lhlebhgdlkpapepnc	FALSE
lhmemniopdfnbmmjg	FALSE
mapfadmofepldpkej	FALSE
mapogbdgipgdfgcoc	FALSE
mkpckcdpmifjheghl	FALSE
mlaffefooflegfanp	FALSE
nfngbddnmfjejommj	FALSE
nfnjdkfmakbagpkgc	FALSE
npolkjgeipmnnihcn	FALSE
npoookgnlhelkbkmj	FALSE
ojhlabbdjhomgoocb	FALSE
ojikbmhfoeachkmhi	FALSE
pfkjiihogphilmpne	FALSE
pfkoekmfebipciacl	FALSE
aabcclkkfaaaaoaaaa	TRUE
aabggcmooaaaagaaaa	TRUE
akfalghmmpaaaaaaaa	TRUE
akfcldbfahaaaaaaaa	TRUE
bdgkehdcmdaaaaaaaa	TRUE
bdhkfhjhodaaaaaaaa	TRUE
bnnhnpgimkaaaaaaaa	TRUE
bnnijlpfbbaaaaaaaa	TRUE
chdpgdpejdaaaaaaaa	TRUE
cheieaomkmaaaaaaaa	TRUE
dbebciljkbaaaaaaaa	TRUE
dbfacbfpolaaaaaaaa	TRUE
dkkfokojcmaaaaaaaa	TRUE
dkmbplgccdaaaaaaaa	TRUE
eennpgaclcaaaaaaaa	TRUE
eeoddhiamnaaaaaaaa	TRUE
eoneggenmhaaaaaaaa	TRUE
eonggcpdodaaaaaaaa	TRUE
fhpmhlemcmaaaaaaaa	TRUE
fiakefpnopaaaaaaaa	TRUE
gdbahamidjaaaaaaaa	TRUE
gddaedphhiaaaaaaaa	TRUE
gogaepolioaaaaaaaa	TRUE
gogglkofhmaaaaaaaa	TRUE
hhhlheccgnaaaaaaaa	TRUE
hhicochlepaaaaaaaa	TRUE
ichjgjocboaaaaaaaa	TRUE
ichnkohicoaaaaaaaa	TRUE
inlbodcfkeaaaaaaaa	TRUE
inmilpoobnaaaaaaaa	TRUE
jiblpjcpniaaaaaaaa	TRUE
jichkdliknaaaaaaaa	TRUE
kcolffiejfaaaaaaaa	TRUE
kcooppkkdnaaaaaaaa	TRUE
knkfikamfoaaaaaaaa	TRUE
knkjblhodjaaaaaaaa	TRUE
lhdpgjpcpdaaaaaaaa	TRUE
lheobmaohlaaaaaaaa	TRUE
maiogdjammaaaaaaaa	TRUE
majjjajkkpaaaaaaaa	TRUE
mkpkmmpkhkaaaaaaaa	TRUE
mlbbmnbnofaaaaaaaa	TRUE
nfeipdlcmgaaaaaaaa	TRUE
nfeodgpincaaaaaaaa	TRUE
npocloboaiaaaaaaaa	TRUE
nppicgpdbiaaaaaaaa	TRUE
ojobkdegnmaaaaaaaa	TRUE
ojpmdliplnaaaaaaaa	TRUE
pffpajpjogaaaaaaaa	TRUE
pfgaahcbnaaaakaaaa	TRUE
aaabcdkdgfdgpamkog	FALSE
aaackbpblchpnpfhpi	FALSE
akmlfgipmmiilcjbdb	FALSE
aknbefldkejhdipbek	FALSE
bgepkbkjpppcdgcnoj	FALSE
bgffdkdhpaheeaafoh	FALSE
calfeaanppmnmgcljm	FALSE
calpaeoenmiigogjbe	FALSE
cjjedppjinicflomie	FALSE
cjkfmcalcejcbdhpic	FALSE
demdgekcefmbeafhna	FALSE
demmphcaaojbppaebj	FALSE
dojhnhflolhkflnimg	FALSE
domadllokohoakdajd	FALSE
eiblhfjjfdlnfdhggd	FALSE
eicphfmamenbmooeng	FALSE
fcnhlpmhbcdlhlloal	FALSE
fcoandnpjlfacefklp	FALSE
fmjhgdifhkdhlgipfe	FALSE
fmjialoecbghlkccmc	FALSE
ggbieaffblmhldckjj	FALSE
ggdnobjbbjmpjfjnbo	FALSE
gpkdlhanpemcidagkj	FALSE
gpklfkgkhidohdagie	FALSE
hlimbpjkaabcobhgen	FALSE
hllacijeppmbekjcgj	FALSE
iheffkogjaikedikme	FALSE
ihegieefddifknmjmo	FALSE
jbefjenkfcbomlkfbj	FALSE
jbfmmekjaokhoaoahb	FALSE
jlpkhejepblngpeile	FALSE
jmammcjcgjihpdijdl	FALSE
kfchlooneikonjcigj	FALSE
kfgbfppbdaoonhpjgk	FALSE
kpglehindoodobdefa	FALSE
kphbcgfaaocngemcja	FALSE
ljbdhjbapkpkjhgnca	FALSE
ljbjmnhgfkbeceeaaj	FALSE
mcgblpipcaogmdajkk	FALSE
mcgieikblmindocafk	FALSE
moijjlfohflgbnpmii	FALSE
moiojmmopjmpglcfka	FALSE
nilcnnkhehcahajjlj	FALSE
nimkdhkjgmnjgaobie	FALSE
ochlpcpkplmfjjnkgi	FALSE
ocimciacagiebbalkl	FALSE
omfnkabdhbokpiejpm	FALSE
omgmpdpnhcnlcmhepj	FALSE
pglgfgnpojcmakejfa	FALSE
pglimgbbbkgpdcibjk	FALSE
aaajkhijieoaaaaaaaa	TRUE
aaddcgacpdcaaaaaaaa	TRUE
albdeampamlaaaaaaaa	TRUE
alcigjlheenaaaaaaaa	TRUE
bfjneoibfliaaaaaaaa	TRUE
bfnmiedjponaaaaaaaa	TRUE
bpfcglcppbgaaaaaaaa	TRUE
bpfdbmgimloaaaaaaaa	TRUE
cjjpfiddchhaaaaaaaa	TRUE
cjkgiaokklfaaaaaaaa	TRUE
decmepfkbdaaaajaaaa	TRUE
deekccmfgblaaaaaaaa	TRUE
dpgbhienmdgaaaaaaaa	TRUE
dpiaoconkajaaaaaaaa	TRUE
eiomhcjlbinaaaaaaaa	TRUE
eipjbbhnbipaaaaaaaa	TRUE
feijdambblkaaaaaaaa	TRUE
fejblfifplkaaaaaaaa	TRUE
fojgbjnajipaaaaaaaa	TRUE
fojghmhdmjiaaaaaaaa	TRUE
gidpdplbdbhaaaaaaaa	TRUE
giemjomnhmoaaaaaaaa	TRUE
hcfepebpkmpaaaaaaaa	TRUE
hcfkboognhjaaaaaaaa	TRUE
hlpaibofeljaaaaaaaa	TRUE
hmaofbkjccoaaaaaaaa	TRUE
ifigpiemeomaaaaaaaa	TRUE
iflnpkjhkffaaaaaaaa	TRUE
jabkiakpdfbaaaaaaaa	TRUE
jackahemainaaaaaaaa	TRUE
jkpfaahhheoaaaaaaaa	TRUE
jlagafmophdaaaaaaaa	TRUE
kfennghfdceaaaaaaaa	TRUE
kffddlidpoaaaalaaaa	TRUE
lalnnlpmplnaaaaaaaa	TRUE
lapcheecodkaaaaaaaa	TRUE
lknjlejalbjaaaaaaaa	TRUE
lkokaoncmheaaaaaaaa	TRUE
mfgaekcgaajaaaaaaaa	TRUE
mfggmbpjpgcaaaaaaaa	TRUE
moahmggdkfdaaaaaaaa	TRUE
mobjlhfkjgnaaaaaaaa	TRUE
niejmdblpfjaaaaaaaa	TRUE
nienlhcdfmbaaaaaaaa	TRUE
ocfdfnmcpcoaaaaaaaa	TRUE
ocfefpbccohaaaaaaaa	TRUE
ololpiegpdnaaaaaaaa	TRUE
olpkhadhpboaaaaaaaa	TRUE
pfdjoglmbloaaaaaaaa	TRUE
pffjepafelgaaaaaaaa	TRUE
aaacgaoimgnjnikkgkb	FALSE
aaahkgpclnnabcmlkbl	FALSE
akcjieijojgbdefdlal	FALSE
akdfacfkoilippoenci	FALSE
becgaapbhnpcmllbloc	FALSE
beddlaebkkpfpaibfac	FALSE
bomccmmfmgmmbbahmok	FALSE
bomhjlikonbiglkbgjm	FALSE
chmnkkdcmecdnbgnmil	FALSE
chncojamohafjifmhaa	FALSE
dcegjmdgoeemkkipeeo	FALSE
dcgeidpimbhflhdofdf	FALSE
dngibelieclnabhcjol	FALSE
dngmpmnpebjoapmckad	FALSE
eggddalcfcmpeicghmk	FALSE
eggdnfgclgphoibbinb	FALSE
famogjccbgmlackogdm	FALSE
fanobemjkcbjgocpkff	FALSE
fledjfcoikaanfjkdcg	FALSE
flemjigfnjdjoilppno	FALSE
gghfkdaahignnmopgcj	FALSE
ggjeebiecpjogdeoiep	FALSE
hapllppjjdgflhkdofo	FALSE
happpnnmndcojncikjp	FALSE
hljogmpiaehgjkhacal	FALSE
hlldkmhjkgihfkegfjf	FALSE
ifbohnhijkjikhmdfli	FALSE
ifcefoipckbofghgejc	FALSE
ipnnljnogancdahcaei	FALSE
ipoagipiboeakkiebml	FALSE
jipfaojodmlnplhpdab	FALSE
jipgfahienfeiibabld	FALSE
kcodoblabnbhkoodbfd	FALSE
kcpeaohjcgickfeileb	FALSE
knhhnglljghcefcngnl	FALSE
knjhgeeipjdemmcckmm	FALSE
liegpcchdmlhnifoecg	FALSE
ligcohaaphbocdibegc	FALSE
mddfchkibaifiiibgin	FALSE
mdefeomhklfibdbkgcj	FALSE
mmhomfjnlpokmcmemab	FALSE
mmiphmoinnpojafjoje	FALSE
nfpfnmjegmleneciolj	FALSE
nfpphhjcngcmbbjiacg	FALSE
obamegmcchabalmflaj	FALSE
obancifodafilgkagll	FALSE
oknboidbebgbjhghljf	FALSE
oknikggbbphffjkcibp	FALSE
pfhifheddmdlellgbpb	FALSE
pfhnfpomaoagnfjhkgi	FALSE
