aaaddeihaa	TRUE
aaahhbnoaa	TRUE
akijcdaaaa	TRUE
akipmeaaaa	TRUE
bdlnpkaaaa	TRUE
bdnodbaaaa	TRUE
bnbjlgaaaa	TRUE
bncdnmaaaa	TRUE
cidodcaaaa	TRUE
cidojgaaaa	TRUE
dcdlfgaaaa	TRUE
dchjclaaaa	TRUE
dlpncjaaaa	TRUE
dmadgaacaa	TRUE
efkngjaaaa	TRUE
efldpiaaaa	TRUE
epfdpcaaaa	TRUE
epfpfoaaaa	TRUE
fjephkaaaa	TRUE
fjiehdaaaa	TRUE
gdipkkaaaa	TRUE
gdipmfaaaa	TRUE
gpcadkaaaa	TRUE
gpdkeaaiaa	TRUE
hjlblbaaaa	TRUE
hjnpfgaaaa	TRUE
iepbiaajaa	TRUE
ifdneiaaaa	TRUE
ipflbiaaaa	TRUE
ipghhnaaaa	TRUE
jjnhepaaaa	TRUE
jjnkgeaaaa	TRUE
kdipbaanaa	TRUE
kdjdjaadaa	TRUE
knieckaaaa	TRUE
knijilaaaa	TRUE
lhjlniaaaa	TRUE
lhkcbbaaaa	TRUE
mbfdghaaaa	TRUE
mbghkcaaaa	TRUE
mlmakpaaaa	TRUE
mlpcdnaaaa	TRUE
ngefigaaaa	TRUE
ngfpodaaaa	TRUE
oaicoeaaaa	TRUE
oajhkfaaaa	TRUE
okpkjnaaaa	TRUE
okpnabaaaa	TRUE
pelklgaaaa	TRUE
pembdaaeaa	TRUE
aaaddeihhb	FALSE
aaahnoblam	FALSE
akihgncioe	FALSE
akjfoiheem	FALSE
bdlbfcknpj	FALSE
bdldeanbbb	FALSE
bmnjfmekkb	FALSE
bmojidjidp	FALSE
chnlnfpili	FALSE
chohkfccod	FALSE
dccoaidmkk	FALSE
dccppdfgeg	FALSE
dlodldonlj	FALSE
dlpiepdafn	FALSE
efecofjgad	FALSE
efejfgheci	FALSE
epbgaimmdp	FALSE
epbkjnmpgh	FALSE
fjpaopgnaf	FALSE
fkbegkeolf	FALSE
gedofgaakk	FALSE
gefdijkccm	FALSE
gopdfclgko	FALSE
goppjmgffn	FALSE
hjmhncdpfc	FALSE
hjoaofcloo	FALSE
ieghohogol	FALSE
iehjlfepmd	FALSE
ipeincmnnc	FALSE
ipfkbliedk	FALSE
jjkobgmlai	FALSE
jjlchlapla	FALSE
kdngodonil	FALSE
kdpcehfppo	FALSE
knnkaoiojf	FALSE
knnooahfah	FALSE
lhopmfocgh	FALSE
libaggbgop	FALSE
mbfmfenlic	FALSE
mbfogopalm	FALSE
mmdfjgoahg	FALSE
mmealmghdd	FALSE
nfdijiljoh	FALSE
nfdjgophap	FALSE
oaieegjhdg	FALSE
oaimkonamm	FALSE
okpinkbgci	FALSE
olaeienfod	FALSE
peobjmieek	FALSE
peobllfplo	FALSE
aaaoeambcaa	TRUE
aaddmebojaa	TRUE
alemmhpaaaa	TRUE
alfjpmoaaaa	TRUE
bemnkanaaaa	TRUE
bempfemaaaa	TRUE
bpadilkaaaa	TRUE
bpafbefaaaa	TRUE
chndbkdaaaa	TRUE
chnlfnjaaaa	TRUE
dbpodnoaaaa	TRUE
dcamoggaaaa	TRUE
dmdoffhaaaa	TRUE
dmeihbdaaaa	TRUE
egbgilaahaa	TRUE
egbhhpfaaaa	TRUE
faehdcnaaaa	TRUE
fafkkldaaaa	TRUE
fkemjkiaaaa	TRUE
fkfcmfcaaaa	TRUE
gdnjnbcaaaa	TRUE
gdnoaioaaaa	TRUE
gpefkbjaaaa	TRUE
gpejicdaaaa	TRUE
hjgglbnaaaa	TRUE
hjjcmkoaaaa	TRUE
idojhmgaaaa	TRUE
idpjedpaaaa	TRUE
iofidncaaaa	TRUE
iogkadkaaaa	TRUE
jkcbielaaaa	TRUE
jkeoiaiaaaa	TRUE
keehkcoaaaa	TRUE
kefcffcaaaa	TRUE
koneejeaaaa	TRUE
konmjgiaaaa	TRUE
ljnajjcaaaa	TRUE
ljnfnicaaaa	TRUE
mdomccmaaaa	TRUE
mealdnkaaaa	TRUE
mnobhdpaaaa	TRUE
mnomnkeaaaa	TRUE
ngmedffaaaa	TRUE
ngmefdmaaaa	TRUE
oahnlnpaaaa	TRUE
oaldceeaaaa	TRUE
olkafimaaaa	TRUE
olkhmngaaaa	TRUE
pgficehaaaa	TRUE
pggnbpfaaaa	TRUE
aaaoeambcdm	FALSE
aadebojhhii	FALSE
algoonpabop	FALSE
algpefdchaj	FALSE
beocgecmpoc	FALSE
beofjpnhgnh	FALSE
boagdnackme	FALSE
boaomelgamb	FALSE
ciekihfkpbi	FALSE
cifhjcnddni	FALSE
dcfikcnhfkn	FALSE
dcfjkkhfgop	FALSE
dlknllekfbo	FALSE
dlldeoafiol	FALSE
eggfocoeabo	FALSE
eghbpaciefk	FALSE
fabjdkofapp	FALSE
fabpedlhebf	FALSE
fkfaciconhm	FALSE
fkfiehhnajm	FALSE
gelmgmkmljp	FALSE
genhoblgbip	FALSE
gpekalahdnn	FALSE
gpfacoffofa	FALSE
hjdmdboidli	FALSE
hjdpifokpep	FALSE
idlppkmnoen	FALSE
idmbceblmoi	FALSE
iogoahokjhe	FALSE
ioiepaokicn	FALSE
jjdknpmlmng	FALSE
jjdpdpjmaej	FALSE
keegpdhondc	FALSE
keejdcnliea	FALSE
kojljkcllof	FALSE
kolplpjmejc	FALSE
ljmmmpoamli	FALSE
ljoffpdgnfc	FALSE
mdjhcbemand	FALSE
mdjkjldnkjh	FALSE
mnlmomadgkh	FALSE
mnmfdlkjmep	FALSE
nghmgchbdfg	FALSE
ngikcfhlege	FALSE
oajefngijpk	FALSE
oakgejnhhgl	FALSE
ollholbdmbp	FALSE
ollmaplgcbi	FALSE
pgemnakmfoa	FALSE
pgeohcpbfpb	FALSE
aaaehmpfihaa	TRUE
aaaohepojiaa	TRUE
ajodcpanaaaa	TRUE
ajohokocaaaa	TRUE
bdgiioaiaaaa	TRUE
bdgkkpfhaaaa	TRUE
bojekgmeaaaa	TRUE
bojeogffaaaa	TRUE
cibgjdnpaaaa	TRUE
cibmkomlaaaa	TRUE
ddodgflpaaaa	TRUE
ddopjidnaaaa	TRUE
dodkknneaaaa	TRUE
doefknmlaaaa	TRUE
einaibmaaeaa	TRUE
eincikegaaaa	TRUE
fdblafdiaaaa	TRUE
fddcohohaaaa	TRUE
fnkhacojaaaa	TRUE
fnkpnngaalaa	TRUE
ghibejgiaaaa	TRUE
ghiepjmbaaaa	TRUE
hapcpnalaaaa	TRUE
hapldmafaaaa	TRUE
hlkokppbaaaa	TRUE
hllcdmncaaaa	TRUE
igonbpjnaaaa	TRUE
igpchjaeaaaa	TRUE
jagbicaamnaa	TRUE
jahagbbcaaaa	TRUE
jkijmfmbaaaa	TRUE
jkjjeleeaaaa	TRUE
kfjjhomnaaaa	TRUE
kfkibgclaaaa	TRUE
kpkchpccaaaa	TRUE
kpkfafboaaaa	TRUE
liommjeiaaaa	TRUE
ljcclooaadaa	TRUE
mdepcofeaaaa	TRUE
mdfpchnbaaaa	TRUE
mmlhfbdeaaaa	TRUE
mmliofjjaaaa	TRUE
nfmffiihaaaa	TRUE
nfmgoemaagaa	TRUE
oanddjcmaaaa	TRUE
oanigfbkaaaa	TRUE
olgcldeaaaaj	TRUE
olggjedjaaaa	TRUE
pfiplbaabaac	TRUE
pfjlaamefhaa	TRUE
aaaehmpfihhe	FALSE
aaaopojinpln	FALSE
ajmongdoemeh	FALSE
ajnlfjagalcj	FALSE
bdnggbofnalo	FALSE
bdpfdgglfgdo	FALSE
bobcaflkbjjn	FALSE
boccfaiokpll	FALSE
cjaliihapngp	FALSE
cjbkfifnnlpp	FALSE
ddkfpembcjpg	FALSE
ddkhahebdejm	FALSE
dnonfcpidmfj	FALSE
dnpbfhjgfemh	FALSE
eicoakkgkcip	FALSE
eigbhkkaceon	FALSE
fdblkkekbjid	FALSE
fddfffhpacog	FALSE
fnhkooapmcll	FALSE
fnijenhjbiff	FALSE
ghpijhbkiomh	FALSE
ghppjpjlakle	FALSE
hbddanajadfn	FALSE
hbfmlnnaggce	FALSE
hldbpaiohlae	FALSE
hldfhjmokmig	FALSE
igglgibodnpa	FALSE
iggpklpgkjgd	FALSE
jaeikanfcclj	FALSE
jafdhpofjnbi	FALSE
jkpcmdnoeima	FALSE
jkpklbgmjpmi	FALSE
kfcejnjngjba	FALSE
kfdbccageckm	FALSE
kphgelcafoeb	FALSE
kpibjhdhbmef	FALSE
lioagoemlfdi	FALSE
lipceejahmgh	FALSE
mdailgbgodod	FALSE
mdamhopngnpm	FALSE
mnjiadbpbmlo	FALSE
mnjnhibdjejj	FALSE
ngnnfcjjcmfj	FALSE
ngofflgeadhp	FALSE
obakbanmljfc	FALSE
obcjbobkfoko	FALSE
olgcjmcjgjfe	FALSE
olgpiggklmio	FALSE
pfhfnheanbki	FALSE
pfhimngpmmfm	FALSE
aaaehmpfihhaa	TRUE
aaaoepojinpaa	TRUE
ajnhkkpnjaaaa	TRUE
ajnijgfddaaaa	TRUE
bdjeoklnoaaaa	TRUE
bdjfgaiphaaaa	TRUE
bnljomncnaaaa	TRUE
bnllfkmgmaaaa	TRUE
cjalllaepaaaa	TRUE
cjbddginaapaa	TRUE
ddpijmlbgaaaa	TRUE
ddpjeapkeaaaa	TRUE
doafhkebpaaaa	TRUE
doallogonaaaa	TRUE
ehmknfekfaaaa	TRUE
ehmockbmkaaaa	TRUE
fdaciecjgaaaa	TRUE
fdaighaioaaaa	TRUE
fmlcnmkkhaaaa	TRUE
fmlilmmidaaaa	TRUE
ghmjnnehlaaaa	TRUE
ghnihfehdaaaa	TRUE
hbopejffmaaaa	TRUE
hcadobedaalaa	TRUE
hlognpjneaaaa	TRUE
hloohpalkaaaa	TRUE
igkaffafnaaaa	TRUE
igkhmofbmaaaa	TRUE
jaeiajgjlaaaa	TRUE
jafalfekhaaaa	TRUE
jkfoncdohaaaa	TRUE
jkgapdjemaaaa	TRUE
kfbcjpocdaaaa	TRUE
kfdgcihcmaaaa	TRUE
kpkegilkfaaaa	TRUE
kpkhbjgnnaaaa	TRUE
ljgaegdbnaaaa	TRUE
ljhihoimcaaaa	TRUE
mdchflkpnaaaa	TRUE
mdclklillaaaa	TRUE
mmomfknacaaaa	TRUE
mnabfdioeaaaa	TRUE
ngpppnbgpaaaa	TRUE
nhbheeajgaaaa	TRUE
oakojjagfaaaa	TRUE
oakpkhomlaaaa	TRUE
okkieocpfaaaa	TRUE
okmncmoekaaaa	TRUE
pfkfiinapaaaa	TRUE
pflhhmkfiaaaa	TRUE
aaaeddhgkonfh	FALSE
aabnmbkjbngpc	FALSE
ajjbjdcnggejj	FALSE
ajkkffafjjolj	FALSE
beejopkjchijj	FALSE
befgeebblclij	FALSE
boogkfmjbjbfh	FALSE
bpaleighfbjkc	FALSE
cilbjgdfblopo	FALSE
cilhdnnoffmed	FALSE
dcccmcfbdgbpf	FALSE
dcclhbglnmnop	FALSE
dlpaeedjfgffd	FALSE
dlpjngbohahma	FALSE
eflflgchepbjp	FALSE
eflhnkanjjaba	FALSE
faapocpaacgaa	FALSE
fabamahomohkh	FALSE
fjhjcjebpkjke	FALSE
fjhlchbjgehif	FALSE
gdikfdgmopjfm	FALSE
gdjfnajedgcmj	FALSE
goiiohmjcdchm	FALSE
gojidnfmmhoae	FALSE
hkafiifnaapdk	FALSE
hkahoadhpmddp	FALSE
iehmbcmokoejk	FALSE
ielabmkcjchkh	FALSE
ippjkmadnkdga	FALSE
jaacfphkfjefg	FALSE
jkgbenanijbpl	FALSE
jkgbnobjlpbpo	FALSE
kfilnmjohnnan	FALSE
kfkjlifbklhok	FALSE
kpbhgnmolebgm	FALSE
kpbnmaplhjcbb	FALSE
liokbpdpflmjp	FALSE
lipfmccjcnkln	FALSE
mddlfigpgbmia	FALSE
mddpkjjnomcjf	FALSE
mnfgdibmekjai	FALSE
mngofgmocefbm	FALSE
ngnomnhoopemk	FALSE
ngnoohkngllmn	FALSE
obkoobcmmapjn	FALSE
obmaekhpmillj	FALSE
olokpnjddgpkj	FALSE
olpdnkedgihji	FALSE
pgemlndcceecm	FALSE
pgeopkilaghhg	FALSE
aaaeddhgkonfaa	TRUE
aabhnmbkjbngaa	TRUE
ajghembkelaaaa	TRUE
ajheejpjhkaaaa	TRUE
beecofingjaaaa	TRUE
beehbecjecaaaa	TRUE
boplbpanckaaaa	TRUE
bpbgmmfecgaaaa	TRUE
cjifpghhflaaaa	TRUE
cjiigcdaemaaaa	TRUE
dcpkpicnfeaaaa	TRUE
ddblhgkbceaaaa	TRUE
dmfpgcfdmfaaaa	TRUE
dmgahiffeoaaaa	TRUE
efinepfnbkaaaa	TRUE
efkageeaicaaaa	TRUE
faddohbbdlaaaa	TRUE
faenmaohddaaaa	TRUE
fjdjniejhhaaaa	TRUE
fjefdeladfaaaa	TRUE
gebpdddmpnaaaa	TRUE
gecanpiddaajaa	TRUE
gomfmcnmfdaaaa	TRUE
gomldchkheaaaa	TRUE
hjpfdgcajaamaa	TRUE
hjphmpcnkdaaaa	TRUE
ieibnlmjmfaaaa	TRUE
ieicpklbgiaaaa	TRUE
ipoopamflmaaaa	TRUE
jaapihhfggaeaa	TRUE
jkmmimmadjaaaa	TRUE
jlbejcilenaaaa	TRUE
kenlhfeebhaaaa	TRUE
kenmnhbbnpaaaa	TRUE
kpagdeecehaaaa	TRUE
kpbdbceedbaaaa	TRUE
linemefcloaaaa	TRUE
liolppndfdaaaa	TRUE
mclplbmdfbaaaa	TRUE
mcmajnaephaaaa	TRUE
mnilkbkfccaaaa	TRUE
mnjhlnbmcgaaaa	TRUE
nhocipmgacaaaa	TRUE
niafmlglplaaaa	TRUE
obmknkekpkaaaa	TRUE
obnhpokmbgaaaa	TRUE
olngecpmkgaaaa	TRUE
olnnpaejpnaaaa	TRUE
pfhcabldicaaaa	TRUE
pfhdpllphmaaaa	TRUE
aaacgnjpljjall	FALSE
aaanfkdfflieao	FALSE
ajhdgfgfiffibc	FALSE
ajidmhdbgbbckc	FALSE
bddmhnkjmgnocp	FALSE
bdeindffiojmgm	FALSE
bnmhoecfikeoal	FALSE
bnmnkgfcdknmje	FALSE
cibcfejimnbndo	FALSE
cibopdpjmiljoh	FALSE
dbobebachfcola	FALSE
dbpalopaaaclem	FALSE
dndnbcbbikjjhp	FALSE
dneominjcjfbnf	FALSE
ehphncafdbhhcp	FALSE
eicijdijjfleee	FALSE
fclefhoigplmpc	FALSE
fcllamiabfkfkn	FALSE
fmihamoecilhgk	FALSE
fmimlechkjnjgg	FALSE
ghfemoglmilejl	FALSE
ghhiplhkncmalo	FALSE
hbflomkdkgmlmd	FALSE
hbgapblncekdcn	FALSE
hlfnebjhgaokhp	FALSE
hlhkdobgmlgopp	FALSE
ifhacbjbnmhlgg	FALSE
ifhancecgcjbmk	FALSE
ipnmdjpcdgeknn	FALSE
ippehpfjhefebn	FALSE
jjljkmmckeklcp	FALSE
jjnlmgacpblekc	FALSE
kdoangdhgiheim	FALSE
kdpaogoejkhkmo	FALSE
kndhpgniekbhag	FALSE
knennkmhifnihn	FALSE
liajfliihfdbkp	FALSE
liboaiimklphfg	FALSE
mbncbekgiopblg	FALSE
mbnhkbchnpiclk	FALSE
mlimdhdommefaj	FALSE
mlkikekngjclkl	FALSE
ngbfgfeolbjcje	FALSE
ngcelanacnkigd	FALSE
obbiggbommglab	FALSE
obdagblldmajac	FALSE
oknmelfaabmoii	FALSE
okoocokmhdkjhg	FALSE
pfipbnnapcllig	FALSE
pfjjbnlkpncndj	FALSE
aaacgnjpljjakaa	TRUE
aaanlfkdfflieaa	TRUE
ajhdbikdmnpaaaa	TRUE
ajlbcglbcocaaaa	TRUE
bdaedhkifgbaaaa	TRUE
bdafajgndjiaaaa	TRUE
boedekfjlbpaaaa	TRUE
bofhgedmhnbaaaa	TRUE
chbmnflbeneaaaa	TRUE
chccfbiejbkaaaa	TRUE
dbnppcfaoggaaaa	TRUE
dbpcoadmgehaaaa	TRUE
dnoaceocfaeaaaa	TRUE
dnoiaabmlkeeoaa	TRUE
ehaajccploknbaa	TRUE
ehbjmfmhjbaanaa	TRUE
fckpoopabhhaaaa	TRUE
fclleacbpocaaaa	TRUE
fnhbhhgnbpcaaaa	TRUE
fnibepdpacaafaa	TRUE
ghehklpdijiaaaa	TRUE
ghendelnhdmaaaa	TRUE
hbhepdaeldbaaaa	TRUE
hbiaeponamjaaaa	TRUE
hkgjomlmhlaakaa	TRUE
hkhjfpigepkaaaa	TRUE
iedjgllibclaaaa	TRUE
ieebfdminanaaaa	TRUE
ipkjacnbbdgaaaa	TRUE
ippgccefhbfaaaa	TRUE
jjjikbjmojhaaaa	TRUE
jjlllkfpjfdaaaa	TRUE
kdlalaljfdiaaaa	TRUE
kdlbjnigpajaaaa	TRUE
knjpkjlemdnaaaa	TRUE
knkjcgcgceaanaa	TRUE
limoohlaeijaaaa	TRUE
limpfblffpkaaaa	TRUE
mcikpohcbinaaaa	TRUE
mcjlhmlicdmaaaa	TRUE
mlmlamnhmajaaaa	TRUE
mlphjcpmkilaaaa	TRUE
nfmmjoafccfaaaa	TRUE
nfodjeopelnaaaa	TRUE
oaihocfeodpaaaa	TRUE
oaipecclfdpaaaa	TRUE
ojpkcjgpbefaaaa	TRUE
okaijgaiaafgeaa	TRUE
pfmggegjaibaaaa	TRUE
pfmhgogldnhaaaa	TRUE
aaacbndpdddgime	FALSE
aaaeccinbcdogbf	FALSE
ajnhpaopimggomn	FALSE
ajnllhallemfhof	FALSE
bdjlhiaekpfknpp	FALSE
bdkpbplkfechdno	FALSE
bnkkfkbeljmicff	FALSE
bnkklfodlknbpaj	FALSE
cienghbkpncoccj	FALSE
ciepojpddjhbopg	FALSE
ddalobnbapmhhpm	FALSE
ddanbhncmiijpaa	FALSE
dmnfiijgcojeofk	FALSE
dmohiamncppkjdc	FALSE
egpejjdlplhibkj	FALSE
egpmenkjeplemcd	FALSE
fbghaeolekhllaj	FALSE
fbgkmongfbncoep	FALSE
flhclmjnbnanjfk	FALSE
flhdapdfbepofha	FALSE
geoldijigaemgnl	FALSE
geoocolickamomf	FALSE
gondacffhakojfo	FALSE
gonelialcbclnkk	FALSE
hipfjageaeapegk	FALSE
hipjhiioaahdehk	FALSE
idcijofmgcgajec	FALSE
idgedbdphanidlo	FALSE
ioejocaidbejpad	FALSE
ioekimkapedfbjd	FALSE
jiicpbiajclpall	FALSE
jijnjcdhnimfhgf	FALSE
keafejijbidnpkk	FALSE
keajafjfodjjinh	FALSE
konfbbcfdacjhll	FALSE
koofnpkkncpagei	FALSE
ljlkghlmjokjcaf	FALSE
ljmighcghbgoaoc	FALSE
mdecdpgipfkpklj	FALSE
mdepcfogibbjkga	FALSE
mmnjngdlbfedkdc	FALSE
mmpnpckhgfcpgjc	FALSE
ngppiickaehkffo	FALSE
ngppmifocchfhmh	FALSE
obkgonfaobfbkal	FALSE
oblhhgkcjimgell	FALSE
olpjjakbfccioof	FALSE
omapidjefpnmnhi	FALSE
pgkfcpopneclndl	FALSE
pgkgpcbendfbjmf	FALSE
aaaiknjoegfnkfaa	TRUE
aaaljebbdmhjfkaa	TRUE
alnplaaomnjmaiaa	TRUE
alobbhjcpedpaaaa	TRUE
bgmaccaencmiaaaa	TRUE
bgmcegodkcmnaaaa	TRUE
cbfooajjhihgaaaa	TRUE
cbhffocijlopaaaa	TRUE
clogbeccadjhaaaa	TRUE
clpeohmfhalaaiaa	TRUE
dffpbpboidjaagaa	TRUE
dfglfkkjnibfaaaa	TRUE
dpglojlamjpbaaaa	TRUE
dpgmimglkmbpaaaa	TRUE
ejdocpegimkgaaaa	TRUE
ejdoplkckaobaaaa	TRUE
fccenhfkkpbmaaaa	TRUE
fcdapgcggecmaaaa	TRUE
fmhphabokkapaaaa	TRUE
fmiijifkbfeaanaa	TRUE
ggjdpphlejibaaaa	TRUE
ggjhmapfbjflaaaa	TRUE
hakcjafmohheaaaa	TRUE
halhcgknfdloaaaa	TRUE
hkjocjhchjihaaaa	TRUE
hkkdldpkjljbaaaa	TRUE
idoaooepjhgeaaaa	TRUE
idocflcbdjogaaaa	TRUE
ioclcjghinonaaaa	TRUE
ioddncjlfjfkaaaa	TRUE
jkcgjikcaihiaaaa	TRUE
jkcnnphmmfgaaeaa	TRUE
kecnkgpjfhinaaaa	TRUE
kecpboidloekaaaa	TRUE
kopninhgjdbeaaaa	TRUE
kpamlpokmnnlaaaa	TRUE
ljemceemippbaaaa	TRUE
ljhlliggfghpaaaa	TRUE
mdhhdohfomgdaaaa	TRUE
mdhnclkdpkikaaaa	TRUE
mmciloaphbpfaaaa	TRUE
mmckffbmmjkpaaaa	TRUE
nhafacnakiomaaaa	TRUE
nhaihhgainfcaaaa	TRUE
oapmjefngollaaaa	TRUE
obbbmgpkliehaaaa	TRUE
olcpchclekdaaeaa	TRUE
oldbmhklecdbaaaa	TRUE
pfbfibljohphaaaa	TRUE
pfbjegkchheiaaaa	TRUE
aaaiknjoegfnkfje	FALSE
aaalbbdmhjfkhffm	FALSE
aljakbpikkhbejof	FALSE
alkekleooghfgjan	FALSE
bgadkdjbodhgmadd	FALSE
bgbgajpanbooafhm	FALSE
cbagpndpbegbhfdd	FALSE
cbbpfeoacjpohoff	FALSE
clhgeahkllopmgag	FALSE
cliclgkpanoflkil	FALSE
dfjkfacfmhlickio	FALSE
dfkbndkggacloinm	FALSE
dpemnfgplnkjkaoj	FALSE
dpfjdfdfpcmkkjpm	FALSE
ejckgbndllpfedod	FALSE
ejffdffgjddjkmij	FALSE
fciclbohbofkhgbf	FALSE
fckfkmikenibegoj	FALSE
flnjkkmoiccjegnk	FALSE
floedlhbkejglffp	FALSE
ggbaefbinpcnfmdn	FALSE
ggdfdlcaeplnnpgm	FALSE
hbdgdbikofnpbnme	FALSE
hbdidhebjmogklhj	FALSE
hklldeldabnmdhpn	FALSE
hkmbdallmbjibfam	FALSE
ieokmopbeabbihbj	FALSE
ieologoomhomgdnd	FALSE
iokhkafdfkhliaja	FALSE
iokmhmkhebipfjak	FALSE
jilakkpcfnmbjkfo	FALSE
jimcbplejfkogjml	FALSE
kebnnecjgdcmdnde	FALSE
kednmchojpjmpmaj	FALSE
kobmoaaappoelbjb	FALSE
kocaolbcaciplcak	FALSE
ljgplacihiaddfgf	FALSE
ljhgfimbimocblbh	FALSE
mdpbfjnokkhbnoad	FALSE
mdpcdkpgdellcbjj	FALSE
mnjlgjiahbbhbdnd	FALSE
mnkhenkphoabgaaj	FALSE
ngkbmgfeokgnlcim	FALSE
ngkingeekdpckphg	FALSE
oapfalaefimfdcge	FALSE
obbamadgfanilnid	FALSE
oklgbligenmnjfmf	FALSE
okllggghdjiminod	FALSE
pffcdmodlkckgbap	FALSE
pfgepdambfoipgbk	FALSE
aaaonklfpdjocaoaa	TRUE
aabelcgofjndojiaa	TRUE
akbcfmklbeclnaaaa	TRUE
akbknpdiafgicaaaa	TRUE
bfnfdafnfnkldaaaa	TRUE
bfnhclinnamccaaaa	TRUE
boopomcobanopaaaa	TRUE
bpamfaggodonbaaaa	TRUE
chnilpgndalciaaaa	TRUE
chnpdnnnmeapnaaaa	TRUE
dcljdkmkedcdcaaaa	TRUE
dcllkahgbpkjjaaaa	TRUE
dohpojocenibhaaaa	TRUE
doieolfedgncdaaaa	TRUE
ejgbmklkbjamjaaaa	TRUE
ejgcjhbnfmhkkaaaa	TRUE
fdafeiiglkideaaaa	TRUE
fdbbijidbjhllaaaa	TRUE
fnjljppjgkocpaaaa	TRUE
fnjmalgmigjikaaaa	TRUE
giamkbijmnoifaaaa	TRUE
gicofjcplbhdaabaa	TRUE
hccaahljkfjnjneaa	TRUE
hcenjnpalmfpjaaaa	TRUE
hmghlolnkncjoaaaa	TRUE
hmgmkkhkodmmmaaaa	TRUE
igjkajecmambnaaaa	TRUE
iglcdldagohejaaaa	TRUE
jbfdbjjjjndlpaaaa	TRUE
jbglpmjnhoknmaaaa	TRUE
jlgjfhfmpdkklaaaa	TRUE
jlgoggjkibndkaaaa	TRUE
kggmkkcipipjmaaaa	TRUE
kggoadphagjemaaaa	TRUE
kpapgmfkkmhbdaaaa	TRUE
kpbfoflbkeeblaaaa	TRUE
ljifcepgpnfdoaaaa	TRUE
ljiihacmlclmkaaaa	TRUE
medcmghejdpcpaaaa	TRUE
medhnjkfkdhfcaaaa	TRUE
mnlbjifoamoeeaaaa	TRUE
mnlklbhdcgapjaaaa	TRUE
niomddijchcobaaaa	TRUE
njancdimoncilaaaa	TRUE
obllcdohjajocaaaa	TRUE
obolncngemjgeaaaa	TRUE
olhipkmbojmnlaaaa	TRUE
olhlglaihdkelaaaa	TRUE
pfmnglgkcgbobaaaa	TRUE
pfpnfcmbdanfpaaaa	TRUE
aaahgjhmiobobkcmj	FALSE
aadaigiidacoefkfe	FALSE
akbbljofeapjmaipi	FALSE
akdjbbmoejeemenpd	FALSE
beekdcjieemogdgno	FALSE
befobgchaoiebkkjb	FALSE
bodjgehfdcbngfkof	FALSE
boedgkncigmhpodka	FALSE
ciloeadoebbobcfkf	FALSE
cimdlnalhamghcpfh	FALSE
ddfjgcfkmnplifopc	FALSE
ddheaipmnoajnmkee	FALSE
donmnjgnndnnbmfdj	FALSE
doofppdenjhnicldm	FALSE
ejeokcmoaaodbodcg	FALSE
ejfnblaicfkjoleoe	FALSE
fdjnhhafofmhmdlil	FALSE
fdncaoiaophilfhdp	FALSE
foakfegohamingdon	FALSE
fobpdeokkilhhngop	FALSE
gjbbfajajkchdoege	FALSE
gjbfolbfdbccnnlng	FALSE
hcjcopgdjiophocoi	FALSE
hcjlnffmnppopaaci	FALSE
hmckdeljmdajgfkig	FALSE
hmedamgdmdlbdeoeo	FALSE
ihpjliejgkfkcjgec	FALSE
ihppngedejdgcggik	FALSE
jbjbiblojbiphogli	FALSE
jbjcajpgoegafcnaj	FALSE
jlbnpcnnhhbkdhehp	FALSE
jlbooiloaokipaied	FALSE
kdonicejdopamophl	FALSE
keamdigjlimbjkphb	FALSE
knknmeijenpggpple	FALSE
knlinpncgbepephkm	FALSE
lgpdjnmnofenmojkl	FALSE
lgpejcmcjmjbncgco	FALSE
mackehldlcijfpjdg	FALSE
maehopogmnnbfhcmh	FALSE
mkejahmfddkdmldjh	FALSE
mkgolfcckookkpffe	FALSE
negbmajiecgojibhe	FALSE
neghhjekihlocjiha	FALSE
oaaljigbkdgcelhii	FALSE
oabidafejclojlmji	FALSE
okcmnfdnpgpmepjgk	FALSE
okegfcljbaggldceh	FALSE
pepioagadjjaolfmp	FALSE
pfajhnpiaeobbebil	FALSE
aaahgjhmiobobkcmaa	TRUE
aadjaigiidacoefkaa	TRUE
akanlndooilchnaaaa	TRUE
akbmolimbhaaflhoaa	TRUE
bdbkfojmkcpbjaacaa	TRUE
bdcaakchphkaegfiaa	TRUE
bodalmppbhpknjaaaa	TRUE
bodookagobgagkaaaa	TRUE
cickoknkchkafjaaaa	TRUE
ciedfnmlehgeklaaaa	TRUE
ddldbbalblmjpgaaaa	TRUE
ddlflpdbfgignhaaaa	TRUE
dookeohdfopiieaaaa	TRUE
dopbcmjhmdclolaaaa	TRUE
eigpbafhflpooiaaaa	TRUE
eihkoenackmdgjaaaa	TRUE
fddnpaagdlggdpcmaa	TRUE
fdeblhdmgkmcgdaaaa	TRUE
fnfcffefadpjkdaaaa	TRUE
fnfigebfpnaemaamaa	TRUE
giiddgacbcajnfaaaa	TRUE
giihpjgniahfacaaaa	TRUE
hcmihclpneanlmaaaa	TRUE
hcmjkjhknhalphaaaa	TRUE
hmknfphhcjcpdoaaaa	TRUE
hmlkkkakdmkonkaaaa	TRUE
ihkekchkfahnahaaaa	TRUE
ihknoelbeapghbaaaa	TRUE
jcbdbeffgdciifaaaa	TRUE
jcbngckpemfacaamaa	TRUE
jlglcpapohcichaaaa	TRUE
jlhbnccdkldakaahaa	TRUE
kdpceedilimkkoaaaa	TRUE
kdphejljhminehaaaa	TRUE
knkloeelphmlmdaaaa	TRUE
knmaiclnlplilcaaaa	TRUE
lhdmncpnoogkpbaaaa	TRUE
lhdmoinhoeodmbaaaa	TRUE
mafihgpneoccjfaaaa	TRUE
mahgcopjliedepaaaa	TRUE
mjmncgohnmaibfaaaa	TRUE
mjmnlheecofnihaaaa	TRUE
nfhlnjaiapkkjiaaaa	TRUE
nfialpmojppijdaaaa	TRUE
oacaendhgmmpjdaaaa	TRUE
oacfbknaicnlbkaaaa	TRUE
okpmpnmphkcmoeaaaa	TRUE
olanolmiinkoaoaaaa	TRUE
pfkoemolpcfkpiaaaa	TRUE
pfmdiechiojhjlaaaa	TRUE
aaaphgpoehofikkpog	FALSE
aabieohelanccbcoio	FALSE
alblbaboinjbfbpimb	FALSE
albpofiffbcmcbiokg	FALSE
bfplfjcmmonelafhfa	FALSE
bgbgmhcimjmeepedah	FALSE
cbdfglkljoehofkjki	FALSE
cbdkkcdljfmkpehncc	FALSE
clcffajhpockjlbhdk	FALSE
cldbkpppodefcggkfj	FALSE
dfdccbdlambdnhjnpi	FALSE
dfdncndoejhgdleken	FALSE
dpjhgdfahnkjabgila	FALSE
dpjpdngbhcmpcmpkho	FALSE
ekaanjmbkmmhcpjhmm	FALSE
ekaellhofmcocdnkoj	FALSE
fejjifkiaagidnpako	FALSE
fejnjihboofbdkpljo	FALSE
fpdkhdjolmkdlgldim	FALSE
fpgpjdpkbngdbjmfof	FALSE
gilnbipmofepeodgga	FALSE
gimpkoekcpokfbnjfh	FALSE
hdboflhknnaefgclmk	FALSE
hdcejdiecccfcflpnk	FALSE
hmcagjnncflighgaan	FALSE
hmclceekdahnbieggl	FALSE
ifbhkhlbiedcedigpi	FALSE
ifbkgfejnjjgdiamih	FALSE
jaaihopaeddeidlibi	FALSE
jacolcacjjigiclebh	FALSE
jjingmgjicfnhkkfaj	FALSE
jjjkmnpifgbkgkfolk	FALSE
kdcbbobmemcihpmmeg	FALSE
kdckhaebcfgnopdmhg	FALSE
kmoamebkhdpapgcfok	FALSE
kmomphhmglogpncnde	FALSE
lhlijnoagpdnlhmdaj	FALSE
lhmhimbdcdjgjachgh	FALSE
mccddedffmdgjmcani	FALSE
mcchijeolnnalkhcmd	FALSE
mlmmahncfmcbhjnmgp	FALSE
mlndkianllkigcmmdg	FALSE
ngkdmachhjhijfkhmf	FALSE
ngkmkfnmeknfhmokcp	FALSE
ocbkfgpjnmnmfbbaff	FALSE
ocbkgaodennldopkij	FALSE
omlfclnmcnmipofjfc	FALSE
omlfeblhadgphagbjf	FALSE
pghffgjkhlgppbnmgp	FALSE
pghpiiibmbphnldekf	FALSE
aaacibcmnghnjkahnaa	TRUE
aaaidechkiolpkbdnaa	TRUE
ajcbmkhaihcimelaaaa	TRUE
ajcemddaopnbddlaaaa	TRUE
begjlcgjgebadgkaaaa	TRUE
behdehanojmppnoaaaa	TRUE
bpnegcogmkmgiobaaaa	TRUE
bpomohgkjfaglghaaaa	TRUE
cjikhemcdbjgiemaaaa	TRUE
cjjaaocifpadlamfpaa	TRUE
dcglphoobjbpmpdaaaa	TRUE
dcgoglealdidifhaaaa	TRUE
dmcpibfeoogplllaaaa	TRUE
dmhaaoeaideblhhdjaa	TRUE
efpadpnclkmclmkaaaa	TRUE
egdnocdnmmaniihaaaa	TRUE
epjojniiccfpoleaaaa	TRUE
eplhfplfpndldacaaaa	TRUE
fkflgdiolchlkamaaaa	TRUE
fkgcmgnajcpimpdaaaa	TRUE
gedaigmjeegfnhbaaaa	TRUE
gedcefpnbgaffcmaaaa	TRUE
gondmhbhfknjebnaaaa	TRUE
gongmkgjnjabdlaaaaj	TRUE
hkclanpkhpcaepoaaaa	TRUE
hkeedpidndjjfefaaaa	TRUE
ieciegdciajmlmaajaa	TRUE
iehglhjgdjmldcmaaaa	TRUE
ipfhdchcldgjjpbaaaa	TRUE
ipfidchbillkhhoaaaa	TRUE
jijfoaedkmkkmmjaaaa	TRUE
jikdflcmpcjpgojaaaa	TRUE
kcncogakdaailngbdaa	TRUE
kcnmlngjadoiabdaaaa	TRUE
klfleifjchglbpfaaaa	TRUE
klgngmdamfpgknmaaaa	TRUE
lglipbbnegaaeaepgaa	TRUE
lglkljmmmieklkcaaaa	TRUE
lpoofccphekimkhaaaa	TRUE
maafjofadomblbljgaa	TRUE
mlibgadaanlokdlinaa	TRUE
mljfikhghifgfphaaaa	TRUE
nfpgooicclfkheoaaaa	TRUE
ngandndojlodhcjaaaa	TRUE
oabdleodplpfkcnaaaa	TRUE
oablnanalnfmmjjaaaa	TRUE
oknmelfhdokblepaaaa	TRUE
okofmobhhbcckfhaaaa	TRUE
pgcjpoeodiejjmpaaaa	TRUE
pgcpboeappmdkkeaaaa	TRUE
aabhjbbipahanbmocid	FALSE
aacdoiokpbbfbbbfage	FALSE
akceiiipbhindconimn	FALSE
akdifgedggpchpiekjf	FALSE
bfjflbbaibclfmhoepp	FALSE
bfjfndlckkcbgipimae	FALSE
cahnkegbkakfpaihfoc	FALSE
cahooikaepfonbgfgkf	FALSE
cmcbecehinmilkhbeca	FALSE
cmcbimklcngoekfighg	FALSE
dgnbogjedmdfoabjjkm	FALSE
dgnnkfdeebhcghmachm	FALSE
ebfjphbdihdpeipfapf	FALSE
ebgikdfbboaklhljcde	FALSE
elajojfddpkfmceolfi	FALSE
elbaidpiokhmjkfnnej	FALSE
fgjdeegfihcamfmignd	FALSE
fgkbchglnncjkefjdbo	FALSE
gakfienooobkignegkc	FALSE
gancnidmlgmanbhbgop	FALSE
gkkegmhoidcbifclpjf	FALSE
gkknpgnkdnhafcpjlee	FALSE
hempafgjhgjepdlpnii	FALSE
henbgiaihbggioidfjh	FALSE
hocebbdfpnjecookkel	FALSE
hodeohnifflolebeelp	FALSE
ihhhomlmimlhohidnib	FALSE
ihjeaaimdepboacedcn	FALSE
jcinggmcgepghcmnjlg	FALSE
jcknihdpgibnmodmljg	FALSE
jmgjkhacmcgkjhokfpf	FALSE
jmgmjfcnlpmmflpojpk	FALSE
kfpahahhjocmiphcdfi	FALSE
kgaadihhbkfglbcghfo	FALSE
kpdgdbmheghicnmhado	FALSE
kpdmajjmobfaomokamf	FALSE
ljniaikhnjcphhbcmcd	FALSE
ljodcpemlnccmhmapji	FALSE
mdgbnfohnohmoikcgop	FALSE
mdgnhplidmbdckmmekn	FALSE
mnfljeckobmenfalgcl	FALSE
mngdmkjgmoaechfacmf	FALSE
nifgfgphlpnelfdcmml	FALSE
nigfnppbdcgnjnchfhn	FALSE
ocininfnahljcheniic	FALSE
ocipgjmhdblkgiamemh	FALSE
omkldfglbbkbnocfigf	FALSE
ommaeclalbdbacckfdb	FALSE
pgggaphlnkpjddljmaf	FALSE
pgidpeofikgcopgoicj	FALSE
