aaafffnkbf	TRUE
aabdkkadok	TRUE
ajpoppdklg	TRUE
akbcckfgih	TRUE
bebjjokoah	TRUE
becdgpkkpp	TRUE
bollaicffl	TRUE
bolnmkpgok	TRUE
ciocacfmab	TRUE
cipaackbhp	TRUE
dcdhkagmfh	TRUE
dcdlkpiiap	TRUE
dlpkmofnkc	TRUE
dmagejipif	TRUE
egkggjbclf	TRUE
egmbbgaplm	TRUE
faifhjjajb	TRUE
faiiillgee	TRUE
fkeohkhbmf	TRUE
fkfndakcgl	TRUE
gdphinffgn	TRUE
gebcjccgli	TRUE
gohiicnolm	TRUE
gohjcdigjh	TRUE
himggabcaj	TRUE
himjhklmfn	TRUE
iccnijckao	TRUE
icdpojmfpf	TRUE
imiklmchpb	TRUE
imjfkjhaoj	TRUE
jibnjlaeop	TRUE
jidcfghhhf	TRUE
kbjpppipdg	TRUE
kblandhpdf	TRUE
kmcbheopjp	TRUE
kmdnggbbkn	TRUE
lhhcjhkfjn	TRUE
lhigegpfnk	TRUE
mccjibomdh	TRUE
mcdkendajk	TRUE
mmdjgdnpeg	TRUE
mmeahcnohb	TRUE
nhjnfldcfk	TRUE
nhknonidko	TRUE
objkebdfdp	TRUE
obkcnlglna	TRUE
olpffgpbnd	TRUE
omaghgfclj	TRUE
phbnhlbjjj	TRUE
phbonbgefi	TRUE
aaaeemekop	FALSE
aacmppifaf	FALSE
akhhmcleaf	FALSE
akhkaijcfh	FALSE
bepnniggaa	FALSE
bfafilapcm	FALSE
bpcfjikgaa	FALSE
bpcpppakla	FALSE
chpeokcbaa	FALSE
chplofkapa	FALSE
dcemppdjaa	FALSE
dcfkbnigaa	FALSE
dnbeogedaa	FALSE
dnbfjhglaa	FALSE
eginleegaa	FALSE
egjdnhehaa	FALSE
fbceadegha	FALSE
fbdaloejja	FALSE
fkkciemcaa	FALSE
fkkhmaojma	FALSE
geoakinpfa	FALSE
geoccflcaa	FALSE
gododlckaa	FALSE
godpcdnbaa	FALSE
hibmjogmaa	FALSE
hicclcifaa	FALSE
iciledhhaa	FALSE
icjjomlkaa	FALSE
imlkboghaa	FALSE
imlngdccaa	FALSE
jhkaeokadd	FALSE
jhkdgjfeaa	FALSE
kbgileojaa	FALSE
kbicmcpcaa	FALSE
kmjnkpmiaa	FALSE
kmnkikhgaa	FALSE
lhfajghjda	FALSE
lhfdnfdgaa	FALSE
mblinfhnaa	FALSE
mbmifkhpaa	FALSE
mlodncegaa	FALSE
mlogncddaa	FALSE
ngegfmpnaa	FALSE
ngejhhkkaa	FALSE
obgmjdeaad	FALSE
obgooojmaa	FALSE
omfljefaia	FALSE
omgjejebaa	FALSE
pgcpanacmh	FALSE
pgdkiijeaa	FALSE
aaafffnkbfm	TRUE
aabdkadokjh	TRUE
ajppgmnemab	TRUE
akbhjhaodlk	TRUE
becepaijgib	TRUE
becpfeeoecd	TRUE
bokhmmomlhe	TRUE
bokimabagfe	TRUE
cijkcoajdln	TRUE
cijpnlienma	TRUE
dckgildnpdm	TRUE
dcnfjginnjf	TRUE
dnaeadnpljb	TRUE
dnapndpgoij	TRUE
egefohlpkdl	TRUE
egfgfdbbkne	TRUE
fakmpkdjndm	TRUE
faldhjhgifc	TRUE
fkojgilhdai	TRUE
fkpdnhplhjj	TRUE
geilflholhk	TRUE
gejdnbehiep	TRUE
gocpodaaaeb	TRUE
godlammokde	TRUE
hindjilgimk	TRUE
hioboajojmp	TRUE
icfoapojjpg	TRUE
icfpmhbbenf	TRUE
imppkmmflhd	TRUE
inabjmapjog	TRUE
jgokbineikc	TRUE
jgpdmhnhdja	TRUE
kbnklkknoao	TRUE
kbomgnlhlpe	TRUE
kmpdnoighdj	TRUE
knbdcamhleh	TRUE
lhhajhpaepb	TRUE
lhjkeejncpa	TRUE
mbolbendfgc	TRUE
mcaiggmjndp	TRUE
mmbiehkkgkg	TRUE
mmbmhndapge	TRUE
nghnmnemmad	TRUE
ngipofbbnnj	TRUE
obggpmbkkfl	TRUE
obhajbgibll	TRUE
omakbpifidp	TRUE
ombdnehcedi	TRUE
pgkncfedpka	TRUE
pglkhjkelgi	TRUE
aacmkflacjf	FALSE
aadcgfidiof	FALSE
akoiloejkja	FALSE
akonkpogola	FALSE
bfncemacgga	FALSE
bfnfiaeejla	FALSE
bpdhgkiogaa	FALSE
bpeecnnocaa	FALSE
cionbegllaa	FALSE
cjaofeonkca	FALSE
ddnfpnbfeaa	FALSE
ddnkpldikaa	FALSE
doiaajepepi	FALSE
doiekbojkaa	FALSE
eijpcpgpiaa	FALSE
eikbjjgnama	FALSE
fddhcagkkoa	FALSE
fdfbeafgpda	FALSE
fnlfoknncaa	FALSE
fnmookognaa	FALSE
ghpckoilpaa	FALSE
giamfipgoda	FALSE
hbkmhopinaa	FALSE
hbmpgimnnaa	FALSE
hmkagcncmfa	FALSE
hmkbfimfhaa	FALSE
igbnkhkkdaa	FALSE
igcegemgfaa	FALSE
jaecalckmpl	FALSE
jafdmhnifga	FALSE
jkbjipkonaa	FALSE
jkblhfnimaa	FALSE
kdaljkklfda	FALSE
kdbkjchggaa	FALSE
knecfjfggaa	FALSE
knedckdkpaa	FALSE
lijbncmkkaa	FALSE
limcdmgcfaa	FALSE
mcbeidiolaa	FALSE
mcbplngnfaa	FALSE
mmmknjlnkaa	FALSE
mmnhbapdppa	FALSE
nichehookaa	FALSE
niclndldkaa	FALSE
obpafjjddga	FALSE
obpeemdlpaa	FALSE
olmdapaphjd	FALSE
olmojifbiaa	FALSE
pgbaoigakaf	FALSE
pgbcdeldoaa	FALSE
aabnfhkfcckp	TRUE
aaccbhkjkglj	TRUE
akiadjpnbklm	TRUE
akjbpagdaalk	TRUE
bemgoihffcih	TRUE
benpmjlfdgdc	TRUE
booifihlompm	TRUE
boolfbnkdhbl	TRUE
cjihfkbbhmaf	TRUE
cjlaogifpdme	TRUE
dcibkcnkaalb	TRUE
dckaphbfndli	TRUE
doafcckghafb	TRUE
doapedmefbbb	TRUE
eilgcpcghcff	TRUE
eimfbdajodbm	TRUE
fdkobhigfeao	TRUE
fdlhgjchldmf	TRUE
fnnegmjnpdpl	TRUE
fnofmapecoee	TRUE
ghonafbodano	TRUE
ghpfmojdmolf	TRUE
hbldcjaeiekl	TRUE
hbmpkocpfnmi	TRUE
hldabpgcncgn	TRUE
hldmknpmpoam	TRUE
igkdhpbaejge	TRUE
igkeekogdhlj	TRUE
jaikljmphdbf	TRUE
jakgabienpgg	TRUE
jkcllnjgfkgf	TRUE
jkdebnafobem	TRUE
kdehodddipig	TRUE
kdeichepgeib	TRUE
knfiohedkgch	TRUE
kngnnlnihebj	TRUE
lhlimlbkciaj	TRUE
lhnemnjphjga	TRUE
mcelibecmnio	TRUE
mcgegklbcich	TRUE
mmljaehbhilc	TRUE
mmmfhimmibdl	TRUE
ngieafjmbked	TRUE
ngjngchfjbpb	TRUE
occlkahhhdhi	TRUE
ocdfgjkojogi	TRUE
omfamlhgkikd	TRUE
omfgildlojik	TRUE
pfpjeblhgfco	TRUE
pgajciiaejob	TRUE
aaapgajpopgl	FALSE
aaceodjddlcg	FALSE
akeahdgmcjhc	FALSE
akfcncclgkja	FALSE
bdnehlpienaa	FALSE
bdnjhkklknaa	FALSE
bmefalhkamgh	FALSE
bmfglchakeha	FALSE
cghfcnomfbaa	FALSE
cghjclhnfiaa	FALSE
dafodkcajkjf	FALSE
daglicahjfke	FALSE
dlfblkiogdaa	FALSE
dlfcieafldpa	FALSE
egfmdcfnaiah	FALSE
eggmeicnmkaa	FALSE
fbiihchoeeaa	FALSE
fbiikdemdlaa	FALSE
fmfeohebhoaa	FALSE
fmfnlahdjfla	FALSE
gfphhkobciaa	FALSE
gfpjbpelfeaa	FALSE
gpngmedbmkaa	FALSE
gppdohonkiaa	FALSE
hkffgmbnkkaa	FALSE
hkfohfameean	FALSE
ifikaadfcfla	FALSE
ifinmmhgkcaa	FALSE
ipjmmdocdbaa	FALSE
ipkajnidjkae	FALSE
jkimodokfbaa	FALSE
jkjgfjldegaa	FALSE
kefekbceipaa	FALSE
keganjhfdmla	FALSE
kpjphddfiaha	FALSE
kpljnjnjibaa	FALSE
ljikfkhaiina	FALSE
ljipiemggiaa	FALSE
mdlgcpbejfaa	FALSE
mdlopokmliaa	FALSE
mnobajagmlfo	FALSE
mnoimincjpaa	FALSE
nhenegahcpla	FALSE
nhenpiedbiaa	FALSE
oamomgmpfcka	FALSE
oampclojcpfa	FALSE
olmpnkclpmaa	FALSE
olncghfhhlaa	FALSE
pflkginhihaa	FALSE
pfnafnjjnmfa	FALSE
aaaodndooihcb	TRUE
aabjjkjoobfga	TRUE
ajmpjdeodnloo	TRUE
ajndikgjehnbf	TRUE
bcmocbggddpfp	TRUE
bcoahamekneeb	TRUE
bmbocekgbijpj	TRUE
bmbomnfkbongp	TRUE
cgbjelhlmgpdi	TRUE
cgckaiminlnkg	TRUE
daipkbbhbcaoc	TRUE
dakdekhmpgghg	TRUE
dlknpbkgfafmp	TRUE
dllhpfpmajdph	TRUE
eggcjbgakldpc	TRUE
eghcipkdnkjop	TRUE
fbfloodpdibpd	TRUE
fbhjlcmfnbink	TRUE
fmhalifdmafib	TRUE
fmhamccojjbmi	TRUE
gfkfgchpodpic	TRUE
gflgenjdcbddc	TRUE
gpkaofiifgbha	TRUE
gpnadadfcgibi	TRUE
hkegocdlfefoh	TRUE
hkfbniacfdioj	TRUE
ienhfgggeddlf	TRUE
ienopciipnpki	TRUE
ipmiopmbdjjof	TRUE
ipmjdkgpebiji	TRUE
jjnbohchjlmkd	TRUE
jjnjppiohfbbp	TRUE
kfdimmfejmikk	TRUE
kfdjdigodmame	TRUE
kpkcfinmfgegg	TRUE
kpkhdjgkkdfni	TRUE
ljeeepeloficl	TRUE
ljepenigkecnp	TRUE
menefbldmlomn	TRUE
menkhjkojgock	TRUE
mnleoadgmmdoh	TRUE
mnmajegbadnme	TRUE
nhpchcpjkfgnh	TRUE
nhpnndfiacofb	TRUE
oapeonofgipab	TRUE
obaflapeijfkb	TRUE
oligdhkodbphf	TRUE
olihbaikggelg	TRUE
pfgpjckagjcjf	TRUE
pfibghnmnbdpj	TRUE
aacicndnnigda	FALSE
aaciddnhkphpj	FALSE
ajpddhkgdieea	FALSE
ajpnljkepeeka	FALSE
beaphngkapgak	FALSE
beapmldjpiila	FALSE
bnicmfmhdjeaa	FALSE
bnimmfgjjkiaa	FALSE
chhbgjeldchaa	FALSE
chidbpofopmaa	FALSE
dcoaigonjeoja	FALSE
dcoleeoeaklpa	FALSE
dnodfngnjlgaa	FALSE
dobihomegdnaa	FALSE
eifiponagedia	FALSE
eigacopcnhiia	FALSE
fcaijjpediafk	FALSE
fcbmfjhocaaok	FALSE
flmbgpeodkala	FALSE
flnjncccdjiaa	FALSE
gfhjceccfmcaa	FALSE
gfkffpnkgihaa	FALSE
hagdkjgcndpfa	FALSE
hagffdcohkmoa	FALSE
hjlgejnlbpeaa	FALSE
hjmhfmkeffoaa	FALSE
idnkcljldjgaa	FALSE
idpdoogecilaa	FALSE
iolplmklpdoaa	FALSE
iomeocaodplma	FALSE
jjefnecfcopaa	FALSE
jjfpiidblnjaa	FALSE
kednjamahngjh	FALSE
keeoanpmdolha	FALSE
knlbopleeieaa	FALSE
knmdjfppnicaa	FALSE
lhhpbgaikjeka	FALSE
lhiaefliehgoa	FALSE
mbonglmikaila	FALSE
mbpkmccdpooaa	FALSE
mlfcahalcdjkk	FALSE
mlfnjijahclak	FALSE
nfpdigfgbdnaa	FALSE
ngbanhekihpha	FALSE
oalicjimnnhpa	FALSE
oamaclfffngpc	FALSE
olaiplffalaie	FALSE
olbeopfpaklia	FALSE
pfigfhelikcaa	FALSE
pfjdbldpophaa	FALSE
aabbejgncggklb	TRUE
aabmnkhhhbpcmc	TRUE
ajdggnahmagglb	TRUE
ajfhopeiojecli	TRUE
bdnaikngchiiab	TRUE
bdncndbjecgaoc	TRUE
bniafdkjpmfdhi	TRUE
bnicgdbdpcilnb	TRUE
chfobfnfdnlgic	TRUE
chhdehbkejicpg	TRUE
dcmcheenblhhna	TRUE
dcoicicjonifef	TRUE
docbjgddblbodn	TRUE
dodjhnkkpnnafp	TRUE
eilijopcpkpbji	TRUE
eimbpocohbbnlf	TRUE
fcgmmabdhinbjn	TRUE
fchhbknlhdlhdh	TRUE
flplfbhnakfddm	TRUE
fmabdhkedgbedk	TRUE
ggfmldmmddhokm	TRUE
gggddgpehpiolm	TRUE
habnglbgbkkjbd	TRUE
haddebjglncifb	TRUE
hkboankhaglcob	TRUE
hkeelhjahlacob	TRUE
iemgmapgpdaodb	TRUE
ienbghnlalofhh	TRUE
iohgkjbcgmibpk	TRUE
iokldidjhgbpil	TRUE
jinimlminhhdmi	TRUE
jiobdcmjnecofl	TRUE
kemojanhcipnef	TRUE
kenihoolpefdhn	TRUE
kobnpomkmbahgm	TRUE
kobojdmnbjcpgl	TRUE
lhfehjaihnhmmh	TRUE
lhfienkeikikgm	TRUE
mbmcgfccacnibo	TRUE
mbnbbdogdmopjb	TRUE
mlgpejoneolpkm	TRUE
mlhblkhlfkinhh	TRUE
nfdmmjjlpkabjk	TRUE
nfeicmghpnmgoe	TRUE
oamdkogmnggbna	TRUE
oanlldfpoadalb	TRUE
okcgecjokdmmfg	TRUE
okcmianfhbeefo	TRUE
pfhhjhphpljbjh	TRUE
pfioimipdknoin	TRUE
aaafehjefgepgg	FALSE
aaagjgfpigjhlf	FALSE
akndnpophkmjoa	FALSE
akngedfaocggpa	FALSE
bfpjihakaadgjd	FALSE
bfpmjffmlomeaa	FALSE
bonddnanlamjnl	FALSE
bonhddlfenjdaa	FALSE
cilcdcbnlgghaa	FALSE
cilmcdlglcidaa	FALSE
ddddlebnkmdmaa	FALSE
dddicgcankance	FALSE
dnkgijjbpjkoaa	FALSE
dnkliageipgnag	FALSE
eidhjpmlhamhka	FALSE
eidkmkbkkeeeaa	FALSE
fcogdgakjkhina	FALSE
fcpmafoooknoea	FALSE
fmkdjbcehdmkaa	FALSE
fmkmfhggjfdlaa	FALSE
ghggichbojanda	FALSE
ghgjhllclagoea	FALSE
hakjjhoahnkpof	FALSE
hamjhlflilplad	FALSE
hkechogialccla	FALSE
hkenbekjlmhjaa	FALSE
iekkbmlfonagda	FALSE
ielbhodjohdpaa	FALSE
ipiibpjapnnlca	FALSE
ipjeidnceimpaa	FALSE
jjbfkmdghldgaa	FALSE
jjdjgojaehpgka	FALSE
kcldefekkbdmaa	FALSE
kclnlmekafplla	FALSE
kllbhianfdecha	FALSE
klleimlaccgoca	FALSE
lgemjnmiefjmaa	FALSE
lgemlafcfpanhn	FALSE
mbklmpkccppnaa	FALSE
mbmagogddiflpa	FALSE
mmioejjmelbafa	FALSE
mmjobnkmmnjeaa	FALSE
nfohnlgebapdfa	FALSE
nfpehnknjpddaa	FALSE
oandnihimjnifa	FALSE
oannfiagkeklji	FALSE
ololipgihpfgaa	FALSE
olpalhaacpcpmc	FALSE
pfkihjpcpfjdaa	FALSE
pflnoddcfkkjaa	FALSE
aabajkffmejddkh	TRUE
aabkopdankmfohd	TRUE
alaakfefhpfndab	TRUE
alajnkcdjigmgfb	TRUE
beoakhckijpjhel	TRUE
beofmcahippfomd	TRUE
boimoafjlcfmgpp	TRUE
bojfhlelmelclie	TRUE
cjcjimcokdniknm	TRUE
cjdbcmongiadebf	TRUE
ddekhhbjjfeeagh	TRUE
ddenpconenpbmcf	TRUE
dnigfgobjmlcool	TRUE
dnjaheongbijnmo	TRUE
ehjmkiopanimpfh	TRUE
ehlanmcjelejmpe	TRUE
fchklfangfnjijb	TRUE
fchnfpekabloldp	TRUE
fmgochmpooamiod	TRUE
fmifoflhlmmlfdc	TRUE
ggijbddknlalbik	TRUE
ggjleoigdefifjb	TRUE
halcmaoocndjgbg	TRUE
halnhjmcblpfnjp	TRUE
hjkigmfbgcbdinh	TRUE
hjlacjimdmdalpb	TRUE
iegjiccanccgkbb	TRUE
iehabcahbjinbec	TRUE
ipelgjbmhbcbefp	TRUE
ipfjnheccgbkndh	TRUE
jjogjagmpegfbph	TRUE
jjojgkjbkeaonlj	TRUE
kccloijhlbgldbe	TRUE
kcegifamoakehkb	TRUE
kmdjabdplgadhdp	TRUE
kmfbhphbehhgjdc	TRUE
lhbefajmooiaflb	TRUE
lhcpkckbhkofehb	TRUE
mbkjlbgjcokfiid	TRUE
mblhgfgadgdjaab	TRUE
mmiidegpjfoeddj	TRUE
mmkfbkidciafcbb	TRUE
ngpdjdjcnnleegi	TRUE
nhadhakeeflhhgb	TRUE
obbjojkhnkkhknp	TRUE
obdlocbdjhhaeeh	TRUE
olpnejklboobnmb	TRUE
omaelpgeaopbgeo	TRUE
phbpkdkdnehalhb	TRUE
phcciigpcnklkph	TRUE
aaaimikgmkmmgij	FALSE
aacghcadmiojhhk	FALSE
alhdohidnlkgnea	FALSE
alhhalolgefanok	FALSE
bgihfeanndflpha	FALSE
bgnlkfepjhkeaga	FALSE
cafeohleenagomc	FALSE
cafjmfpfncnigaj	FALSE
cjoeaanamfmdlck	FALSE
cjoiockodefjlaa	FALSE
depclkgcleonnaa	FALSE
depdmfbihphhdaa	FALSE
eacgcmgochpdnoa	FALSE
eaddhoggpdnladl	FALSE
ejihfepngpdafpa	FALSE
ejijpcagpmahaia	FALSE
feglcepamkikjha	FALSE
fehchdipclmboaa	FALSE
fonmoimonlpmeaa	FALSE
fooonnldgppgaja	FALSE
gjnpccelbdmfjaa	FALSE
gkadlnddepcfama	FALSE
heeijfhmogfdlaa	FALSE
heephlpefimpmaa	FALSE
hoeichknelibkaa	FALSE
hoenjgbmmpolpaa	FALSE
ijmbiegifdopnaa	FALSE
ijmkibkjiielpaa	FALSE
jdnddigelfhjeaa	FALSE
jdnihcdjopbnpaa	FALSE
jngmhhkbkochgaa	FALSE
jnhpkahocfkooaa	FALSE
khlhllbggikpeaa	FALSE
khmkffonponemaa	FALSE
lbmendnfmhlkoaa	FALSE
lbmfmiaonigjgna	FALSE
lkpnpjfjafnncpa	FALSE
llbfldkioekkcaa	FALSE
meemhhhkfnanjla	FALSE
mefpkandhpefacn	FALSE
mpedpjgbgofoiaa	FALSE
mpgooignmikieaa	FALSE
niggolhbnaoggja	FALSE
nigjdmnibchomaa	FALSE
obpahhefeadcffh	FALSE
obpjcgkdjcjaiah	FALSE
omdgonjldaejdga	FALSE
omdjfhcbonnkdaa	FALSE
pgocebcflhclgaa	FALSE
pgoeebmhoicmiaa	FALSE
aabafibpaboalkca	TRUE
aabhehmkakmmjanf	TRUE
akacenmgdeoppieb	TRUE
akbpnhjdddophoje	TRUE
bfamffiodjkglmon	TRUE
bfcamakaeoccanfb	TRUE
bpodjemmpliijbin	TRUE
bpokpoejldhjihna	TRUE
ciojhpokgnbbbaee	TRUE
cipbbdkmnfmcbpdk	TRUE
dcjmnhphgkniljpj	TRUE
dclcehegomnocfjo	TRUE
dmhlgnbmkcpghphn	TRUE
dmicbodamjaeofnb	TRUE
egonbjnbcejedlde	TRUE
egpgkjnlefnoceoc	TRUE
fbnkofpgghfmgied	TRUE
fbnpkpkmfnepikhd	TRUE
fncbmhgehnlbacjh	TRUE
fncbohjkepkjjjgb	TRUE
ggaeglgichmnbhpn	TRUE
ggapeoadgfolcljb	TRUE
hbblmbhnjcagnand	TRUE
hbgjecpkcoofcgid	TRUE
hlopoplengmggenh	TRUE
hlpeddhehjeghihm	TRUE
igaljkneghkjgmpg	TRUE
igbfbpmeonihkfnb	TRUE
jbjjmblldaljnocb	TRUE
jbldjkbdkjbgkkgc	TRUE
jmciejpejihlinjk	TRUE
jmefednemnkbbchp	TRUE
kffeecedbiibijfk	TRUE
kffejgbdbjepighb	TRUE
kohepikcfbpecmdn	TRUE
kohifcodnifihpcp	TRUE
ljckejbinjpplbmp	TRUE
ljdmejelefhoaahb	TRUE
mdbfiplddjdjbeko	TRUE
mdbkginbendpjgln	TRUE
mmiccfalmgmihdoj	TRUE
mmjfbdeofeeoahme	TRUE
ngddlkhmcnbphfde	TRUE
ngdfmncipeaileol	TRUE
obiepcjbeccellog	TRUE
obkmbcldcmdhhloj	TRUE
omaopbkjboiidpbe	TRUE
omcjneiepnckdenn	TRUE
pfpplbifagchglpm	TRUE
pgapdccblniilmbp	TRUE
aaaaogcpamhimfkc	FALSE
aaakmjghlolamhmj	FALSE
akfgfklmccclofla	FALSE
akghfnpgeedjdgpa	FALSE
beplmcipnffeiama	FALSE
bfadecokdcncgena	FALSE
bpigeepoaaocfede	FALSE
bpkjpocfpafnjjda	FALSE
cjdlocaokamaemga	FALSE
cjfjgnphmpfmedaa	FALSE
dckphgkniljpjcaa	FALSE
dcleegomnocfjoaa	FALSE
dmfehnlpcdolbkaa	FALSE
dmickclhpcboniaa	FALSE
efpoiihgkeeponaa	FALSE
egbpehjlejkmlgaa	FALSE
fcchjmccpdjekeaa	FALSE
fcdiiopfdbmjnfaa	FALSE
fmgfeplkihmcomaa	FALSE
fmhfoinmineeajoa	FALSE
ggnoepbgejeonoaa	FALSE
ggofnobngogdokaa	FALSE
haminhpkjenkhhca	FALSE
haofljmgdpeoccfa	FALSE
hlmchnmblhikfmaa	FALSE
hlmniejiamggfiea	FALSE
ihhfikclkghghmaa	FALSE
ihhfpeakamncfhon	FALSE
jbnhjcdadamloglk	FALSE
jbohokndmjfcljaa	FALSE
jlcchinbkiggghaa	FALSE
jldahknjaechicpg	FALSE
kfhphfkclihnclaa	FALSE
kfimjhlbfcmgfeaa	FALSE
knlgggpiaodcfmca	FALSE
knlldgkeilfjiaca	FALSE
lifjimfphjaolnfa	FALSE
ligcppagkljaadmo	FALSE
mccccnofmefcjjaa	FALSE
mcdcbnnjohllaika	FALSE
mmngmlhhglfnndaa	FALSE
mmnmdbcadfnaelej	FALSE
ngjehpdgmeccpaea	FALSE
nglcomenlhpfhnaa	FALSE
obdefeojhggolhaa	FALSE
obdhiecmkkafgfoa	FALSE
omceghgobmofodaa	FALSE
omdkfnbcnepmckaa	FALSE
pfgbdpdahnekfain	FALSE
pfhbkegphgjeoiaa	FALSE
aacnonimomjanbkkd	TRUE
aaecadjeicejfhdcb	TRUE
ajkccfejacnabjkhk	TRUE
ajmgimejdppjagaeb	TRUE
bcnkmmfdfhjjhanbb	TRUE
bcobjgafkljfcamhp	TRUE
bnajpgfpfplndenod	TRUE
bnakgmdgdnkenhfpd	TRUE
cgpleekijiibcapip	TRUE
chahokgdgfcmmmnhe	TRUE
dacmplmeajdagfdob	TRUE
dacocbnfgenpnionh	TRUE
dllcainknbfngoefl	TRUE
dlmhhcmnpofhgoign	TRUE
efkbnoflphkjnijgh	TRUE
efkllbnpoliegajpj	TRUE
fapekahbgjdkolclo	TRUE
fbaebhmbfcbcbgenl	TRUE
fkfdlnnffcljedjoh	TRUE
fkgdnhfodfddjhjhh	TRUE
geolidahiblepdkfh	TRUE
gfadpieenleapcfba	TRUE
gomklnjpdglicfkad	TRUE
gonimecbinhbekkeb	TRUE
hkdpjopkkcjgkoacf	TRUE
hkfbhaimppppoenom	TRUE
idkkifaplananofbh	TRUE
idkogmpajcllgkejf	TRUE
ipideginofkjnadif	TRUE
ipipjbnkhbpmpflof	TRUE
jillndjcipoddnihf	TRUE
jimnnjengcehlmohi	TRUE
kdicdfapdfpncmccd	TRUE
kdjbikdbgdpiconjo	TRUE
kljpdadfbklceahci	TRUE
kllcbgcoohjfncpld	TRUE
lhebmafhljckfbjnh	TRUE
lhembkapfghdcmodd	TRUE
mcbheolkjaknofpof	TRUE
mccjpdkngidfigepa	TRUE
mmmnabahnbedgacci	TRUE
mmnaheempjacgmoab	TRUE
nifjhpgbkfhepiiff	TRUE
niiicploclbijlode	TRUE
ocgcjehkicnboapab	TRUE
ocgfdhpncnpjgdcln	TRUE
omokgjkibmaopaoab	TRUE
onbmlndfbebhoacig	TRUE
pgkebljbkdppbppih	TRUE
pgkhgppaomcldjolf	TRUE
aaappgdimnpphehho	FALSE
aaconcenceoedgknp	FALSE
alkchejdnkhglagcn	FALSE
alkgnmpgiijfhejfa	FALSE
bfgpcmndjmkfmooaa	FALSE
bfkhhdkhofmpgghaa	FALSE
bpffphnpidliegeaa	FALSE
bpgmkfhgndahgeela	FALSE
cjnghmdgpmlkoelaa	FALSE
cjoeangimkocoeakm	FALSE
dejjdaaaooddcadfm	FALSE
dekmgpfnlegfmgmaa	FALSE
dofacmhichgnkdoae	FALSE
dofmibejkepagjcac	FALSE
ehlnpeknnkeeocdaa	FALSE
ehmbnlaagddkkcikc	FALSE
fcbgciogapeckenea	FALSE
fcccboocekicikfaa	FALSE
fmdcmionijiamlkda	FALSE
fmdemmacellajeenl	FALSE
ghaadlkhagfejdfef	FALSE
ghaekgoloanpohjfa	FALSE
hbnppgopicikacgea	FALSE
hbpieejjaopojcpma	FALSE
hmjhjcojphedfbgaa	FALSE
hmjlknngjlifpmbaa	FALSE
ifklonlfhhlipioaa	FALSE
ifmdbonhchfodnama	FALSE
ipjlgmeagachcfhjm	FALSE
ipkcmkjfojfdgjdaa	FALSE
jkfopfafjcoodjdka	FALSE
jkichkgllindpioaa	FALSE
kfhmkmackkkddcgia	FALSE
kfmclmdanpkhfnnma	FALSE
kpoaneihffagolncn	FALSE
kpooppldmphckiaga	FALSE
lkjhoccblmgmfadia	FALSE
lklffjnigpobehnaa	FALSE
mdbaflanpaejjkomi	FALSE
mdbeodigmpjldcafa	FALSE
moljnkpapkhfnhoca	FALSE
momkkgmobnnlgeeaa	FALSE
nionoleakghimnmma	FALSE
nipdoikoolmcphgaa	FALSE
oclkgjfgijfgnonaa	FALSE
ocnkjpnkdfkdklhaa	FALSE
omjgpbapcfiflkfma	FALSE
omjpddggaannmemee	FALSE
pgjhfgldflogepnaa	FALSE
pgkfdhbjifoajdppa	FALSE
aaahkdailboeimcngo	TRUE
aacpofchlmoogdggnb	TRUE
akohipegdiebfojdnn	TRUE
aladlfcjbaapdfcdep	TRUE
bepkhcfmhbikihehij	TRUE
bepncfmfgpeaoaeekb	TRUE
bpdfjnekehbffogeon	TRUE
bpedjjgbpjmbkeolml	TRUE
cjkimmncfccjjbggaf	TRUE
cjkpbkgfkmlegpcehk	TRUE
ddnoepiggjobhaipll	TRUE
ddpnlmjpgolgigcldh	TRUE
doaabodijkbacnmaac	TRUE
doafglkjmiojncjpfe	TRUE
eiplamkkpjhccmdanb	TRUE
ejabmhjdhfdjmafbnc	TRUE
fcpcklidfefdncpgkj	TRUE
fcpilkehkbbjdhcnon	TRUE
flpohkjgbdpbefbpah	TRUE
fmagfbhngnnfkiagih	TRUE
ggipbgmfmlcplkldef	TRUE
ggjcojpeaaobjfjfjb	TRUE
hbjpjgmiodcbignffh	TRUE
hblbmeiinpgcmggldn	TRUE
hmekkanmmdnlfkepmn	TRUE
hmgegfeofilbhipfdd	TRUE
igaipcneicoifnkdfe	TRUE
igbhmkomjcpiaffoie	TRUE
ipinhdccjkggofokdf	TRUE
ipjaebddncohhmkomf	TRUE
jkbmnnejaejapkeghb	TRUE
jkcbcknhclidmlgcoe	TRUE
kelfbianhlhjoemjab	TRUE
kelffapjncaehpnobd	TRUE
kpllphpggilmhegkmn	TRUE
kpmjlnkbmkmplgmjoc	TRUE
ljhopkmjgbeddcdead	TRUE
ljibdfnhecchogmgla	TRUE
mehjgdmohbbmbpcoam	TRUE
melkgooifebgchlgeo	TRUE
mojoapiacapekapccb	TRUE
moklalipegbmgbhfce	TRUE
njmghdckfiffokddia	TRUE
njmgndkkbpihbhnpma	TRUE
ocgohbmcnmbboibjpm	TRUE
ocjdldfodnkgeeomoe	TRUE
onehhdjemdobgopnge	TRUE
oneifcjicpjimnojpc	TRUE
pgldlehhedfbbmeoje	TRUE
pgmcheeadfnmpaaonb	TRUE
aaalllhhodellnjgfo	FALSE
aacgenndhekoejkknd	FALSE
ajdcfjgijkdemhekna	FALSE
ajddeeicgfedniaaij	FALSE
bdfnpcplckoakgfooa	FALSE
bdghinameaeheifkhf	FALSE
bmgopieaaijepkapag	FALSE
bmhnchnnjhphpilmaa	FALSE
cgpldiblndjfkgaima	FALSE
cgppomgaekgcgngofa	FALSE
dbahkinkcalnikilmp	FALSE
dbdogoojjcgdnfniaa	FALSE
dldkoolibpocnghcaa	FALSE
dldopmcljffhfmfeaa	FALSE
eghlclpmfbedgkdhaa	FALSE
egkghlgmcckahnggna	FALSE
fadmngmngmkfcoagdk	FALSE
faeffphclndakkipni	FALSE
fkjccleagflooedaki	FALSE
fkkdiebdmadeonffca	FALSE
gdlbjpeappnkafjcdn	FALSE
gdnhfhboehnoknijaa	FALSE
gocjfopchdhoolmfaa	FALSE
goeikjbfagdfaaiaoc	FALSE
hiedhfpmebfeckamha	FALSE
hiflpgdnofkafkjdoa	FALSE
ibnkcjglpclhmpogaa	FALSE
ibnplphaopkoenkoia	FALSE
inciibkemnikfmngaa	FALSE
inddplkdijhaedfjka	FALSE
jgpmainfacminifkhe	FALSE
jhaofjmlkdpnnfndla	FALSE
kbdallpecefgnpopha	FALSE
kbdmldonjkmagcjdka	FALSE
klhndghkjaelaoedmi	FALSE
kliapcfmcdjooafejm	FALSE
lhckgkbnappaeciifn	FALSE
lhdehgfdpggmpihapa	FALSE
mbidemcopfnegckfaa	FALSE
mbjcfnkkgmihakepoa	FALSE
mkpmmejfffdeklnfaa	FALSE
mlakcmahknnifncohg	FALSE
nfjaidhkokhodiadlm	FALSE
nfjcgfoicfkmomodaa	FALSE
npbnhhjcjkfmccmjaa	FALSE
npcgidjdgobofnjnaa	FALSE
okemgcmmdncfcjmgaa	FALSE
okgbpjipfhopanicca	FALSE
pfdefokfckldohliaa	FALSE
pfdolkiolcbckgkgaa	FALSE
aaaaoiiocoildbgffhj	TRUE
aaadcfhppbljahbhadf	TRUE
ajhpjjmlmnhhbnjopjb	TRUE
ajjccfdkkeblaejcbcn	TRUE
befakcnkbapejbdfpom	TRUE
befdgpnnphlpcgdlikj	TRUE
boklkbpgpbhbmhfeapb	TRUE
bolhnlbkioofgbcmfmm	TRUE
cjhkabojkokmeikplbn	TRUE
cjhokafnodmmnnkolni	TRUE
ddmmocknchfgemioadn	TRUE
ddnmggfpagajjbhkdmf	TRUE
dnagdnogbdnhejejlck	TRUE
dnagkdcgpnahjkmnndb	TRUE
egldkdbbkljmajogfma	TRUE
egmfgenfdmodcmkaiog	TRUE
fbffjkhldpobgcglhlf	TRUE
fbgbgieolonilbggifb	TRUE
flmclignpepcohpjohe	TRUE
flnbaidkifgnkmfiknb	TRUE
gggpojabceioffjnmeh	TRUE
ggjapblfeepefoilakd	TRUE
hafgfciopioomcbkmlg	TRUE
hafhcjbjpdiaacmdpke	TRUE
hjninmgpmkjgebnfbne	TRUE
hjocilibooneejogdjb	TRUE
ifdninobkfmlfgkpign	TRUE
ifecddpkfbdijlppeka	TRUE
ipdiodbbjfjimjoiooh	TRUE
ipdmjipbepgopgblmcl	TRUE
jinclloikebjbojfoeb	TRUE
jinoalhfhpiannoonbj	TRUE
kccfhboiahmndkglagb	TRUE
kcdknohkdgocbonnmce	TRUE
klhagfbjiolpnkhfjji	TRUE
klhlekbaengpphnjenk	TRUE
lgdkhljonoiipcmffbh	TRUE
lgedjjaohfhmeikfbhe	TRUE
majjoanlioijnedmeob	TRUE
makamfajdlclenanibj	TRUE
mlidgcaoomciddnfkdo	TRUE
mlkhgimjilbenilgdlk	TRUE
nfignenpipflkikipjg	TRUE
nfilhchiigmkgfnlijd	TRUE
npigofdappgpnanmblc	TRUE
npjniokhbdneacnnppn	TRUE
okkfgncjgmobghalnol	TRUE
oklidpinjibhgifgjnf	TRUE
pfopcncbiafldmbacoe	TRUE
pfpfepgbemcaijkeeil	TRUE
aaaidoidfeejdnkkfap	FALSE
aacaadpdphjiefmhggo	FALSE
alekccjiknjhipdijda	FALSE
alfnpfjejligpceijja	FALSE
bfpmgjfapjmjcdplfla	FALSE
bgcmmiijoidhcahcnoa	FALSE
bokfpgpajkiidpeiipa	FALSE
bokkedomcfkkdjopfaa	FALSE
cinlbdkoahiimjcdfka	FALSE
cioopgnogcgmmljdpaa	FALSE
deecjbgckeegimccmaa	FALSE
deepbmcnhjpoigkflaa	FALSE
doamkcocffofocejfea	FALSE
dochmaekgioilhnnkja	FALSE
ehoohpheppknoclplaa	FALSE
ehopfieehjlhgnmjkaa	FALSE
fbjlpdpahacaflgaakf	FALSE
fbkfghegdchoodiijaa	FALSE
fmnlndmkoakoldcnaje	FALSE
fmnoknejeghjindfgaa	FALSE
gidmclcfibadhloneda	FALSE
gifmplbelphfnmhleaa	FALSE
hcbimlpmimgmdhamiia	FALSE
hccecimfdidlhakhgga	FALSE
hmkdoojlgnelggeeaha	FALSE
hmljmefpiiclmiifnaa	FALSE
ihefkpjeljhdppjgdaa	FALSE
ihflpofhidchfciamoa	FALSE
jbahpdpkimgagkmimdf	FALSE
jbakmckihffeoghopda	FALSE
jkkhajfkgaindklcchh	FALSE
jkkkagednnodplcdcga	FALSE
kebnljmiogenpglclaa	FALSE
keelmmgbagmadlefanj	FALSE
knjlimcmopngafefopa	FALSE
knloflnnhpjojigpoaa	FALSE
lieiocngfgmhgncnhaa	FALSE
lifnghjdgbnkmohoeaa	FALSE
mceanlefkdmemengcja	FALSE
mcekpkklpoinnpfkhaa	FALSE
mlbllonhgoflfggccaa	FALSE
mlbmkicfhmhianahjcd	FALSE
nelaildhgcnoiaojffc	FALSE
nelbgkccplphmldhkaa	FALSE
npfdggagdjeedogcjga	FALSE
npgfkhmcamifhgdacdd	FALSE
okdcjifegkpahhmncla	FALSE
okdnalchcgmcjopdgda	FALSE
pfdbelajjdppipapnpk	FALSE
pfdmajfhfpdemgldifa	FALSE
