aabngjoggb	TRUE
aachlfoabb	TRUE
ajpiniipio	TRUE
ajpjpdgabb	TRUE
bebknkidpk	TRUE
becalclgdh	TRUE
bnkbgpbkfg	TRUE
bnleidclgc	TRUE
cijolpahld	TRUE
cikbifmamk	TRUE
dcmmjaoifb	TRUE
dcodemnabe	TRUE
dneibflolm	TRUE
dnephchnnl	TRUE
eiajdmjnlj	TRUE
eibladeoab	TRUE
fbhmbhclmh	TRUE
fbijkjfdmf	TRUE
flpfeclfle	TRUE
fmbecdeebl	TRUE
gempiopppp	TRUE
geneamggeh	TRUE
hachkghpbf	TRUE
haednilbcd	TRUE
hmebbehhgi	TRUE
hmejpfpaco	TRUE
ifoopkffca	TRUE
igcikandlb	TRUE
ippjofcgoj	TRUE
jaalffkkbb	TRUE
jkchjglcin	TRUE
jkclejpioh	TRUE
kdeloekcdc	TRUE
kdeojcilhf	TRUE
knchjddjgi	TRUE
kndpelgpoh	TRUE
lgpbbkhlcb	TRUE
lhafehodpg	TRUE
mcoknkomeb	TRUE
mcpdcjfjip	TRUE
mmoojdmmbf	TRUE
mnajgglpgp	TRUE
nhgmhehobk	TRUE
nhheinadpb	TRUE
obbnjmcncl	TRUE
obcmppihfg	TRUE
olkelmoghj	TRUE
olkfiilbke	TRUE
pffojfcjmn	TRUE
pfgbiopagk	TRUE
aaaackejhn	FALSE
aacbhonjdp	FALSE
akadcmommm	FALSE
akahphodij	FALSE
bdejeeboaa	FALSE
bdenjkpbaa	FALSE
bnnhkbpkaa	FALSE
bnodbkjbaa	FALSE
cihhkcngaa	FALSE
cihkdchfaa	FALSE
ddbpidemaa	FALSE
ddcepaflpa	FALSE
dnfknhalja	FALSE
dnflbangna	FALSE
ehnjakkfoa	FALSE
ehomgeidaa	FALSE
fcadhpmkea	FALSE
fcadjkgnca	FALSE
flimnnidaa	FALSE
fljeijldaa	FALSE
gfenjmoiaa	FALSE
gffnodndaa	FALSE
goelbeiaea	FALSE
gofcfdjjaa	FALSE
hjelaghnka	FALSE
hjemdogmaa	FALSE
idfjmdeaja	FALSE
idfmkfmeaa	FALSE
innoneadla	FALSE
ioaobcenca	FALSE
jhefpafnka	FALSE
jhfambjiha	FALSE
kcjfhalkba	FALSE
kclnoghmaa	FALSE
kmfkjlpkaa	FALSE
kmgcelmhaa	FALSE
lgnpjjfdaa	FALSE
lgphibioaa	FALSE
mbdcelpama	FALSE
mbdimnkgaa	FALSE
mndfdmjgaa	FALSE
mndnpbddaa	FALSE
nfikfechaa	FALSE
nfildgjbaa	FALSE
oakmioklam	FALSE
oalkdjpbca	FALSE
okjjfddpaa	FALSE
okljnfgcaa	FALSE
peffplhnaa	FALSE
pegjelhnaa	FALSE
aaaackejhbb	TRUE
aacnbgnmicb	TRUE
akbicflojbc	TRUE
akdheomcpjf	TRUE
bdfabbjeano	TRUE
bdfcoeafinc	TRUE
bnkjjkgnhmc	TRUE
bnlhbabmaoj	TRUE
chikamjmocb	TRUE
chikepeolnl	TRUE
ddaopiobdeg	TRUE
ddbegddjikg	TRUE
dnikcacpfjn	TRUE
dnmamafgmbb	TRUE
ehgbadanjhb	TRUE
ehgedmdcgdh	TRUE
fbmmjbddelk	TRUE
fbnpilblkek	TRUE
fljhhagdhji	TRUE
flklfmgafnn	TRUE
geonjilmkop	TRUE
gfabjaejkdb	TRUE
goedaafcibb	TRUE
goedfeabjbl	TRUE
hjambhnlfdd	TRUE
hjamhaeefbb	TRUE
idieongpaic	TRUE
idimkjlpkpm	TRUE
inmmmkaacbb	TRUE
inmojagadbb	TRUE
jiepikajckg	TRUE
jifgllmlkkd	TRUE
kbpgpkjekge	TRUE
kbphehapfkj	TRUE
kmfhepmagnb	TRUE
kmfojcmjhed	TRUE
lghhocbopcc	TRUE
lgihoejahfm	TRUE
mbfbnnmohcp	TRUE
mbfnonallpl	TRUE
mmgbklaimki	TRUE
mmiffdfchnc	TRUE
ngidomphknj	TRUE
ngihnalagbb	TRUE
oaikmicliii	TRUE
oaiodgleabb	TRUE
okgoodbonpf	TRUE
okjdobnkgoh	TRUE
pecbifgfiae	TRUE
pedbflhldia	TRUE
aaaackejhnb	FALSE
aacgnmicohf	FALSE
akcaappeinm	FALSE
akcamnmnnfi	FALSE
bdfmjgdjlaa	FALSE
bdfpebcoeaa	FALSE
bnlckpdmhaa	FALSE
bnlibgndgaa	FALSE
chmeloppnaa	FALSE
chomdpaiica	FALSE
dclebjjafpa	FALSE
dcleecianma	FALSE
dnemjmldiaa	FALSE
dngbfjdpaha	FALSE
ehcmmcdfiaa	FALSE
ehdjnpdpbaa	FALSE
fbfoihlmcaa	FALSE
fbgmnndbnaa	FALSE
flbmjdkfdaa	FALSE
flbmlkibpaa	FALSE
geobealpagi	FALSE
geofphhfpaa	FALSE
gojpkadklia	FALSE
gokhmlkfoaa	FALSE
hjciepcdmaa	FALSE
hjdhbbcmmaa	FALSE
idaojlonica	FALSE
idcolaekmia	FALSE
inplpaflkba	FALSE
iobkdfnkcaa	FALSE
jilhmmpfnaa	FALSE
jimfecohnaa	FALSE
kcdldinknaa	FALSE
kcflfobafia	FALSE
kmfaoajmdkd	FALSE
kmhgfbjmpaa	FALSE
lfmlmamngfa	FALSE
lfmmfohplaa	FALSE
mbjbgidkjaa	FALSE
mbjchbjbkaa	FALSE
mmfdjbifcaa	FALSE
mmhlcfpnlaa	FALSE
ngjllebhjaa	FALSE
ngjnpekndaa	FALSE
oagjgdeanch	FALSE
oagncniphpa	FALSE
okbicfijpaa	FALSE
okcakodkoda	FALSE
pehhknjnala	FALSE
pekagpgfhma	FALSE
aabhnfjnmjob	TRUE
aacaomjbgoib	TRUE
akedfmnlokbe	TRUE
akfddaonpjbb	TRUE
belggnpcihgl	TRUE
benagdkmfgim	TRUE
bpbgcmaejlbn	TRUE
bpbjccjegdpi	TRUE
cjhcpkkhlfmd	TRUE
cjicmjldckmg	TRUE
dcnaopjecboi	TRUE
dcnnbemmodeb	TRUE
dnfgockklhfm	TRUE
dngkagmkgegd	TRUE
ejmlijlakkdi	TRUE
ejndiikacdbi	TRUE
feaigogpndpb	TRUE
febdckmmkokc	TRUE
fofaljblalhb	TRUE
fofecbodabom	TRUE
ghhgljnkofde	TRUE
ghiheblcbohg	TRUE
hcjekpepknko	TRUE
hckmpcfnjfkl	TRUE
hmfecmopjcil	TRUE
hmgdlokbfcdb	TRUE
ignhkfffgcif	TRUE
ignnccpepikb	TRUE
jajadnjimkbb	TRUE
jakomjhhgeik	TRUE
jjhpnghncibf	TRUE
jjiafpkmmdnn	TRUE
kdogcapmjkbn	TRUE
kdoigilfbmoe	TRUE
knepocangghk	TRUE
knhkpcmkfcjn	TRUE
liacomjcnhgn	TRUE
libckogokccp	TRUE
mbnfdmadbejh	TRUE
mbnhgdpnchbg	TRUE
mmagldmijopj	TRUE
mmbdppdcojch	TRUE
nfpkjnoaaebb	TRUE
ngaeopnopjlm	TRUE
oaekioalepbb	TRUE
oaffghmnpboj	TRUE
ojolpimkbpbl	TRUE
ojpahdmpeljh	TRUE
pfpjmomekfga	TRUE
pgaopgelkmfl	TRUE
aabiogkonkpk	FALSE
aacamjbhpjhi	FALSE
akdploohhfha	FALSE
akdpmkhfjgfa	FALSE
bfigafjgkppa	FALSE
bfilahomnhda	FALSE
bpdgfhokogaa	FALSE
bpdjnfnfekaa	FALSE
cjckmcpbieaa	FALSE
cjeejjpikjaa	FALSE
ddgopcpfgbaa	FALSE
ddhdollihiaa	FALSE
dnllhjfcodaa	FALSE
dnlodeflklaa	FALSE
eioecneobfaa	FALSE
eioijhfibpaa	FALSE
feleoikiefaa	FALSE
fenbbmjdnlaa	FALSE
fockfpgldmaa	FALSE
foclmeiaaela	FALSE
gjbdfdphoeaa	FALSE
gjcekigjojaa	FALSE
hciebiphhgaa	FALSE
hcmhipkkpjaa	FALSE
hmpagbckdhfa	FALSE
hndfcdhbpjaa	FALSE
igpocpgibmaa	FALSE
ihbcnbaaehfm	FALSE
jaenpmancimc	FALSE
jagcloapbmfo	FALSE
jjpdkkcegcaa	FALSE
jjpimaieieba	FALSE
kegnhlejogaa	FALSE
kehkcfbmjpaa	FALSE
knmhcfekhcaa	FALSE
knnpphfohkaa	FALSE
lidmkepphoaa	FALSE
lidmpholmiaa	FALSE
mcalmlhckcka	FALSE
mccmghilmiaa	FALSE
mljmamjihjla	FALSE
mljnckdkkjaa	FALSE
nffdmdojfoaa	FALSE
nfgnjhlojoaa	FALSE
oafemlabflgm	FALSE
oajkfbppkkna	FALSE
okpbfhnplfaa	FALSE
okpfdfkncnaa	FALSE
pfabnoiklcia	FALSE
pfbhbkilaano	FALSE
aaaeilmlbhimb	TRUE
aacgpikclljbb	TRUE
aknbimaeijpnb	TRUE
aknnmcjcjobab	TRUE
befchngkhgped	TRUE
befppfbdogfmm	TRUE
bopefnmjgpabi	TRUE
bopjomciheamo	TRUE
cieihjbapdndf	TRUE
ciennfkcoobjb	TRUE
dbnckgdepjngi	TRUE
dboiimdkbdami	TRUE
dloaipiagbnpb	TRUE
dlobfobnocdoe	TRUE
eghdkbfabidbp	TRUE
eghfdbmkjpblo	TRUE
fbmkcjcccmheb	TRUE
fbndphfcoflpj	TRUE
floknpiapogei	TRUE
flolfflnjjagg	TRUE
ggbdclibllhpa	TRUE
ggchmdmlcoaeo	TRUE
hbhjahngbhlmc	TRUE
hbimopamgfiab	TRUE
hlmhfemhnlkmk	TRUE
hlmkkdkejooij	TRUE
iflhgjfnnmoaj	TRUE
ifllfgmbficfm	TRUE
jakhjpnjfhabb	TRUE
jambieggbojla	TRUE
jklpaobfbgkom	TRUE
jklpegepidicj	TRUE
kenjagamejjbb	TRUE
kenoegpeedlog	TRUE
kohigpmncommf	TRUE
kohljbjkcaecp	TRUE
ligionfeccjid	TRUE
ligpnoffohpjh	TRUE
mcapjokfppldd	TRUE
mcchfdjbabblc	TRUE
mmbfaipaajfjb	TRUE
mmchhhfnidklc	TRUE
ngjpmdgellbni	TRUE
ngkjaokckkbnk	TRUE
oanmgcjdnmfid	TRUE
oaojhkncbcmjb	TRUE
olcanhlankkbb	TRUE
olckafginnfie	TRUE
pflgoikigcgjo	TRUE
pfmfdnbdemfkk	TRUE
aaaeilmlbijnh	FALSE
aacnikclljfdf	FALSE
akgpiimhakiia	FALSE
akiabfophnehj	FALSE
begicmobfhaha	FALSE
behpeomojfkaa	FALSE
boonbjojomeaa	FALSE
bpanlgoeaodpk	FALSE
cihmcoobnmkaa	FALSE
ciihfmcpmpkaa	FALSE
dcahpgdiepbpa	FALSE
dcbboalhffena	FALSE
dmoklbfilgoaa	FALSE
dmpdiffhiloaa	FALSE
ehdkghedlcnaa	FALSE
ehecmfjhgkjaa	FALSE
fcfhcajnmgloa	FALSE
fcgfdfjnfheaa	FALSE
fmlkflhfcbeaa	FALSE
fmlokfllkmnaa	FALSE
gghmfagmhekaa	FALSE
ggimdjgdaglba	FALSE
hbhlbanaepcng	FALSE
hbhmjbepgfkaa	FALSE
hldmdijhdfoaa	FALSE
hldpfacndlnca	FALSE
iflnbbhcikbaa	FALSE
iflpjieknifaa	FALSE
japdlfffdglka	FALSE
japgdbnfffeja	FALSE
jldjopclgpiaa	FALSE
jlgjlogdfhhaa	FALSE
kemdikfcekkaa	FALSE
kendlincfajna	FALSE
kobhjfihigmaa	FALSE
kobofcejbgaca	FALSE
lioeedlbjaoha	FALSE
liofkkggmpfaa	FALSE
mchniboknpnaa	FALSE
mciebohobcfaa	FALSE
mmdjlppdjfbaa	FALSE
mmdnpfffiljaa	FALSE
ngpbdljfocfaa	FALSE
ngpdmmenfgjaa	FALSE
oalgljjodogla	FALSE
oallfcnhpkfpa	FALSE
olfbepklgbdaa	FALSE
olgjpjjgoecaa	FALSE
pfnipehnogmaa	FALSE
pfojapmecmkga	FALSE
aaacfhbahmcbkm	TRUE
aaanclpalehnbb	TRUE
akbjdhfgdaahgb	TRUE
akgemjkhopkabb	TRUE
beoggcfhakngbb	TRUE
beolebmopfkofn	TRUE
bokghddnmjndkl	TRUE
bokojpldahnopi	TRUE
cilfjomniolmea	TRUE
cilplicmeegcop	TRUE
ddgoakfmplgoeb	TRUE
ddhghabpepkmhn	TRUE
dnijccbhejkkmc	TRUE
dnjakjjooldebc	TRUE
eifldiefdgmngo	TRUE
eifnjfmkncmomi	TRUE
fccbicnfmmhnph	TRUE
fccioclokbddcm	TRUE
fmfjicjnnobkgh	TRUE
fmggdpmkjfnonc	TRUE
ggninolipajfop	TRUE
ggpilijpollceb	TRUE
hbllnhmdkghhbl	TRUE
hbmclomgnlplnn	TRUE
hljpdomkfefpep	TRUE
hlkkchhkklahid	TRUE
iggpnpngmndcga	TRUE
ighemgnbdikloc	TRUE
jaoneciafekabb	TRUE
japedelaplfhbb	TRUE
jkjiengdmjbppd	TRUE
jklfbmlblhfanj	TRUE
kfmknjcpnanabb	TRUE
kfmlifmemcbepp	TRUE
kpoaidgheddjhp	TRUE
kpogfcajmhcfkk	TRUE
limihgdjkplkbh	TRUE
liocndkddkobne	TRUE
mciojmlbdkfebo	TRUE
mciplkhhogehjm	TRUE
mmdjckoaafecbb	TRUE
mmemhlgkpgmlmg	TRUE
nhbihmecmfpapp	TRUE
nhdfflpdoakihd	TRUE
obcbpdfeollcgg	TRUE
obcjpckdlcoalf	TRUE
olladfljiaacbb	TRUE
ollefmmdmdepdl	TRUE
pfppclmbcnjfeb	TRUE
pgagilnnflhbcc	TRUE
aaacfhbaindcln	FALSE
aaanclpalehnac	FALSE
akbnmaocleojim	FALSE
akcbklciedloan	FALSE
begdkbnfmehmaa	FALSE
begicmdiiamcpa	FALSE
bolkipjhclhpaa	FALSE
bolpcojppbkiaa	FALSE
cjdienejfhhlaa	FALSE
cjdnibdialfmja	FALSE
dddfiajabmajoi	FALSE
dddhomogakefga	FALSE
dndilapdagaekg	FALSE
dnekmeadphaaik	FALSE
eidfkckncgddaa	FALSE
eidiaifgienaea	FALSE
fchgaodigjokia	FALSE
fcjjgmjafjeafo	FALSE
fmmemkphkakpoa	FALSE
fmmhhknnocgkaa	FALSE
ghghdnhacfnkma	FALSE
ghhblfoejbfnaa	FALSE
hblfogidmnjkaa	FALSE
hbllocohhnamma	FALSE
hmapknobheghea	FALSE
hmbchgmcijiaha	FALSE
igdgebhmhoklaa	FALSE
igdlfbpffbbkaa	FALSE
jamhpmbkajakkf	FALSE
jbbbbhlgjlohaa	FALSE
jlopfpmafgaeei	FALSE
jlplgknpgefmaa	FALSE
kflnghagpheaen	FALSE
kfmaifkknddcma	FALSE
kplehpbajoopia	FALSE
kpoaihmipgnaom	FALSE
ljcopdjdfmjpaa	FALSE
ljdgpaljchkgfa	FALSE
mcljojjmedhaoa	FALSE
mclkiofhffcoaa	FALSE
mmojendfjhdnaa	FALSE
mnaanhgjegneob	FALSE
ngknkjkjobalma	FALSE
ngncpmdcpibcaa	FALSE
obmailndodkanf	FALSE
obmipbaaoaplgc	FALSE
olkfiglfnidfaa	FALSE
olkimhimlngfaa	FALSE
pfndmgipajlgha	FALSE
pfonlihomijkaa	FALSE
aaahnmlcikjdhbb	TRUE
aaaneeboenlicdb	TRUE
aklehlfbccjioei	TRUE
akmdbpndgbnlpjf	TRUE
begnhhgngdocnbl	TRUE
behbhcfbcefjjpj	TRUE
bpdfacplgecedhi	TRUE
bpdogbphfpnmhio	TRUE
ckhhiplnomecjfa	TRUE
ckhiieafcimahbb	TRUE
dgbbkcjgnofddib	TRUE
dgchiicnlhbjcfj	TRUE
dphicfpbachcfgl	TRUE
dphjpiecegbopnh	TRUE
eimjkkcmcbeiief	TRUE
eimomgkgpdinbbj	TRUE
fcjabblkmbeimje	TRUE
fcjeeigdoolnajf	TRUE
fmlhbgfkaihacnb	TRUE
fmmfgfpnbkfcakn	TRUE
ghaaebkecookdab	TRUE
ghakihnenphckfh	TRUE
hbgkkooeadfmdho	TRUE
hbhnpaiilcflacb	TRUE
hmlmollclbdnijm	TRUE
hmmbognmnbieaik	TRUE
ihclnipjcinigcf	TRUE
ihdmobpkonjfefl	TRUE
jbhjaoblbjhokio	TRUE
jbicklnpmanchnm	TRUE
jljnenhjflpegeb	TRUE
jljnfoeighkonel	TRUE
kffcndcppabhcig	TRUE
kfhjbfjdjmfamme	TRUE
koicclmdehejini	TRUE
kokofhfaododdig	TRUE
lieeioebfjfclfh	TRUE
lienpbapapbgpfc	TRUE
mbmckedonjhmlbh	TRUE
mbnmempbemcbccb	TRUE
mlcolgggmbahadb	TRUE
mleajmidhjiolbn	TRUE
nfbkedbjldfonag	TRUE
nfblleocdjgngbi	TRUE
oaccieahpogggbb	TRUE
oadfaabjmkijfcb	TRUE
okogmihlbkgjlbi	TRUE
okokfdghpikjihg	TRUE
pfddeccegjoagoc	TRUE
pfdeoncnmpkjplm	TRUE
aaahnmlcikjdhee	FALSE
aaanbpfomjdefeo	FALSE
akkdajjahkccodo	FALSE
aklopeibmejaelp	FALSE
beocnjaomamdfaf	FALSE
beopodjjimknbaa	FALSE
bpbealcocmoohha	FALSE
bpclhfcmodgjoaa	FALSE
cjmjbidbemeiaca	FALSE
cjmkmfpnobfaipa	FALSE
dfkhekgdlifmeaa	FALSE
dfnobjnlkigdmaa	FALSE
dpljdjboodcfoaa	FALSE
dpmcbniamnhglka	FALSE
ejghpjahabiakei	FALSE
ejhboicfpijdlaa	FALSE
fcpfeeibkldnlaa	FALSE
fcplljoeepkljaa	FALSE
fmmlonpfnjapmba	FALSE
fmmmclkfmnchmaa	FALSE
ghchigedmamlpda	FALSE
ghdldladnjlkcpa	FALSE
hbhaficiccnofpa	FALSE
hbhbfklcklohjaa	FALSE
hlopfolpfpfbkaa	FALSE
hlpnniapkcplgca	FALSE
iglhmjlddmoadba	FALSE
igmfamlnmecfopa	FALSE
jbkkggbeaeflhap	FALSE
jbmcfgbcbobnnaa	FALSE
jlpammkclhgiabm	FALSE
jmbaogggkijgica	FALSE
kejindedngfgmaa	FALSE
keklpfemeifmcaa	FALSE
kokbfepoholbbaa	FALSE
kolnjpbkbhooeaa	FALSE
lidhofiidbhegaa	FALSE
lieaodoaombaalm	FALSE
mcalcabndlhjafj	FALSE
mcbgbiklbelmbaa	FALSE
mlcgdfjgebpneaa	FALSE
mlcoafgeegbckma	FALSE
nefekfcolabkeah	FALSE
nefiglhedcicmaa	FALSE
oabkhnlhpldldca	FALSE
oafcchoohcananf	FALSE
okmjhipkdafamfn	FALSE
okndakcihipgfma	FALSE
pfdididglgmliaa	FALSE
pfedhjoncgomoaa	FALSE
aabecafohjenhmcb	TRUE
aacjdobljenlojmb	TRUE
ajpohnnhjmjoklkm	TRUE
akainbadcmiempdb	TRUE
bfbpdidcpclkngag	TRUE
bfcabcpmfabipgfi	TRUE
caehgclfomkaggbb	TRUE
cafjblngpopkkfep	TRUE
ckgbehofdjpegdkd	TRUE
ckgfdaiggmpbmijp	TRUE
deblilombdcocohe	TRUE
dechbhkbgplikgjj	TRUE
dnfgkeomfchmbhln	TRUE
dniaoklbmnphjikg	TRUE
ehmcjfghcdaegabb	TRUE
ehnacomdfebpjmab	TRUE
fbcjfkjichbickci	TRUE
fbclkfnngclcndmm	TRUE
fklfkpjbcijakedd	TRUE
fkllopgcmncgccna	TRUE
ghbfflbkljdoojbe	TRUE
ghbiifbhnolioaab	TRUE
hanggmadoonfcdbb	TRUE
hanjhbdgegabaelo	TRUE
hklnignbkhmfehfc	TRUE
hkmdchodecpnpbae	TRUE
ienmfogodeclldkl	TRUE
iepenfeaadacghbb	TRUE
ipoepodnnohdngoh	TRUE
ippklbanfknabiim	TRUE
jkjagjpbbaincaen	TRUE
jkjghibakcecjlgo	TRUE
kecjfgcebjeofmbk	TRUE
kedbimipobekafdh	TRUE
kndcgbjkdceafmop	TRUE
kndeccbdpabigejc	TRUE
lgnlcnipmdfndpfl	TRUE
lgpebidcolbalgpp	TRUE
mbkpjapjmofbbpof	TRUE
mblckknebbdoehhe	TRUE
mllkmmnhffkgcdej	TRUE
mllljfgedjpdbfje	TRUE
nfkepcbmniepfceb	TRUE
nfmagnagkpidcgbb	TRUE
oamifihohleppmfi	TRUE
oapijfkfcnnadnbb	TRUE
oloeekmjfbbemene	TRUE
ologdcbhoncjdbma	TRUE
pgikckgcehcenilk	TRUE
pgjcdfamiebfpkce	TRUE
aaaagklojedccged	FALSE
aaafhokgmeapcpjk	FALSE
akehcbngiapelfhg	FALSE
akenloomkjnoogea	FALSE
bekgjcagminmhooa	FALSE
bekkfbonkngekpaa	FALSE
bnmmelcakfijcaeo	FALSE
bnoiafejkfigplga	FALSE
chbokjfoiaeddoga	FALSE
chfnfnkdpoonjhaa	FALSE
dbhlhpbjiogompaa	FALSE
dbiknbjcipifliaa	FALSE
dmjnjmcnioljeeaa	FALSE
dmkhfbdlempihdaa	FALSE
eiipmdbnhailalmj	FALSE
eikfjhdocfgdfaca	FALSE
fcifipmpfancjboa	FALSE
fciflebgmlboffaa	FALSE
flldhmcbcepnfnaa	FALSE
flmonfainenbmcpa	FALSE
ghbaodgafgkhdenf	FALSE
ghcinlbplnemekaa	FALSE
hcbdmlbjomibmdaa	FALSE
hcbeicaghmalonfl	FALSE
hljncmhmlebodmaa	FALSE
hlkcfmoohkkbfcaa	FALSE
ieipkibmpifmalga	FALSE
iejcinnhbdnjigaa	FALSE
inocpfjjfikojdaa	FALSE
inpkgbhimpnopdaa	FALSE
jhelnehilgflnmaa	FALSE
jhfnimafocopiajh	FALSE
kbahagkaaccjhghl	FALSE
kbalhodjhlemdlna	FALSE
kmllibcapcnljnea	FALSE
kmmnbcgmipnbccaa	FALSE
lgccegddmhlajjia	FALSE
lgeacopdmjookina	FALSE
lphonjifipaaafcf	FALSE
lpjamnhonabilmdp	FALSE
mkkgbfgeifankjca	FALSE
mkldoeeohcibcnaa	FALSE
nfhhmjbogdfdnoaa	FALSE
nfigpjdbdclebgaa	FALSE
npnfahhgnnaonkdm	FALSE
npognhnngjlognaa	FALSE
okjpiijnjpoibjaa	FALSE
okjplkbmmeajhhda	FALSE
pfihcefecomoebaa	FALSE
pflmlioddidgfeaa	FALSE
aaaagklojedccgebb	TRUE
aaafdhokgmeapcpbb	TRUE
akdhmelhojmcnbnpj	TRUE
akeibmgcjcecajcdb	TRUE
befhhkpdljlmljdpc	TRUE
befpdeelnonggabbh	TRUE
bnhnppdboklpeaamb	TRUE
bnicalgiapeiehhgb	TRUE
chnkgbmjpmdpdpnce	TRUE
chohnapoblnbbdoeg	TRUE
dbjidkjnkhckmoinj	TRUE
dbkdpcphonifohdjl	TRUE
dndacfmgcjalkhibb	TRUE
dndbmhkejibmhikok	TRUE
ehfdmocihlceggjla	TRUE
ehfkofmhfjcifblii	TRUE
fcappdjcdnlbnjgfi	TRUE
fcbfdhicanglbiajd	TRUE
fmjfofjmleeodgddm	TRUE
fmkambkealhbmjlcm	TRUE
gibkocnibefaammfb	TRUE
gibpkgcakboimglga	TRUE
hcikmdgcgffaijabb	TRUE
hcimehmmoaiofdoop	TRUE
hlelknanmlgdjmenl	TRUE
hlgcmaheicabdhllb	TRUE
iejfodkhhofdcndid	TRUE
iellhcoklkmjbjaab	TRUE
iobklmlkkaijollcf	TRUE
ioddjhjebiiechfkd	TRUE
jhmjppkkeodjibikg	TRUE
jhnbonajmliaofjdb	TRUE
kapljdgdmjjdfmjeb	TRUE
kbafcclbaidapbfgl	TRUE
klpehnkebdcppipml	TRUE
kmbbkelldjgohohil	TRUE
lgaehoolakimajjbb	TRUE
lgblkoiihljdgnbgk	TRUE
lpgekapiingjaikbb	TRUE
lphkmjdapnjickngg	TRUE
mkkocobpnjomoeakj	TRUE
mkmlgildoomljhbej	TRUE
nfinfeijciopjpiio	TRUE
nfkdgjaddchgkaobb	TRUE
npokkkdcjmgnjgdcd	TRUE
nponkidlglkehkeob	TRUE
okkafpkkbapdlpmkb	TRUE
okkicbnbcnfkblmgc	TRUE
pegfimldfpeocmpgl	TRUE
peghahffmlkdlnabb	TRUE
aaacbnaahnkmnmejg	FALSE
aaadajiegncmpfofl	FALSE
almejfbclgoagneok	FALSE
alnlppehfpdaafggp	FALSE
bhmempfbpbnfhihaa	FALSE
bhmfkfkkdkbgenfaa	FALSE
cbcflhknfeoahiika	FALSE
cbclmanjlmnmkiola	FALSE
ckcbgflclolgfkoaa	FALSE
ckcnklhdegopkolaa	FALSE
deiphogimhnmkglaa	FALSE
dejedahnpeaklkfnc	FALSE
dpdjobfhoapamdinm	FALSE
dpdmeihmhiehhknaa	FALSE
ejkgbeaoechglfacc	FALSE
ejkoigkddkmlpelaa	FALSE
fdocimpmpoapefgma	FALSE
fdofnpekfmijppafa	FALSE
fpdlhjgibfmjjfhaa	FALSE
fpdnlokammhgcipda	FALSE
gingcmmkolnnbciaa	FALSE
gipnaccgkjlocccka	FALSE
hddikjmepdenmmiaa	FALSE
hdecebpnjbkmibbaa	FALSE
hodhlomdggnjcmaia	FALSE
hofbkapcajjcedplm	FALSE
iiooilbbicjbdnfaa	FALSE
iipgjldlmdbebbmaa	FALSE
jdghkcedchflmfhaa	FALSE
jdgopnfobdmeclfaa	FALSE
joccnlimpnflimama	FALSE
jodbodcpnpjlhdeaa	FALSE
kiidlmklglcmebcaa	FALSE
kiifegnlmcfaofeia	FALSE
lccmhinjadegpkhla	FALSE
lcdcoecpknigfogaa	FALSE
lkiabeilllhacgfog	FALSE
lkjflkblckngohpaa	FALSE
mdgifahelkncapgci	FALSE
mdhglhgknjklpoiaa	FALSE
mnaddoihhlkcbeida	FALSE
mnfbinfnakifkfnja	FALSE
ngngbmbenfiicnama	FALSE
ngoalfbinacedocon	FALSE
obcjiimcmaiofheka	FALSE
obdhpgfgnphgokpaa	FALSE
olkjicdmockgcoana	FALSE
ollgbhkjjbobannna	FALSE
pfmebnonbeojhjfaa	FALSE
pfmgeniiaoikemaoj	FALSE
aaaikhjmnfhankfjbb	TRUE
aackfkjkaijjegicbb	TRUE
aklhkehcjdgecelpbp	TRUE
akodbiahfdbmalkhmi	TRUE
bepikccebojikimfem	TRUE
beppgchehmhnlpoehg	TRUE
bphadommejmafnkgob	TRUE
bphbkeklcjibmbilli	TRUE
cipeijminacnagpkbb	TRUE
cjagcldbafeejpfhgb	TRUE
dcndahgblncgijgihm	TRUE
dcodfmipejodhnaocl	TRUE
dnaebpeopdoklhmhni	TRUE
dnaeeobjjfghoedfeo	TRUE
ehcefgbigjeklhodoc	TRUE
ehchjhokgefcofnggo	TRUE
fbkifdlbojiphcnogj	TRUE
fbndemdknkfaojfjpo	TRUE
flgoodgemjojaijmic	TRUE
flgpdcoocibcbedmgn	TRUE
gepjikjhcdkhindkkm	TRUE
geponbjffmnkadffmn	TRUE
gpdflkgenddhfaflbi	TRUE
gpecgbbklfncbhndbe	TRUE
hjljnldgcacmnlgkne	TRUE
hjmdjdcjpeomjbhchh	TRUE
idenokefceefpaleng	TRUE
ideoflaijkejgadmbb	TRUE
iodhohhelnhidgnkee	TRUE
iodikkdaholbobkgfk	TRUE
jhpmbafhbhefokbhle	TRUE
jiabgecbakncfnglnj	TRUE
kcdcebnoaknpkdjnnk	TRUE
kcfoclmphjaoghignf	TRUE
kojcpgoegfcaobeood	TRUE
kojiphebdfbojhonen	TRUE
lieidenkmlenalnhjd	TRUE
lifdcbdngjadkgkjdd	TRUE
mcddndbaogmdcoblmi	TRUE
mcdijkjjlbebkkfeje	TRUE
mmkmfocpaighpjgijb	TRUE
mmlcncmiaggkcbkcjk	TRUE
ngichcbmgbnijeklmf	TRUE
ngjdfcjkgfkdabfebo	TRUE
obdlbnmlfginioljom	TRUE
obeinghdmilmjgndfb	TRUE
olbinngkjhcigolkim	TRUE
oldlmgmnkfalfgnnpc	TRUE
pgklipiophdfbongek	TRUE
pglggnbimhkoogofdk	TRUE
aaaikhjmnfhankfjko	FALSE
aacfjkaijjegicmahm	FALSE
aknjljkekjmapoelaj	FALSE
akpbindfanjjgidocj	FALSE
beflnalacjgdmcaaji	FALSE
begbhmchkoaigipika	FALSE
bpemdommejmagolhpa	FALSE
bpfkeklcjibmbillaa	FALSE
cindobclmblfkldgaa	FALSE
cinohkmadkaefpdndc	FALSE
dcfknhlcoojbdkjeaa	FALSE
dcfnokhjofjebpcbaa	FALSE
dmghadjahlkokikdlk	FALSE
dmghamkkhmafkccgjj	FALSE
ehdinafhhmcemkibma	FALSE
eheojfjengikddclaa	FALSE
fbfpeheccalheceoma	FALSE
fbgampfjfeojklgkea	FALSE
flkeeoaliggfiaegpc	FALSE
flkjbioackmhnkhfoa	FALSE
gfodpdhnjplbogcaha	FALSE
gfopgneiechpejbbaa	FALSE
gpffjdoceonglpedaa	FALSE
gpfjagaihnbgghpckl	FALSE
hjjgfkbddngalpipla	FALSE
hjjpfigjjkgojgppaa	FALSE
idjpgkjjkeaopnhjda	FALSE
idkjpjfapngojaocmk	FALSE
inconjlkhgjfmjdbaa	FALSE
indjbkggcndjcpfpaa	FALSE
jgobaoeafoofohiden	FALSE
jgofllmcebhcomkcaa	FALSE
kcecbldppcmkdadiia	FALSE
kcemadaanjcmmikdke	FALSE
kogopeldlpmpnhakna	FALSE
koieelmgaomopaffhc	FALSE
ljfcocfkohhfgegpaa	FALSE
ljfeblmgaeepapokjd	FALSE
mckopckkdnlidkeiaa	FALSE
mclbbbkijmgeipocaa	FALSE
mmeffmknodgijcidaa	FALSE
mmfgocdfmbgikjppaa	FALSE
nheajfplhnbpdginna	FALSE
nhebiknggindglegaa	FALSE
obdnagolgaeeohgaej	FALSE
obdoolamhpkejddcla	FALSE
ombmfodojmhnajaoph	FALSE
omcphabpkceihoicaj	FALSE
pgipholepolglnjeaa	FALSE
pglfhjpbciigjgehaa	FALSE
aaagbcidlmpgjkcdkab	TRUE
aacigffnmndopddfdbb	TRUE
aldipkeiljcdabemlgb	TRUE
aldnnhddfejahikjobb	TRUE
bfddellelcgekhpeeme	TRUE
bfdgagdgmopjnhelkop	TRUE
cabhgbofoajiokdfljg	TRUE
cablimkhffpajnijlob	TRUE
cjikmcpmoeabiepmnoo	TRUE
cjjhdiblnhofekpcmbo	TRUE
deeeiblghbpllacckhe	TRUE
deekjcfckcapjkdhkdg	TRUE
dnlhbdhkbkmhlkhidfd	TRUE
dnmacpihoakldkiefbb	TRUE
ehfhpmclnelmlilmadl	TRUE
ehgbbgcfbeplmbahjgn	TRUE
fblkkgijiodpbccphda	TRUE
fbmlcagdcagkhifgkjb	TRUE
fndhkebiobhbnpadbjp	TRUE
fndnkaelakmfahjlfbb	TRUE
ggehimkjbgkjkomjohc	TRUE
ggfagdpkolebfbnbnpd	TRUE
halclpkblgcekemipbf	TRUE
hambmeplieaefjpfghb	TRUE
hkoojpjjkdlbpfdbmeg	TRUE
hkpkfjnankamimpdnbb	TRUE
igbkjndgmdagmdmcdmg	TRUE
igblfdipikbldckbdbj	TRUE
jaajfinfkaffmgbjleb	TRUE
jaaondibpkdofhbpddp	TRUE
jkiblhljmahlhnoofho	TRUE
jkicdfmodhgplblncog	TRUE
kfgbdmficgohmnecino	TRUE
kfhcbfgmjhbphmpjhif	TRUE
kocbdhjbdcejbphheag	TRUE
kocobjllegicnopmibj	TRUE
ljmdcfpomcpgkgddhmb	TRUE
ljnmfpododngfdalfok	TRUE
mebicfmpjhcafpfhfhj	TRUE
mechkilabddkponncch	TRUE
molalgfhhklnnnbonml	TRUE
molhecpfhblmnfldbfp	TRUE
ninjkponeemmmflhhff	TRUE
niogmlaikcnokhnmbkc	TRUE
oecimdbjnanpgoalfcb	TRUE
oecjnhmkfpjhdkbmidn	TRUE
onojkfnkcpekdkppigp	TRUE
onpbjboigimhfedmalf	TRUE
phghhdjcglaojachjbb	TRUE
phhglejijibbalhpfim	TRUE
aaaflbijegkgkcjedoo	FALSE
aacgklgiheodbaleaap	FALSE
akfchmkjmdpkgkckkca	FALSE
akgcjemhbanojjeifjj	FALSE
bfignfhcpiiakfaanhd	FALSE
bfigodacjahpeoecami	FALSE
bpeblehohpjjjifhbaa	FALSE
bpfanakjkomplacdinc	FALSE
cjfglmnjlegfeijmgaa	FALSE
cjgajodkdnlaedidmnh	FALSE
ddmafbaedpdadfaeeka	FALSE
ddmfafjaeehnidopagp	FALSE
dnnejdediffbcgdnhaa	FALSE
dnnggagdamejibfcgak	FALSE
ehdjiildkabhfihnagm	FALSE
ehdpiecbkhahafacehc	FALSE
fchkpilplamfifogema	FALSE
fchmpkacibojmmkhkfa	FALSE
fmbmgbfcfibamikdagf	FALSE
fmcjdgocgfnobmmggaa	FALSE
ggekegjkhfodbfkfala	FALSE
ggffmcnlibgignbcjaa	FALSE
haemifbjmajmghfiojf	FALSE
haihckkfegfefipohba	FALSE
hlllljmogapgfeonioa	FALSE
hlohckdgeiidklafeba	FALSE
iemfihkklphmokefgaa	FALSE
ieoeloglbhclihbgpaa	FALSE
ipcfohdjpiickeoofaa	FALSE
ipchohmpbodfjemfjaa	FALSE
jjhejoldhfkmkoimbaa	FALSE
jjhiialpajkhjgbdfll	FALSE
kekkhpefapcedckbpma	FALSE
kelenkebfecapdkmgia	FALSE
kojadcdcfmedakmnnmi	FALSE
kojafemhpifjopahhpp	FALSE
lioegnocbnkfnnljeaa	FALSE
ljaboolpcildmpaoppj	FALSE
mcghnmgikonilefalka	FALSE
mcginmbeeopjakadndj	FALSE
mmhbnlakadlfaongfpf	FALSE
mmioioklkcnefonhoaa	FALSE
ngbdmnidpobcilhmdaa	FALSE
ngbkpbhjcjfmndbamla	FALSE
oaagkidjpjbhklncofo	FALSE
oadnamedakgpnibhopk	FALSE
ojnknfiooobmjjmhbaa	FALSE
ojnnlbmdnhbcjbkijaa	FALSE
pepfjbkollipopfppaa	FALSE
peppnhcfdpfoceofaba	FALSE
