aaadklbocd	TRUE
aaaikgbdcd	TRUE
ajpbgnkmcd	TRUE
ajpongbkcd	TRUE
bckopifcgn	TRUE
bcljnmldpa	TRUE
bmopcophap	TRUE
bnaellkapk	TRUE
ciamaeoeeh	TRUE
cibbggjcja	TRUE
dcohemgndk	TRUE
ddagfejoip	TRUE
dmdgikakpj	TRUE
dmenafjado	TRUE
egoefgffhi	TRUE
egonlapejc	TRUE
fbpebonmbm	TRUE
fcaobbckdd	TRUE
flpjjgpkdc	TRUE
fmebonjbpn	TRUE
gglhiifdna	TRUE
ggmiddbege	TRUE
hapbbhmjcd	TRUE
hbaagflbcd	TRUE
hkiaohdbcd	TRUE
hkihihacim	TRUE
ifjpakgdno	TRUE
ifmbphagdf	TRUE
jacapakacn	TRUE
jaeconbnld	TRUE
jkimnigock	TRUE
jkjgohbajn	TRUE
kendngjhcn	TRUE
kenkeoffoh	TRUE
kobjklhfpe	TRUE
koblbcjokn	TRUE
libekllnbm	TRUE
liboligfoh	TRUE
mcbmnmmahp	TRUE
mcdafkbfgc	TRUE
mobfbnoapi	TRUE
mobicpfach	TRUE
ngningalgp	TRUE
ngnjdephje	TRUE
obafgjiahd	TRUE
obdhoikejg	TRUE
ojlonopcad	TRUE
ojmokelmlm	TRUE
peoaemmonj	TRUE
peocpngpph	TRUE
aaadklbokg	FALSE
aaaibdinij	FALSE
ajplipmdlb	FALSE
ajpolpijhb	FALSE
bclbjhjfab	FALSE
bcmaecoceb	FALSE
bndgnndiab	FALSE
bndiljboab	FALSE
cheolfpmab	FALSE
chfcmnblab	FALSE
dcgjflccab	FALSE
dcgmnhcgab	FALSE
dmpcpecoab	FALSE
dnbajfjpbb	FALSE
ehhdacppgb	FALSE
ehhkngjeab	FALSE
fbpionffab	FALSE
fbpngjloab	FALSE
fmopdekmab	FALSE
fmpbbkkdab	FALSE
ggannalaob	FALSE
ggbkebjdab	FALSE
hbgfbhkhab	FALSE
hbhfokggab	FALSE
hkkhllldab	FALSE
hknokjpoab	FALSE
ifdioieeab	FALSE
ifedadihpb	FALSE
jaeookebnl	FALSE
jaepmpjaob	FALSE
jkejhghkab	FALSE
jkfefbjaib	FALSE
kejhbpmpab	FALSE
kejijfjbab	FALSE
knkkhkeeab	FALSE
knnpdgaflb	FALSE
licmhoelab	FALSE
lielopdamb	FALSE
mcionpinab	FALSE
mcjffpnjab	FALSE
mnmjcmigab	FALSE
mnnmllbgab	FALSE
nhnjkekfab	FALSE
niacaplcbe	FALSE
obahgpjkeb	FALSE
obangolfnb	FALSE
okebafaajb	FALSE
okelomioab	FALSE
peggdalomb	FALSE
peggjkkkab	FALSE
aaackmlabod	TRUE
aabjhmndhcd	TRUE
aldenhcnldp	TRUE
aldhnaifeml	TRUE
bfcfbkemeod	TRUE
bfebcfekobi	TRUE
cambckjifod	TRUE
caonkolbhgd	TRUE
clebpajcabd	TRUE
clgpgmldpja	TRUE
dfiajlidieh	TRUE
dfidaoiinol	TRUE
dphghkmpokf	TRUE
dphmbcoiame	TRUE
ejknnlhgkge	TRUE
ejleboehnel	TRUE
fenakmhigni	TRUE
fencekldfaa	TRUE
fpjndadfljf	TRUE
fpjoocgebbe	TRUE
gjnpekpfjbm	TRUE
gjoadlijdjo	TRUE
hdjejkcfkbd	TRUE
hdjfhoohglk	TRUE
hmkfajejaoj	TRUE
hmkhpjjggaj	TRUE
iglhjfpjmdh	TRUE
igomgfpclie	TRUE
jbgkabnlocd	TRUE
jbhccmpbgih	TRUE
jlbihomlfaj	TRUE
jlbmlklcipk	TRUE
kfmpeneajfk	TRUE
kfnflclonje	TRUE
kpapcokadhj	TRUE
kpbmammebcd	TRUE
ljalndcleic	TRUE
ljanapdhpoi	TRUE
mcnjcepgjdf	TRUE
mcnjignpppa	TRUE
mofepbpnpha	TRUE
mofhocfpkip	TRUE
nhppjjbgleh	TRUE
niagcjpbfhd	TRUE
obkkpjaognk	TRUE
obkmjcnahmn	TRUE
omoihmeiccc	TRUE
omokejjkoah	TRUE
pgepkdekgce	TRUE
pgfgmjejggg	TRUE
aaaclnmabpk	FALSE
aabhmndhjpp	FALSE
aleaoneoilb	FALSE
aleidcpffib	FALSE
bfdeamgkdbb	FALSE
bfffdkcgjab	FALSE
caiogmkfmbj	FALSE
cajgnhjgnmb	FALSE
ckogchacihb	FALSE
ckolignliab	FALSE
dgbcgljijab	FALSE
dgcgpoghnab	FALSE
dpljokgpeab	FALSE
dpmidehgoab	FALSE
ekkkdhahchb	FALSE
ekljdgobmab	FALSE
fecjkjjlbab	FALSE
feejlkghpab	FALSE
fpkneciobab	FALSE
fplbcomfcab	FALSE
giihphdfiab	FALSE
gijlofgkpab	FALSE
hclmnjknnab	FALSE
hcneflcjfab	FALSE
hnajndebkdk	FALSE
hnbdlpeblab	FALSE
ihonpdlndab	FALSE
ihpahkfpfgb	FALSE
jbfbcceogab	FALSE
jbfebegdeab	FALSE
jldbfhiinab	FALSE
jleegjllmab	FALSE
kenccbfngab	FALSE
kepkpgjpbab	FALSE
kpecaejjkfb	FALSE
kpecojfhfab	FALSE
lilmhhmmkab	FALSE
limcicfpjab	FALSE
mdamigahflb	FALSE
mdbemfojpab	FALSE
moflnokecab	FALSE
mohebohhbab	FALSE
nifnnfeidab	FALSE
nigdliihkab	FALSE
occnclihhab	FALSE
ocfbonhceab	FALSE
omaglipfhgb	FALSE
omahdcjbgkg	FALSE
pgedfkjecab	FALSE
pgegenjamfb	FALSE
aaackmlabojd	TRUE
aabhmndhjpcd	TRUE
alebmfnmhccd	TRUE
alefahfmpcpf	TRUE
bfiilhbbfjhh	TRUE
bfjidfdieojj	TRUE
cadldijdoadp	TRUE
cafnbkkbeabd	TRUE
cknigocjecfi	TRUE
cknoahiajilg	TRUE
deojihophhhp	TRUE
dfafncnaklnp	TRUE
dpinjbnblcle	TRUE
dpkfblbdlcil	TRUE
ekffjmgofiho	TRUE
ekfldmdbocbo	TRUE
ffiiokbmalkp	TRUE
ffjjmgnngado	TRUE
fpmapbfllocd	TRUE
fpmgkkoopidj	TRUE
gjijjjnemjfd	TRUE
gjipoglgcjmo	TRUE
hdgdkajilmdc	TRUE
hdghfolbngdf	TRUE
hnddedhcpemh	TRUE
hndgpbclhohg	TRUE
ihmcngpokofo	TRUE
ihmokpeabfcd	TRUE
jbopaccaiodb	TRUE
jbpknlbfhajg	TRUE
jkmjlcplkgof	TRUE
jknpokkihffm	TRUE
kfcgffmoaihc	TRUE
kfeeppkeoejm	TRUE
kpbngmomnleo	TRUE
kpdfcjpjmglo	TRUE
ljabmkonofcd	TRUE
ljacbcpjceid	TRUE
mdedkpkjphlh	TRUE
mdgeidmkjapg	TRUE
mohfhjbefdgj	TRUE
moimklhpjkle	TRUE
nikjbaiegnmj	TRUE
nilhaejllfli	TRUE
ocacmgffoaoj	TRUE
ocahmmokcpbd	TRUE
oncpedmcfkba	TRUE
ondjdcadjedd	TRUE
pgfplkggbjmm	TRUE
pggepohinehg	TRUE
aabahcccgoim	FALSE
aabgapbifjdl	FALSE
akkookodpoib	FALSE
akmcaanbmhlo	FALSE
bcolkmeohpab	FALSE
bdahmbbnlpgd	FALSE
bnckcfacfkib	FALSE
bndkddfglgab	FALSE
ciafgabbicjo	FALSE
ciakpebjbjch	FALSE
dbioacphelkb	FALSE
dbipmedaihob	FALSE
dljhccnbcbab	FALSE
dljmhhjpdmab	FALSE
eflljcppipab	FALSE
efnljfifomab	FALSE
epaiblkabdpd	FALSE
epajncbjahap	FALSE
fkeeafgieppb	FALSE
fkgjfmljehab	FALSE
ggajbgbklkke	FALSE
ggbbmjbdooab	FALSE
hbccnoijailb	FALSE
hbcpooaafgnb	FALSE
hlbmpadledjb	FALSE
hldcbpbficab	FALSE
igdnmjfmlhab	FALSE
igegkdafnjeb	FALSE
jaoojpommopb	FALSE
japlofidinlb	FALSE
jkpfghlhdbab	FALSE
jkphmgjhigab	FALSE
keggcbneappb	FALSE
keglabgmgcmn	FALSE
kpdbmpiadpob	FALSE
kpdegkahnffb	FALSE
ljbckjpogfab	FALSE
ljbjnonikaob	FALSE
mdahadekdenb	FALSE
mdahpjccopkb	FALSE
mndodejaolnb	FALSE
mnenakhkdgib	FALSE
nhdljgapnaeb	FALSE
nhfkjlggceab	FALSE
npojbdbojajb	FALSE
nppdnmdhahnb	FALSE
oldidekonoab	FALSE
oldjdopgigab	FALSE
pgdlcgekfnab	FALSE
pgfdbpfibeab	FALSE
aabahcpccfnhd	TRUE
aabglapbifjcd	TRUE
akmjpegdpopmn	TRUE
akncmhecihpol	TRUE
beapfkblmcigd	TRUE
bebcfenhnjnoo	TRUE
bmkgjggbiipjb	TRUE
bmlnhjbikglfm	TRUE
cgojapgpjeogn	TRUE
cgpnkkigjmhia	TRUE
dbjlgnihgfeal	TRUE
dbliepeikfkig	TRUE
dljedhonpgjae	TRUE
dlndiihhedpjf	TRUE
efkocooogmmbm	TRUE
eflnkildfnpef	TRUE
epbhloohhlhdg	TRUE
epbkklajbhkcd	TRUE
fknoblhmfdmik	TRUE
fkobokanpflhm	TRUE
gfmgohjippfkm	TRUE
gfmjdgbdpgclb	TRUE
hbhfbnkcbmfdm	TRUE
hbiolamedpnjf	TRUE
hlohbfbkjkbpf	TRUE
hlpbghpponbjj	TRUE
ifnngdanpmjdp	TRUE
iganepcnenfeo	TRUE
japfppgfjjjeh	TRUE
japomlholfele	TRUE
jkaehmcioabnd	TRUE
jkccennhdleab	TRUE
kecchgmdmaonc	TRUE
kecelmadehbfp	TRUE
kplkjdiekibam	TRUE
kpmfnlcpomjnc	TRUE
ljnbjlgpediok	TRUE
ljnchhiajbied	TRUE
mdipkbjllddfo	TRUE
mdjhmbaipnonp	TRUE
mmjfibejdjkdm	TRUE
mmlcmbfigekko	TRUE
nggmgdnpeghkl	TRUE
ngicdigindclc	TRUE
npnbfmjgomofb	TRUE
npnieblbanoco	TRUE
ollbfnkhgmbhb	TRUE
ollijmdmhjako	TRUE
pfidlfahpoham	TRUE
pfimooidbpgfc	TRUE
aaafojbfebicg	FALSE
aaajmipccbcel	FALSE
akaffipalgmnb	FALSE
akbbpemccgbjg	FALSE
befmpiiflmiab	FALSE
begfegfehmkab	FALSE
bnnlgdplhmiab	FALSE
bnnnnhbfoogab	FALSE
cjagkjlgbmnmf	FALSE
cjaianpeglglb	FALSE
dclncobmpbkab	FALSE
dcncbgeeffiab	FALSE
dmjchinejgoab	FALSE
dmklfonkmlfab	FALSE
eflhbbhjidoab	FALSE
eflocljicbeab	FALSE
eoojfcigekhab	FALSE
eopgapchkpfhb	FALSE
fjhdbmdkldjab	FALSE
fjhjilbhppbab	FALSE
genbabfelddpd	FALSE
geomflomniiab	FALSE
gofkndcojcfab	FALSE
gofpgjdachfnb	FALSE
hjmhedeoalcmb	FALSE
hjmoaadbhping	FALSE
ielellbmebeab	FALSE
iembalfoomjnb	FALSE
ipcnlnnohngab	FALSE
ipeiiebpbohab	FALSE
jiofpgbipflab	FALSE
jiokdknhnogab	FALSE
kemmnnmhaigob	FALSE
keojadpagkjdb	FALSE
konfkobbhimab	FALSE
konnpbiopenab	FALSE
ljdknmdnjdpab	FALSE
ljdmblfleiacb	FALSE
mdhjlghkhhfab	FALSE
mdjhjfgdghfab	FALSE
mnolgjhohjkab	FALSE
mnphkoggjkajb	FALSE
nhdgoogmbnmab	FALSE
nhebnmdhhfeab	FALSE
objeepmlhliab	FALSE
objjhicofnajb	FALSE
omlcafilbnmak	FALSE
omlocmapfbocp	FALSE
pghglcekcpiab	FALSE
pgjaldejjdhab	FALSE
aaafojbfebicfd	TRUE
aaajmipccbcdkl	TRUE
akaedbokacdfpf	TRUE
akalobjdiimdcd	TRUE
behfaiclplonha	TRUE
behpbikimikcdj	TRUE
bobnilcmhikcnp	TRUE
bodbcmpekdffcb	TRUE
cjchhcddmidlhd	TRUE
cjdcdebplhipfm	TRUE
dclficgpgolbnn	TRUE
dcljpfpdehbjka	TRUE
dmgbefldcbillk	TRUE
dmgeaaflbcmhjd	TRUE
efphnpilnadlnc	TRUE
efpjbnilmlmijb	TRUE
eopfpfdpfcgoib	TRUE
eoplcfademejgd	TRUE
fkhcemgpkhjegn	TRUE
fkhiapdongfaml	TRUE
geelpdmjgjiiok	TRUE
gefdfhdkkigffa	TRUE
gofhjjijdjmebj	TRUE
gofmhkniifbihh	TRUE
hinpggcegkppmi	TRUE
hipikkghabblcd	TRUE
idfdkjebjkmmij	TRUE
idhjlleonebgcj	TRUE
iongocecfakigk	TRUE
ioocedbkoombdj	TRUE
jjankdkcegalpj	TRUE
jjbgnnlahaaokp	TRUE
kdpgniinonigoo	TRUE
kdpjjocbagclmh	TRUE
koihbloieioeim	TRUE
koiphdneminghh	TRUE
ljldjlliehlldk	TRUE
ljlkcjegdepbgi	TRUE
mdbpllmhllnnhf	TRUE
mdcmkjhbdjlcne	TRUE
mndmkcigjhonoo	TRUE
mnfanjgjcemggk	TRUE
nhcbpfgallelnn	TRUE
nhddklplhfnodj	TRUE
obpimjeccjocmb	TRUE
occajhhojcopdj	TRUE
omlklpahfpencj	TRUE
omloepeoeembjp	TRUE
pfgibeinlhmigd	TRUE
pfgincpamkilmj	TRUE
aaabbphcakcoeo	FALSE
aaackcflmefoab	FALSE
ajdkoidkdlmfmb	FALSE
ajdpnocchninlb	FALSE
bcncfomgomolab	FALSE
bdcjckmckkhiab	FALSE
bmlnakdpllalkb	FALSE
bmmdcapagobmao	FALSE
cicliojbbcpmab	FALSE
cicpobbpkeaonb	FALSE
daobjljadekebh	FALSE
daopfeabecfmfc	FALSE
dlcniojbmkiiab	FALSE
dlcpgjaljmomib	FALSE
eejbgacnjkcogb	FALSE
eejmaojpakchib	FALSE
eopbljfcemmcab	FALSE
eopiccocopncab	FALSE
fkdaaapgclkeob	FALSE
fkdagbkfahplgo	FALSE
gelchkilicchab	FALSE
gelpiodcfochab	FALSE
hacinplioeccnb	FALSE
hadhomiappmicb	FALSE
hkbiahflfejfgb	FALSE
hkdepiedmajhlb	FALSE
ifkehadelklnmb	FALSE
ifkhjcfbjihbab	FALSE
jabihlcalifpmo	FALSE
jadfbblphbpfoe	FALSE
jjeaocgpefffeb	FALSE
jjehijnadangab	FALSE
kdjfjokpafenlb	FALSE
kdmbpdfhleliab	FALSE
koahoabcfojgio	FALSE
koallijihpgknb	FALSE
lgmppnmhpeokab	FALSE
lgnommfanpddnb	FALSE
mbkcahbjfhkeon	FALSE
mbkiocgncibgab	FALSE
mmdgeoghnicfab	FALSE
mmegnjelkinmab	FALSE
nflilfoaipkpkb	FALSE
nfnahmccigihlb	FALSE
npbcekbkhanafb	FALSE
npckkplflkmhab	FALSE
olbdffbnmadnfb	FALSE
olclelccccimab	FALSE
pgkedbpdhlliab	FALSE
pgkobnpikjkjab	FALSE
aaabbphcajcndnj	TRUE
aaaccekldenaodb	TRUE
ajbogoomifdjpcd	TRUE
ajcfpgmfakmilia	TRUE
bcndfnfpnpenhhn	TRUE
bcoicfaiagiakaf	TRUE
bnbikanigpadocn	TRUE
bncogooipdicocn	TRUE
chjppjbfdaalfli	TRUE
chkkeciipmnbjki	TRUE
dapjkpgpaeeggej	TRUE
dbaboofllhnijcd	TRUE
dlkfjjdjmbjlpne	TRUE
dlkmbhlhmeddekk	TRUE
eenihkgcaoompmc	TRUE
eenmibnopompiaj	TRUE
eopgleofpgkehag	TRUE
eopgmcbkogfjhhl	TRUE
fkdfahglhgbjkcd	TRUE
fkefinckgoakloj	TRUE
gflllpaiidgjome	TRUE
gfmanagnclbgndg	TRUE
hadeglfifhmappe	TRUE
haeiacljjckfnog	TRUE
hlfhgfgeojflfhp	TRUE
hlgdgfjlgbifjjn	TRUE
iembpbbieinhndn	TRUE
iemmpmbplcdpdad	TRUE
jaceefbmfokdabn	TRUE
jacfiofbmmpmkod	TRUE
jkcbfmjhabpekjd	TRUE
jkcfjndiphpbake	TRUE
kdiejnpkgnjcoie	TRUE
kdjenlohlgngool	TRUE
knpogiekfbhkjcj	TRUE
kobepnjfnddbgnf	TRUE
likbcfpgifmckdp	TRUE
lilbfflppggpkdh	TRUE
mcgogmlgijhjmld	TRUE
mcihniplbmjmaje	TRUE
mmmfbiiaggjaajf	TRUE
mmmfhaagcjcbjdn	TRUE
nfopnjdkijhknof	TRUE
nfpmfcfdegkpdhl	TRUE
npebjfgmljfgadk	TRUE
npemadklnehmddo	TRUE
olalgaabijhjfcd	TRUE
olbjnddhcdhkoae	TRUE
pflgcggkdfbdjek	TRUE
pfloajogkpmfdci	TRUE
aabbbokomochaeb	FALSE
aabgigemhghnfio	FALSE
ajkofknnlhgpiab	FALSE
ajlabknnomonnjh	FALSE
begbkphmecaeoeb	FALSE
begogngaeinmokb	FALSE
bognkgabnpadioh	FALSE
bohmofpfbjejcab	FALSE
chhjnoecniankfb	FALSE
chjblamnbhnmnmj	FALSE
dbbklipbeihjdab	FALSE
dbbmefgkebddhab	FALSE
dldfdmpdgioenab	FALSE
dldpoddmmcpieab	FALSE
effjjmihhiiccab	FALSE
effmdflcolmbjab	FALSE
faekhpemacabfop	FALSE
faekkcnohecehfb	FALSE
flehmcapaopobam	FALSE
flemcolclhchjab	FALSE
ggbbfcalmhjemmb	FALSE
ggbemmomaejjcfb	FALSE
hagccogjiniihgb	FALSE
hahbeahgfeielha	FALSE
hkfdieaemcabbff	FALSE
hkfdkfbdghbolab	FALSE
ifdaphpmnkelmeb	FALSE
ifdgicpemcgpbab	FALSE
ipfpadlgemlakfb	FALSE
iphccknchgnciab	FALSE
jjofgmaaionhojb	FALSE
jjohhbfjdigbfab	FALSE
kcplpkljnlglkab	FALSE
kdapimppaepklpb	FALSE
knfanpkimdbnedc	FALSE
kngecappgfonnhb	FALSE
lhgcgcjiecbapob	FALSE
lhgmpfjlochikab	FALSE
makcckgohpenfmb	FALSE
makdahflmnmlafb	FALSE
mkdophfdbifloab	FALSE
mkehiiodclamkib	FALSE
neihbpangmikdmb	FALSE
nejhgddbnkmblab	FALSE
nnkpmpngohhmhab	FALSE
nnmkfbjeeakchob	FALSE
ohmcnilgbbcngab	FALSE
ohmnhkbkknbagjb	FALSE
pecaebfelgblmgn	FALSE
pedmpcnichjabef	FALSE
aabbbokomocgadbi	TRUE
aabggemhghnfiocd	TRUE
ajkpockdfnlecjgf	TRUE
ajlfobbceojbakbd	TRUE
becadekgibebenil	TRUE
becbkmahjdifblgp	TRUE
bnmmfhgenfecmolj	TRUE
bnnhgopfimkmdbak	TRUE
chnneanojammalmd	TRUE
chohmgommaoglbid	TRUE
dbmpfifcabilcied	TRUE
dbndpgimokgionlp	TRUE
dlokofoananncdnk	TRUE
dlpgmhokifkjnblf	TRUE
effjeebhkhjfmfpm	TRUE
efflefkpjfmaphon	TRUE
fafojilefampokgf	TRUE
fafopdfgbmkaeacd	TRUE
flfhefaficogeeck	TRUE
flfibndinonckkho	TRUE
gfnidipljneklehh	TRUE
ggahbiikbhgfencd	TRUE
hajohegefhelgggm	TRUE
haklgfjcdeafcmde	TRUE
hkmhcipbapdnnocm	TRUE
hknaaocfdoinchbd	TRUE
iemngfnglkhphnii	TRUE
ieomnjcmikjhienm	TRUE
ipapanipmeiiiaja	TRUE
ipbokhfpblngecfe	TRUE
jjhdennojgifpmen	TRUE
jjhelnhcllefmlin	TRUE
kdljmmiojoommljm	TRUE
kdlndmcfcihdcbao	TRUE
knbeigkeeicmkiec	TRUE
knbejagcloelidif	TRUE
lhaoeocppclhgbfd	TRUE
lhbelknnnnpgblgg	TRUE
mahcifoccmpjgnid	TRUE
maikcdbealninfch	TRUE
mkgellmnipifdbpe	TRUE
mkgkcgkkmiplbdoa	TRUE
negncimlocemnjlc	TRUE
neipfmnlfmdooknf	TRUE
nnolhhbdjnekhfal	TRUE
nnpkncjckegdllgi	TRUE
ohkfkdgopijdaffi	TRUE
ohkjpmalegfgjogd	TRUE
pdebdoggeomhffho	TRUE
pdgoaiplifbaaacd	TRUE
aaaifhpbedkgiacg	FALSE
aabaegdebemkeflc	FALSE
ajbhcmhgoppnofpi	FALSE
ajdbmacfmgaijbpj	FALSE
bddegjjdhpjbogab	FALSE
bddmmmopjknifiab	FALSE
bmghhhbahgdkdaob	FALSE
bmjbgbpipafbeinh	FALSE
chkbhaipfonniacb	FALSE
chkkmjbmjajinghb	FALSE
daknanjcgncnmeab	FALSE
daldkgpldfcmfpcb	FALSE
dkpmnnfdekadhjdb	FALSE
dkpoifnbigdhmbab	FALSE
efgnlknhlohdocab	FALSE
efhambmnedpgfeoe	FALSE
epmeadlacamlcmbf	FALSE
epnkphfcppnemgab	FALSE
fjbfdodkmohjipab	FALSE
fjbhobepdfkoinab	FALSE
gcfjcnfccllfhiab	FALSE
gcghpcomfjphllab	FALSE
gnbjdibofabpeadn	FALSE
gncipklnbeiefbab	FALSE
hglihmpbkndjimab	FALSE
hgllicfiaacigcnb	FALSE
ichjklhhjnglamjb	FALSE
iciogjaiffaljlbn	FALSE
illdjihojlodjoab	FALSE
illmfljngnkgdoab	FALSE
jgdnkolaamkaiapb	FALSE
jgeibjgbomoncnab	FALSE
kbejhkgeldbhdkab	FALSE
kbgomdddfbchmoab	FALSE
kojbphmnanigkinb	FALSE
kokkaodfhinnkgdb	FALSE
likpcalhhkmnjenb	FALSE
lilnbfpolmfaicmb	FALSE
mdhifheeihbgkfab	FALSE
mdikhobibikaklkb	FALSE
mldkgcgnenjabjfi	FALSE
mleikfadhbgdedjk	FALSE
ngajpodfjjdbonfi	FALSE
ngbmdfdcmkhhgfab	FALSE
oaaacoibeokkikmh	FALSE
oaaoaiefppaglkib	FALSE
ojkokhdenkkjffab	FALSE
ojmggkllgjhnfpab	FALSE
penodpbckipbogab	FALSE
peoikcikgipolbab	FALSE
aacmgmeggjgnkbcad	TRUE
aadcllficnlhcinaf	TRUE
akdmkmmogjbogcald	TRUE
akefhpbmbeapkamcd	TRUE
befbjgojjfcebimlh	TRUE
befkomffdcddnkpae	TRUE
bopdjmfgbkaonmhgg	TRUE
bpchgcbmiemnojilk	TRUE
choeogdjekmmhohnm	TRUE
chogacpemnlmnidcf	TRUE
dcfgdamjheidjjabe	TRUE
dcghahkdaecjbolgb	TRUE
dmiinggoelbmdnmbc	TRUE
dmjembkjlhgbbopla	TRUE
ehgnlghmnigennbmj	TRUE
ehipimgchppchmjii	TRUE
fbmglkpgbnfmfihaa	TRUE
fbmiodhkbgegmminn	TRUE
fmieocliaifbjajod	TRUE
fminfjepomngbiobf	TRUE
ggiihfiadgcmdhbjb	TRUE
ggjghmnonlndalple	TRUE
haednddmdhfhmbpcd	TRUE
haeghjelhkmmmpogd	TRUE
hjocepphlemlbfkon	TRUE
hjopehcndhojmcogn	TRUE
idhbjmpbpiohfgeon	TRUE
idhfpabaehjkmincd	TRUE
inmdhgceiojflgdga	TRUE
inmlcjccoocfokpbh	TRUE
jimnkjgfmponkakoc	TRUE
jincenekmlfhdbblf	TRUE
kcnlfpibfkdkdnchk	TRUE
kdbdclmiickdcgabp	TRUE
kmjefdefcnegnbofj	TRUE
kmjfajmjkhkdonbcd	TRUE
lhfllmiokbkhjimdc	TRUE
lhhgofckhgdjmfhpn	TRUE
mdbeafnjdadkjaadc	TRUE
mdckknlckhephnbmm	TRUE
mnmkfifdbpflgdklo	TRUE
mnngddnikmnjjnmpm	TRUE
nhpflkejfgdccmmjc	TRUE
nhpiacmpfboigfnnd	TRUE
occjgkiblpfddohoc	TRUE
occlhaoaogellkbbd	TRUE
olancflbninalbhld	TRUE
olbbpcnpobpngpklc	TRUE
pekjkfmhjcgcpkjcd	TRUE
pemjhcilaclclnndh	TRUE
aaaafllpocokcmeeb	FALSE
aaagghoelamhdmlhb	FALSE
akimcjnjpajemhgib	FALSE
akjhjbgijljokoijk	FALSE
bejfhgboknooncmab	FALSE
beklapeophinhjdhb	FALSE
bofhadfmiifjfbopl	FALSE
boflilcnglnepmfab	FALSE
cilinjkeoihgjibab	FALSE
cimffmbpchmejbeab	FALSE
ddibjnpdmbemiekab	FALSE
ddlolngaidoohcbhb	FALSE
dnjdolfdohjohifab	FALSE
dnkegeplbclmilhab	FALSE
eibhbgadfojecljcb	FALSE
eicmlbichllgpikab	FALSE
fdanhnfonmggdedlb	FALSE
fdbdihejhadinmaob	FALSE
fnonkmgpicioahlnb	FALSE
fnpbbknbemddodmab	FALSE
ghijjjlfpckclhbab	FALSE
ghjaonejklmhdldbe	FALSE
hbmglaccoikaininb	FALSE
hbncgaeafiefpbjme	FALSE
hmmpkldhcpmfpccab	FALSE
hmncjolpfbkjapjgb	FALSE
ifmmdmjnnnlpmifab	FALSE
ifninocpkojhaoomb	FALSE
ipcbpmnljfocimgab	FALSE
ipdmapoecmaipplab	FALSE
jjbfijilmhebnppab	FALSE
jjbklibfpjnlgnoab	FALSE
kdnibjaknhglploob	FALSE
kdnjhfahkongchhab	FALSE
koelenecmpipkpiab	FALSE
kofchcplggnppgmab	FALSE
lhpbplpnlfaifcjeb	FALSE
liaejgcipcahgfenb	FALSE
mdaaaeekiinpgpfdb	FALSE
mdacpfnohlkagkifb	FALSE
mmiijkmgopemockab	FALSE
mmjecjhknejmbbkab	FALSE
ngaiaekibpkklipbi	FALSE
ngaogacbccmloegmk	FALSE
oamacffmbcnnplajl	FALSE
oamfbkkgciimkeojp	FALSE
olklfijgnlccfkiab	FALSE
ollgcgaemnkllmejb	FALSE
pgboclggcmbhljoab	FALSE
pgcaajfihjgipfajb	FALSE
aaaafllpocnjclddgh	TRUE
aaagoelamhdmlhnbcd	TRUE
akipbngcmckepdehai	TRUE
akjmebjdikoknjmpcd	TRUE
benoiigljdlpcffpca	TRUE
beobbjljiojcklkpci	TRUE
boeblhdbfeoempniea	TRUE
boeklnjfenffjgcpao	TRUE
cjhppjnkmmllhnlgdo	TRUE
cjiigbjbgafnnadeki	TRUE
dcomajlnihojialkad	TRUE
dcpoihllnimfljdjci	TRUE
dnabggcomenkfojmid	TRUE
dnaklpbkkpbiifgkcd	TRUE
eihedloghhakjggbcd	TRUE
eihmmgdoapamjcogfc	TRUE
fcnicckgflfohgoege	TRUE
fcnnfofmdmpbpackme	TRUE
fnfmpbfcpjofdifine	TRUE
fngmllckclkofcejke	TRUE
gidopdmgpompdhahak	TRUE
gifcffmbgnbdmelgab	TRUE
hbmeiogndfolgpnmla	TRUE
hbmeoehpkfmogoekcd	TRUE
hmpgpcpcedfmdmjnnn	TRUE
hmpilpmifinocojnig	TRUE
igekpkhddncpccaoaj	TRUE
igendlbnfcmgnbhaka	TRUE
ipcclkabfkkgeaomid	TRUE
ipcgccgebdpdefnhbk	TRUE
jjinpioodfplpfbahd	TRUE
jjjfadllpgekmepphp	TRUE
kfcfimnbobaophbaid	TRUE
kfdgfdmbfopcpocgal	TRUE
koddkhhjladefbpecd	TRUE
kogpinfkcopfkconef	TRUE
lilggjkomdjagggppp	TRUE
lilgleckbfhjikidhg	TRUE
mclkadmjfgmijbjahh	TRUE
mclnpafefacjmfhohn	TRUE
mmkklbeeclphbhckld	TRUE
mmldahekidghijbbcd	TRUE
ngppkbpkapmlepaijn	TRUE
nhafadlpmjkkldiilf	TRUE
oangjnponodlbphacd	TRUE
oanincolhcbemjdhbl	TRUE
okjhmafmhnjkdpfffm	TRUE
okjkbeeahfmjmbckld	TRUE
pfhlfoacmpglppnmln	TRUE
pficaclkgcjoinnlnk	TRUE
aabjmnfhpknpfkjoed	FALSE
aacoelboopohpgmela	FALSE
ainfdoenafmjkejmhb	FALSE
ainlejghjkfefnjfkb	FALSE
bbmapngocifpefamnb	FALSE
bbmjhbhkdmebeffnab	FALSE
blocilbogeaajonbii	FALSE
blocjjjlbpgjckebab	FALSE
cgiehmfgpofccpgajb	FALSE
cgiepabnojnggkpcpn	FALSE
dcajjbmoiammmecica	FALSE
dcbbchmgpjolbmhcab	FALSE
dlnjikjdddannkcbeg	FALSE
dlnommcbibbgnagbjp	FALSE
egcghamclcbjnfbhgp	FALSE
egddnjgmjepcjpclab	FALSE
epeiihkogcihmpkbab	FALSE
epekfoggbhgioohdab	FALSE
fjejofcecceplcilab	FALSE
fjepkhnadikkpnnhdb	FALSE
gcniepbimeahmnklbn	FALSE
gcnnmpakffpfehajib	FALSE
gngcfjpcffegakhepb	FALSE
gngdeofpgoipgidiab	FALSE
hhcoigoeaoboilkegf	FALSE
hhcpjcjbbnkphoneab	FALSE
ickaajfeeflgcfohob	FALSE
icllbpcgbaopifkmjb	FALSE
incaoociplnmnekcab	FALSE
indoffldkafnpdlmob	FALSE
jiflgmampapkjlipib	FALSE
jifmfipocpjeclacgb	FALSE
kbmjmdahbhcpcmnpfp	FALSE
kbmkdihpmojbcjnoab	FALSE
kmpmgfkbamejddebad	FALSE
knamnmakkeaihkdpeb	FALSE
lhgmdlfpnlkaldeepb	FALSE
lhhamkcjfagkcnmflb	FALSE
mbaimhihnfboicpofj	FALSE
mbajmgicbclcahpehc	FALSE
mllikjkbcfhpjjjcab	FALSE
mllldiffabhbiebgbo	FALSE
nfgpdpbkhgbhgkhgab	FALSE
nfibjhmpfiolijkdab	FALSE
oacjfljihcaiphahbc	FALSE
oadeabkbcpnenhabmc	FALSE
oljjjjpeplokkefhab	FALSE
oljlakfbnlacajkike	FALSE
pfoeblkehfjdnkcoab	FALSE
pfohgkfnicblkgnaob	FALSE
aabdcncjiimfoifndmg	TRUE
aabobhonecpkcndbdnh	TRUE
aklghknhpaanlhgpffh	TRUE
akmbbadjonphahdkgcd	TRUE
bekljkpaejdmaaamcbd	TRUE
bemggaodajghhfdclof	TRUE
bnpkadldopgddhhnghl	TRUE
boajiijmjplbgbgfjcd	TRUE
cjcpecagdenodhahpjb	TRUE
cjdihbppjappjckicgn	TRUE
dddpjfkmeebbdckpihg	TRUE
ddeoeajicpilobdbhde	TRUE
dobedocgclipcjaooli	TRUE
dobijpdahmnnofcldbo	TRUE
ehiginkfhlpkgpfbfci	TRUE
ehjalaeopihoamnlphj	TRUE
fcciigbkgclmonciokc	TRUE
fcckppjademeajefdnk	TRUE
fokfkkmgdmaifbhaocd	TRUE
folecndlfaaebgkiglf	TRUE
gigcjelmjajkhehpbed	TRUE
gigogppmgohggbfmmbh	TRUE
hdaihaoglompdecbpcd	TRUE
hdbhloofbcailgggkdd	TRUE
hojcciblgnhpbjogfoj	TRUE
hokiompemnenncgmbjp	TRUE
iiheakoekobpagnjkcd	TRUE
iihifphlobfabpbjlcd	TRUE
jccmoimooinlebmihgb	TRUE
jcdjaakbhjnnmcgmfmn	TRUE
jlhoigjhfhhnjlogakp	TRUE
jlincjdpjoagfinobhn	TRUE
kgflmgpaalnlmoajnda	TRUE
kggnmdapankgoengaff	TRUE
kppgmaoidnkdboiekcd	TRUE
kppnjalbddndghkagcd	TRUE
ljmgbfhbhiofppeeedg	TRUE
ljnbkcidiaefbaaedgb	TRUE
mdiknkjhlckledmfpob	TRUE
mdioneofeopjnaebcmd	TRUE
mngolafjaccioladden	TRUE
mnidfmbpdodjocgaeho	TRUE
nhdohcmkkojjlhhcpfj	TRUE
nhecehagpalcdbfpofg	TRUE
obckakcobaeclkopdhf	TRUE
obfbphjiolgagelhmim	TRUE
oknlkbpoanmamcnpnpj	TRUE
okogeobjhkdmddbbdbd	TRUE
peofnamkegmmanibecd	TRUE
peogohpiaafobghkbcd	TRUE
aabfmflbhainmanjaej	FALSE
aaceecilafpkpikahpb	FALSE
ajjloohnklpiponaacb	FALSE
ajkgfbljmjikhgpbemh	FALSE
bdhjkbekbhnbclbnnab	FALSE
bdihfnnjeddkinbadmb	FALSE
bnjdecgpjehbajikpnb	FALSE
bnjmkkeieaapaplmoeb	FALSE
chpghhhgmkbojjcoiab	FALSE
chpioppblhhkphlcoab	FALSE
dcajehgjpcbnohncpjh	FALSE
dcapgpkfbkgejibmnha	FALSE
dlnfdjhidiabhchlggh	FALSE
dlnholghdkgmekklaib	FALSE
efppahlahbbpjgkmlbh	FALSE
efppephdhidhlkimnab	FALSE
fbdfffpdljcccehlkab	FALSE
fbfppicnmpffpfakbog	FALSE
fkmhlageggfhclnnbgl	FALSE
fknbceimihmaiaohpob	FALSE
gekphigjncoilgiofab	FALSE
gelkhkdmabiogpnmeoe	FALSE
goebidlhhmfhjjfdlab	FALSE
goebiklkkijpjjoclab	FALSE
hjdicealeihpgppaomb	FALSE
hjdlhmcehnjkpelikab	FALSE
idmfholhejgfmijppab	FALSE
idnmoejnoapadajjjeb	FALSE
iniliklhfkdodfjcmab	FALSE
injhimehihkaiglckpb	FALSE
jianilcakjpngnbclka	FALSE
jicmnjolihlpibjjjab	FALSE
kboflhojdkkilbpgdab	FALSE
kbpglpgancgbcnmgggi	FALSE
kmnpcbenfpelfgmiiab	FALSE
kmocnfkjbpgafijbplf	FALSE
lhhfoiedpagdlcilkeb	FALSE
lhjiakekgcinbobicel	FALSE
malhgpohkcpoeefnaib	FALSE
mamflkbfolkneehkdmn	FALSE
mkjnikgkeekjbkmndab	FALSE
mkkmefcmnmiokooamnb	FALSE
nfppkedpgpmibcjjiab	FALSE
ngbommbcnpcphjcghab	FALSE
npmdgogemodididniab	FALSE
npmgfkojfkpfjkohjab	FALSE
okcebefhbaibipjemkb	FALSE
okdmaeediecoalbhiia	FALSE
pfboicbfpcjminibfab	FALSE
pfchlbhnhkjggaoejnb	FALSE
