aaacmbicdh	TRUE
aaahfdjnnm	TRUE
akmaolakea	TRUE
akmliebbfg	TRUE
bfbllajbma	TRUE
bfccfhikld	TRUE
bpigfjiohl	TRUE
bpihlglnfh	TRUE
ckkecjlipe	TRUE
ckkpgfdbfg	TRUE
deionpfgae	TRUE
dejkoaiamp	TRUE
dodoodcppk	TRUE
dofclmaaho	TRUE
ehoeccknaj	TRUE
ehphgjejgl	TRUE
fcdlkfhicn	TRUE
fceofcbghp	TRUE
fmkjkanhfd	TRUE
fmkljeiaea	TRUE
giggijjkdi	TRUE
gihenocjci	TRUE
hcgbdojdff	TRUE
hcgpkkjkfm	TRUE
hncenicckf	TRUE
hnclagjlik	TRUE
iihdcgnepb	TRUE
iihddflakj	TRUE
jbhnlijnpa	TRUE
jbieghjllj	TRUE
jkeokikadl	TRUE
jkgdbnefjl	TRUE
kedgbcmakk	TRUE
keecignkpf	TRUE
knnojapkog	TRUE
knodjmfcij	TRUE
lidcphjiji	TRUE
lidhjnhfpd	TRUE
mddiihfbbe	TRUE
mddmogbadf	TRUE
mnneocigha	TRUE
mnnlpkacal	TRUE
nhiacgclep	TRUE
nhijjlpogi	TRUE
oagkibgoib	TRUE
oaglolcjdf	TRUE
ombopmaedg	TRUE
ombpidfclb	TRUE
pglkadbgjf	TRUE
pgnlcinkmd	TRUE
aaacmbicab	FALSE
aaahdhfbab	FALSE
akmhelmbab	FALSE
akoapaabab	FALSE
bfmjbnabab	FALSE
bgadbpdpab	FALSE
bpnjmhabab	FALSE
bpnkbhabab	FALSE
cjnheoabab	FALSE
cjnngeabab	FALSE
deggkfabab	FALSE
dehcaljbab	FALSE
dokpeeabab	FALSE
dolmaggbab	FALSE
eiadagbcab	FALSE
eiaejcpbab	FALSE
fbpfijabab	FALSE
fbpianfbab	FALSE
fnbkonabab	FALSE
fndmmjabab	FALSE
ghgnhiabab	FALSE
ghhlnhabab	FALSE
hcenfkabab	FALSE
hcfadfobab	FALSE
hmmidabbab	FALSE
hmnemdabab	FALSE
ihecakebab	FALSE
ihemhkabab	FALSE
jbcmdhabab	FALSE
jbcndeabab	FALSE
jjongeabab	FALSE
jjpbjcabab	FALSE
kdfideabab	FALSE
kdhkhjabab	FALSE
kmkepeabab	FALSE
kmkmenabab	FALSE
lhpmhmabab	FALSE
lhpngnabab	FALSE
mciolnabab	FALSE
mcjaolcbab	FALSE
mnhpjcabab	FALSE
mnlanmnbab	FALSE
ngpnnbabab	FALSE
nhbopmabab	FALSE
oafkanpbab	FALSE
oafkciibab	FALSE
olihjdabab	FALSE
olipkcabab	FALSE
pfhjfadbab	FALSE
pfjeegabab	FALSE
aabdcjikpfl	TRUE
aabhenmghgo	TRUE
akekfaihgdn	TRUE
akffcnchfdl	TRUE
bfjmgcaejnj	TRUE
bfkmdmomihh	TRUE
bpjghbgpbag	TRUE
bpkcaimieee	TRUE
cimfgamlmke	TRUE
cimmopkkalg	TRUE
ddmkenembhd	TRUE
ddmkgcnjfnc	TRUE
dnkfghgmppd	TRUE
dnkmdkdfepp	TRUE
eikcbjjlppj	TRUE
eikmmigjfoi	TRUE
fddfpbimpie	TRUE
fddiocifcjn	TRUE
fndhnmmjckd	TRUE
fndlddeldkd	TRUE
ghebegpjdke	TRUE
ghfpnmeofdh	TRUE
hbpnmdmdlfb	TRUE
hcafhahamob	TRUE
hlhkfdkhcic	TRUE
hlihponagdi	TRUE
ifpclkpomca	TRUE
ifphjogckoh	TRUE
ipnknjibjek	TRUE
ipoegcgcjni	TRUE
jjjhjfgifjj	TRUE
jjjncnnepnm	TRUE
kdakhdfockn	TRUE
kdbffffkfha	TRUE
kpaillbgiop	TRUE
kpanpdbmdjg	TRUE
lihcjcdibda	TRUE
lihhnfaiagh	TRUE
mcmjaeadnkp	TRUE
mcoaenjapfk	TRUE
mmlppjbplci	TRUE
mmmpneiokjj	TRUE
nglindammee	TRUE
ngloiemoenk	TRUE
obebmoemlia	TRUE
obfdnogihed	TRUE
ollnkmebmdi	TRUE
olpbiimedeh	TRUE
pfojaiakneg	TRUE
pfomapjgpjk	TRUE
aabdckjlgab	FALSE
aabhlenmgab	FALSE
akhlbeneoab	FALSE
akikggbmcab	FALSE
bffnkialbab	FALSE
bfjccopabab	FALSE
bpcjgkoabab	FALSE
bpdaidknbab	FALSE
cjebnblabab	FALSE
cjegdcambab	FALSE
ddhfckfabab	FALSE
ddhgmjfabab	FALSE
dnneeibabab	FALSE
dnngbebabab	FALSE
eilgamkebab	FALSE
eilldplabab	FALSE
fdafigoabab	FALSE
fdalhkmgbab	FALSE
fmklkoacbab	FALSE
fmkpfflabab	FALSE
gheholdabab	FALSE
gheinmfabab	FALSE
hbpflljabab	FALSE
hbpijbdabab	FALSE
hliehopabab	FALSE
hljaapakbab	FALSE
ifddlemabab	FALSE
ifdjggnabab	FALSE
iponahhpbab	FALSE
ipopagojbab	FALSE
jjjcdkfabab	FALSE
jjkbpafbnab	FALSE
kddagfnobab	FALSE
kddcjclabab	FALSE
kopkjbfabab	FALSE
kpaifddcbab	FALSE
limpijhabab	FALSE
lindhagcbab	FALSE
mcdcmijabab	FALSE
mcehnbcabab	FALSE
mmhbgffabab	FALSE
mmhkpkjabab	FALSE
nghngclabab	FALSE
nghpcdcabab	FALSE
obgfamlmbab	FALSE
obgjgmdabab	FALSE
oldodkoabab	FALSE
oleklibabab	FALSE
pfmggoeabab	FALSE
pfmhjdoabab	FALSE
aabjlohhefil	TRUE
aadblejpppnc	TRUE
akjmmimaecho	TRUE
akkedbolpgbc	TRUE
bfdakpmdgich	TRUE
bfemgipelela	TRUE
bolnghagnpni	TRUE
boloclmokjel	TRUE
cinblccanabi	TRUE
ciofbngpdgeg	TRUE
ddnnkhafdfje	TRUE
ddodkkcjelkb	TRUE
dogcchfmndnl	TRUE
doheodgachia	TRUE
ehmjgfoilbhj	TRUE
ehpakdpblbeo	TRUE
fcemapmibiho	TRUE
fcgicpdnkfke	TRUE
fnlcmaojfdim	TRUE
fnmblnfbbbfi	TRUE
gionadhncdeo	TRUE
gipebobgbggp	TRUE
hcfphdnpneln	TRUE
hcghcgcdjmnj	TRUE
hmghelgoneie	TRUE
hmgkhckidfip	TRUE
igeppeojanbe	TRUE
iggojieiflbe	TRUE
jbadenekabjk	TRUE
jbbfjeldbnim	TRUE
jmeljodiekpk	TRUE
jmfbnmlljmef	TRUE
khboghhccoec	TRUE
khcbgcjejbkh	TRUE
laklkpijmdjk	TRUE
lalhidebhdom	TRUE
lkpfaidgckip	TRUE
lladacnacnid	TRUE
mflkhhafepde	TRUE
mfllhdboifdc	TRUE
najaglhbjikl	TRUE
najijdhplico	TRUE
njmgjniohlpm	TRUE
njmjgclalgao	TRUE
ocpdemnpeejn	TRUE
odajfmhoepmo	TRUE
omdhkcjdpfic	TRUE
omhaligopiik	TRUE
pgbcpiigljbc	TRUE
pgbkmijpkbfg	TRUE
aabjlohhefab	FALSE
aadbclmfkoab	FALSE
akjngnpdebab	FALSE
akjojhmidbab	FALSE
bekdafdojbab	FALSE
belijjafabab	FALSE
boljofojabab	FALSE
boncbjdlabab	FALSE
cjkgknmdabab	FALSE
cjkjlpnadbab	FALSE
ddpgcldlabab	FALSE
deacnhlpbeab	FALSE
doeipndpabab	FALSE
doemglahkbab	FALSE
ehlplcjpabab	FALSE
ehmncgemabab	FALSE
fcgiceicabab	FALSE
fchggjmhabab	FALSE
fnebojegabab	FALSE
fnfdpaiaebab	FALSE
gifkobbgabab	FALSE
gigjahobfiab	FALSE
hchngmgkabab	FALSE
hcjipipeabab	FALSE
hllcnkhhabab	FALSE
hlmldlahabab	FALSE
igbioonfabab	FALSE
igbkhkmabbab	FALSE
jbfmkogmabab	FALSE
jbgomcibabab	FALSE
jlnellkdabab	FALSE
jlnilnpfabab	FALSE
kgfmkaidjbab	FALSE
kgicemngabab	FALSE
lapikmigcbab	FALSE
lbagjbemmdab	FALSE
llhbdeegabab	FALSE
llhgfkgiabab	FALSE
mfdcjdcbabab	FALSE
mfdenecmabab	FALSE
nahclpjaebab	FALSE
nahjmpgalbab	FALSE
njgnjlgeabab	FALSE
njhaopppnbab	FALSE
odoopcgnabab	FALSE
odopfgnkabab	FALSE
omjlhlpiabab	FALSE
omknclaokbab	FALSE
pgfpjadlfbab	FALSE
pghbgmheabab	FALSE
aabjlohhefilb	TRUE
aadcejpppncbb	TRUE
akjeakmdemmel	TRUE
akjnmnfcagllp	TRUE
beobkdmmeecli	TRUE
beoifenddkemk	TRUE
bopceahnmhlni	TRUE
bophoaaljbgfb	TRUE
cjbnokmdedeji	TRUE
cjcaimkpbgloe	TRUE
ddionehadflmb	TRUE
ddkfhehebkafl	TRUE
dobcjbnpkcnpi	TRUE
docainammkefb	TRUE
ehpfhoinpmkdg	TRUE
ehpkamjogmela	TRUE
fcjjaghgpeohn	TRUE
fcjmenehdchgo	TRUE
fnihcdfopehin	TRUE
fnjelcmmfplam	TRUE
gilafmjodoihp	TRUE
giljkandmiakl	TRUE
hdbcglodgdbcn	TRUE
hdbkedkfabkkc	TRUE
hlkfbihijdoko	TRUE
hllimombdpdhb	TRUE
ifheknpgaeefi	TRUE
ifhfadbhcckco	TRUE
jbieeoofhcede	TRUE
jbjnkkmlfjfpp	TRUE
jmfkkidoombmi	TRUE
jmhhkjdmbcbcm	TRUE
kghnnekcngfdf	TRUE
kgjglhmdkhfcp	TRUE
laliligodhkah	TRUE
laliollmncjph	TRUE
lkpmdmkafidcf	TRUE
llacpaieencfa	TRUE
mggmbplohapdj	TRUE
mghhenimajmpm	TRUE
nafldojnichpa	TRUE
nagjljlcekpke	TRUE
njhiajjbdaiij	TRUE
njhmofpadgmbk	TRUE
ocpekmphjeonc	TRUE
ocpffdboahkgg	TRUE
omlhmndcgngmg	TRUE
ommkcpddgnnpa	TRUE
pfmkhlobpfaih	TRUE
pfnojddgafihb	TRUE
aackbknpkapab	FALSE
aadlcjjdgkbab	FALSE
akdeeblgkleab	FALSE
akdngebkadjbn	FALSE
beknpfekfabab	FALSE
bellpilmeabab	FALSE
cabdggenfcgab	FALSE
caehlojggabab	FALSE
clelobdeoabab	FALSE
clfomdmaolbab	FALSE
dfhefbhihabab	FALSE
dfhmjdikiabab	FALSE
dpjmfciceabab	FALSE
dpkhjpbifabab	FALSE
eimomaeafhbab	FALSE
einnehnkgabab	FALSE
fdlccjihcabab	FALSE
fdlgplgolabab	FALSE
folbadeklebab	FALSE
folcilfjgabab	FALSE
gjmkbibajhbab	FALSE
gjnchidjmabab	FALSE
hefcldfkcabab	FALSE
heggkabobfeab	FALSE
hndgfebiiabab	FALSE
hnekiikeoabab	FALSE
igkpcihbpabab	FALSE
iglciaimofbab	FALSE
iplojgpimabab	FALSE
ipmnhfbedabab	FALSE
jkciocmpcabab	FALSE
jkdalcllnbpab	FALSE
kemecffjjabab	FALSE
kenlipjamdbab	FALSE
kpgklkpaknbab	FALSE
kphcdidcmabab	FALSE
lijngegpbabab	FALSE
likljlkdkabab	FALSE
mdclioehgabab	FALSE
mddpiffhlabab	FALSE
mmeejpffoabab	FALSE
mmfmecmfeabab	FALSE
ngbbkmiaghbab	FALSE
ngbdigjjmabab	FALSE
oabnjjnhdemab	FALSE
oaccfgcfljbab	FALSE
olelbicciabab	FALSE
olfngeeenabab	FALSE
pgdbdbnhkabab	FALSE
pgedjdodnabab	FALSE
aackbknpkapamd	TRUE
aadjjdgkkkbhnm	TRUE
akekjocahbboka	TRUE
akfciggcfinpbc	TRUE
bfhkciaodeiknf	TRUE
bfjdpjiphkpcpn	TRUE
cadekhaocaklpo	TRUE
caegckiadhejmg	TRUE
cldhlmjcpiabcl	TRUE
clenckbljhjplg	TRUE
dfpgnjfgndfeeo	TRUE
dgaaikgidnmkpm	TRUE
dpmhnogflnaljd	TRUE
dpmlbhelofpmek	TRUE
ekbegabjdbcanf	TRUE
ekcdaanfeacbla	TRUE
fddjdjolpllnjj	TRUE
fdendhmbpiaklc	TRUE
fngnhfkmnmeaae	TRUE
fnhekdnjkiniml	TRUE
gjbalcllnbpmhg	TRUE
gjclchkcfnbjoo	TRUE
hebklkjjfafjof	TRUE
hecgodemdijloa	TRUE
hnglmpncaaefah	TRUE
hnifgkefgmgidl	TRUE
ignikkdkjmfjdl	TRUE
ignnbckkogmaoe	TRUE
ipoghjcjjlbgmb	TRUE
ipolpekcagglfo	TRUE
jkfedggdhdoojf	TRUE
jkflffhpghghkk	TRUE
kefgbpacifcoie	TRUE
kefkkagnekdmge	TRUE
kpheogdnegfklc	TRUE
kpilkjbolimopa	TRUE
ljkoleehimoilg	TRUE
ljkpedmmdcodfd	TRUE
mdcompefgeeldb	TRUE
mddfdciedncnie	TRUE
mmcoghfcpniolk	TRUE
mmdomgllfmlmea	TRUE
ngkhoepmnpobjk	TRUE
nglfbbdfidncno	TRUE
oaaghldfnmlhpf	TRUE
oaalngekcpdjeg	TRUE
oljdboodpchigb	TRUE
olkklpiapmlcfi	TRUE
pgpkjidpofmghe	TRUE
phbcdmfhgmmhnh	TRUE
aaancgghliibab	FALSE
aabcaehcpgmfhb	FALSE
ajianemfjohbab	FALSE
ajigbnojkggoab	FALSE
bcojbnnhpfabab	FALSE
bcpiikhoeoabab	FALSE
bnkeccemcdabab	FALSE
bnlidpfjpnabab	FALSE
chienkmfdoabab	FALSE
chkigdjmlnabab	FALSE
dcplnhheimabab	FALSE
ddahapecpnibab	FALSE
dnhnaglomdpbab	FALSE
dnkfniekpnabab	FALSE
ehknipogkeabab	FALSE
ehlmjdhkmmabab	FALSE
fbbpbgkejgabab	FALSE
fbcgmakbjnifab	FALSE
fkokbffngmabab	FALSE
fkpabiodocokab	FALSE
genoiogiheabab	FALSE
geobbpkhgkabab	FALSE
gpkkkddkdoabab	FALSE
gpkngiopncabab	FALSE
hikimmkaknabab	FALSE
hilikkibnhabab	FALSE
ibebggbigcabab	FALSE
ibeblgljijabab	FALSE
iljbchdkcmabab	FALSE
iljmljdfkbabab	FALSE
jfpgfigbdoabab	FALSE
jfpipcklofabab	FALSE
kbkdkidiiiabab	FALSE
kbkockcmldabab	FALSE
klghchenkpabab	FALSE
klhhakpcepabab	FALSE
lfcjjbekcgabab	FALSE
lfcmhdjlkkabab	FALSE
lpekkebjbdabab	FALSE
lpelcpiecadbab	FALSE
mjmdcbjmccabab	FALSE
mjmebpeedpabab	FALSE
neogdagkmpbiab	FALSE
neoifeoghnabab	FALSE
oadhmemlhldbab	FALSE
oadidlnnpdmbab	FALSE
oknjnlfobbabab	FALSE
okokikmnheabab	FALSE
pggbcgagfgcbab	FALSE
pggcabacbiigel	FALSE
aaccdhhkhmklllm	TRUE
aaccpgkommbljlb	TRUE
ajkjcbpfafpaigh	TRUE
ajlcocinningdgc	TRUE
bdgaomachmeoofa	TRUE
bdhcjamlphjphbh	TRUE
boicfmcehkcdenb	TRUE
boilgepdjdninic	TRUE
ckglhfaikakneop	TRUE
ckifcadiajdhpng	TRUE
ddibbhfahndmaje	TRUE
ddigpcgfiiggeaj	TRUE
dnbdfljmmmjegmb	TRUE
dncdcbmapecldob	TRUE
ehakonfclbjgicl	TRUE
ehaokbnhpaohfpl	TRUE
fafpmflchioiefi	TRUE
fahgnjipljokjhc	TRUE
flabgbdllamlamn	TRUE
flcckbnpiifadge	TRUE
gfaeennkkhbinai	TRUE
gfaohehneemdbmp	TRUE
hbdeepchbankpgo	TRUE
hbdkeheelfpaogm	TRUE
hlmnofdeoipkkcn	TRUE
hlpckagnlijbkjj	TRUE
ifckkijadcpfnll	TRUE
ifdfpbbeeancplh	TRUE
iplfnekcpnjnfih	TRUE
ipmcfipfajepcni	TRUE
jjfeenileocegdj	TRUE
jjggeiafhhojgoo	TRUE
kedpinablabhncd	TRUE
kefdhigipceakde	TRUE
kobnjjncbgnhgnl	TRUE
kodnlblaekijdmp	TRUE
lihfhcebgfoleaf	TRUE
lihnnkgnpeglbmp	TRUE
mcebmjeokndlgio	TRUE
mcfildpopegfjnm	TRUE
mnhgbdaakokahoo	TRUE
mniokmkmhflmkdg	TRUE
nhjleffgjoeiond	TRUE
nhkjjoncamhdfnf	TRUE
ocedfbpnhndciae	TRUE
ocepckdlaihccnm	TRUE
omomnhionihlhac	TRUE
omphmbpelmkodbc	TRUE
pgkimiakhlleffp	TRUE
pgklonjmgiacdme	TRUE
aaccdhhkhmklbab	FALSE
aaccpllmgkombab	FALSE
ajonioknipibhab	FALSE
ajopdmikjpbjiab	FALSE
belcbjlpmkaobab	FALSE
belpejimceeabab	FALSE
bpeboehcjelabab	FALSE
bpfpmgojebeabab	FALSE
ckbolnpcpfgabab	FALSE
ckbpoppdiocabab	FALSE
ddflllhfaikabab	FALSE
ddhkneopgfcabab	FALSE
dmalakbeohblgab	FALSE
dmamnkjfhifgbab	FALSE
eglmpjfjicfabab	FALSE
egmabhjpmlhglab	FALSE
fagohhkiikclbab	FALSE
fahilmfndkpfbab	FALSE
fljoianpannabab	FALSE
flllhgbojjmabab	FALSE
gfgndkhnciiabab	FALSE
gfiggalngohjbab	FALSE
haigpbkhclkjgab	FALSE
haimioocgcgmbab	FALSE
hknjkgmlgchabab	FALSE
hkockbklcjdabab	FALSE
ieghkpelicmabab	FALSE
iegjccaoophcbab	FALSE
iplookknopbabab	FALSE
ipmnnmlfeopabab	FALSE
jkbniipdafimbab	FALSE
jkckoiemegcabab	FALSE
kdoepkfniogabab	FALSE
kdoncjdemmeabab	FALSE
knkgmmhejhpabab	FALSE
knkhjbcoepfabab	FALSE
liebaphaahdlbab	FALSE
ligainmkofnbnab	FALSE
mclhicjklnkabab	FALSE
mcndpngaoildbab	FALSE
mncblgmnlmkabab	FALSE
mnebcopgojnabab	FALSE
nifcoiahdgikbab	FALSE
nifdcojkhgeabab	FALSE
ocffdkegdpeabab	FALSE
ocgoflebnjjabab	FALSE
oneneebhijpabab	FALSE
onfdfinpcfpabab	FALSE
pfjdnciiooeabab	FALSE
pfkdkdoabnpkpab	FALSE
aaajnhhoajjlkdka	TRUE
aacacjiimaicjccm	TRUE
akjhojlaedomneij	TRUE
aklenladmaaoojep	TRUE
bdngijggdpdicfdl	TRUE
bdnofekbpplbajbd	TRUE
boebndoepebkcccp	TRUE
bofblpneceibgmhc	TRUE
cipoobihoolhhkik	TRUE
cjambimofekgcgne	TRUE
ddkgnlejpaklaghc	TRUE
ddkjhelpgpoeefgg	TRUE
dngobombecdgflpi	TRUE
dnhakcaicfadnonh	TRUE
ehlkaffhcjppkkfn	TRUE
ehmefdhiipliijll	TRUE
fbpdaibjepgimdga	TRUE
fbpiaeldoglpahjo	TRUE
fnakchlgbaephbcd	TRUE
fnappoeapadggpfn	TRUE
ghnckenhdeilneml	TRUE
ghngikclkelniolc	TRUE
hblgljoondemmlmk	TRUE
hblipdodkgiofkge	TRUE
hlngphblkibdhopb	TRUE
hlnibklkciggdehm	TRUE
igcncjigogodmcbo	TRUE
igdifljjngehimfo	TRUE
jaenkkhacpnkpdem	TRUE
jafnddgflcjgmlof	TRUE
jkhnikjobcgdaldj	TRUE
jkjfcpmpbcobomld	TRUE
kfeklioncgbphphb	TRUE
kfffojocpmjmanjk	TRUE
kokikogglnahddjp	TRUE
kokljffjlophogpk	TRUE
lindnhoahedjcoeg	TRUE
linpcjmgicbhmlde	TRUE
mdbjoakgmldcmhoc	TRUE
mdcfkkiajjgjlolf	TRUE
mmnooodglohcoojo	TRUE
mmobdcepnmmjlndp	TRUE
nhcncgkphofhjoao	TRUE
nhcoembodpphhmpj	TRUE
obfllbklmnlfnhma	TRUE
obgebajkepjlafdc	TRUE
olcpndcnclojflpo	TRUE
oleapacmiebpdkeg	TRUE
pfhceljcncblhgoe	TRUE
pficgpgcphhociao	TRUE
aaajnhhoajjlkbab	FALSE
aacdaaicjiimabab	FALSE
akmggcjhdbchnoab	FALSE
akmieigbpijeinab	FALSE
bedkkcabndepoakb	FALSE
beemajgdmpllkbab	FALSE
boceonclajjpjbab	FALSE
bodaccohiogdkbab	FALSE
cjcifjiicgckabab	FALSE
cjdncheakmhambab	FALSE
ddochpfajpmfibab	FALSE
ddohlphijcoajbab	FALSE
dobhgakgbijbafpb	FALSE
dobocmfpehnoabab	FALSE
ehkeihghjendabab	FALSE
ehlfahcokcgnmbab	FALSE
fckcipejpjcbabab	FALSE
fckcpfjaejmckbab	FALSE
fnahhkfhlgcenbab	FALSE
fnbaahfkamdgbjab	FALSE
ggfdagmacfiikbab	FALSE
ggfdokdpalgbhcab	FALSE
hbinkkmeelfhabab	FALSE
hbiokdepceebabab	FALSE
hllmfdcmnhbiabab	FALSE
hlmgpcdepfkkabab	FALSE
igimlnbkbenhabab	FALSE
iginejmbaeidlbab	FALSE
jaeocmndchgkebab	FALSE
jagkdikhhjeggbab	FALSE
jkkjelmlnjpfabab	FALSE
jkombjecepmkabab	FALSE
keokepidmmceabab	FALSE
keopahmelllndbab	FALSE
kodplfhhakdfabab	FALSE
koeenfkebppiabab	FALSE
liolkfdkjokeabab	FALSE
lionbpnlmjchabab	FALSE
mcmommjddodnabab	FALSE
mcohabalgcgjogpb	FALSE
mmkmmaeenmiocbab	FALSE
mmlgkcjodomhabab	FALSE
nhihbekjngpgabab	FALSE
nhjcfjapbhdefnab	FALSE
obeafeadggmcpbab	FALSE
obedfaheanehabab	FALSE
olickonehoenabab	FALSE
olinglfahhiclbab	FALSE
pfjjcpnipiedabab	FALSE
pfklkecdikcmabab	FALSE
aaaijkiadcdkklanl	TRUE
aabddfoihbcbenomo	TRUE
akgohcbpekjhonfmf	TRUE
akhjegajjpbdjecoh	TRUE
bechofoaggienopnb	TRUE
beckhggopkcimopmj	TRUE
boamgklbmpkfdpgkh	TRUE
bobehbkoopcdiegkd	TRUE
chodcgfoijdebonfe	TRUE
chofgmljbokndbheo	TRUE
dcbmlpcokfpfmmidb	TRUE
dcehnefpimdedgpfi	TRUE
dmdpbeoaedpjbcpkg	TRUE
dmeconcclhmmneihc	TRUE
egckekcieijbcgjgm	TRUE
egdcnnbehopmkennc	TRUE
faapcpeidkefgodec	TRUE
fabglodefdfoefcob	TRUE
fkacdkhbfplkeolib	TRUE
fkaegdkjhkeipddjo	TRUE
geihddlhdboaadmll	TRUE
gejdibmaiieijepdm	TRUE
gojaegoccegfffhhe	TRUE
gojfkhjbkpdjdibja	TRUE
hijnkkpaeppbijpml	TRUE
hijogemfjifhocdok	TRUE
idjdcgaapbablpecd	TRUE
idkdpfinnelmpjiak	TRUE
impiegemaonbbhlgl	TRUE
inagaflmcfcfnlgbf	TRUE
jicifdaceliibpgcl	TRUE
jicpofpekbebcjlfa	TRUE
kcjjoohafgmhacdhi	TRUE
kclenhcclgfhcpkaf	TRUE
knfnbdmmjbapiihgf	TRUE
kngebckaacdeacnho	TRUE
lhnihoflegdmkpfbi	TRUE
libgaamebgnhkbokm	TRUE
mccocaokeckhgcolm	TRUE
mcdhmpmjdpmgdgkhi	TRUE
mndchjioickdifabl	TRUE
mnddjhaodcpefbmhp	TRUE
nhjfgpihpnhpnohom	TRUE
nhkhkocobnncbccob	TRUE
obfadcckdonjlndef	TRUE
obhnilcjajjomejgc	TRUE
olkcdbpgpjiofjoei	TRUE
olkhfcnbifnkomlaj	TRUE
pgcjicagmlfpoapbm	TRUE
pgdgebaolkfleopil	TRUE
aaanifjdjpndgfbab	FALSE
aabbpbldibcabjngh	FALSE
akjijccigjcmhcbab	FALSE
akkpcklmoolfinbab	FALSE
bedpcefkcddkgabab	FALSE
begeafdbebebhmfab	FALSE
bpcjkfjljndohabab	FALSE
bpdipkmddkanhdbab	FALSE
ciphlmmmgpkmcabab	FALSE
cipkpfgbjhcpmabab	FALSE
dcnlodkalclglkbab	FALSE
dcnmjmcnfeaabkcab	FALSE
dnjfopkngglflabab	FALSE
dnjpbclbbdgdhabab	FALSE
eifnknfcijochabab	FALSE
eihcdbkncllgapbab	FALSE
fcplnodickkdgabab	FALSE
fdadkfefamnjffbab	FALSE
fnjbmfalfmfgbcbab	FALSE
fnleofhdnkmamcbab	FALSE
ghlkeoabgehmmailb	FALSE
ghllamehpbncfachb	FALSE
hbjhoniilcjigabab	FALSE
hbkigdnghkikcabab	FALSE
hlkpmmldebphoabab	FALSE
hlndgnncbnklhabab	FALSE
igcfnmgkendecabab	FALSE
igeonfmhfnkehabab	FALSE
jbgpefmhdlbgpabab	FALSE
jbhejmdgaalihnbab	FALSE
jlknlidibbheiabab	FALSE
jlleaemchnimajbab	FALSE
kengcakfekmedabab	FALSE
kfaainppimmmmjbab	FALSE
kompggmnkkbmfabab	FALSE
konfpedcieedmabab	FALSE
ljaakjbegdhiaofjb	FALSE
ljbgcifmilbicabab	FALSE
mcmhdomcjpfmhabab	FALSE
mcmkcfcanffighbab	FALSE
mmolfibcefmihabab	FALSE
mmppipgdckbbfabab	FALSE
nhbhnlpoinehacbab	FALSE
nhbjbmecgbkhaobab	FALSE
oafajpfopjmhijbab	FALSE
oafefajcnfeiafbab	FALSE
okpejdbdlmjjfabab	FALSE
okpjeapmhckdoobab	FALSE
pfdiiekobipjfabab	FALSE
pfebbepikamolfbab	FALSE
aaanifjdjpndgfbpbl	TRUE
aabdibcabimfgmpgid	TRUE
akjpohbpldcjnckhml	TRUE
akkahplajihcmodaia	TRUE
bdppdnhbcflnofjhgb	TRUE
beeopodnfjbeijkhpm	TRUE
bpgkmolkgikgohbceb	TRUE
bpgnbiobdjgnamapgj	TRUE
cjogfmfndgjlkjhdmp	TRUE
cjoidlmcdchjgmgcjn	TRUE
ddepnpoomcgofcmmnk	TRUE
ddfcbhenalmakhmndo	TRUE
dodgbannjaeaakjnce	TRUE
dodogkjpildlnnpfll	TRUE
ehpipfhgedjcgkddja	TRUE
ehpjmkhjfbofoeggig	TRUE
fdienkhdfocpnmmonl	TRUE
fdjkdlmejiajbhebak	TRUE
fnakoabpfondhihafg	TRUE
fnanggojoiebgfkmjd	TRUE
ghbjigbkjlmhoonbdp	TRUE
ghcpbjjdmfmadmjlif	TRUE
hbdlfblofnijchjaan	TRUE
hbekejkgadjdfaiceb	TRUE
hmdeknecncfpgmliak	TRUE
hmdfibplkeonicgdfp	TRUE
ighghhikojoimoehfd	TRUE
igiaoenjpajjpmfnip	TRUE
jbgdgmompknfblflgn	TRUE
jbhbcdjcfcgnmpogfl	TRUE
jkknlgpdeaolkabaeh	TRUE
jklaaknekppdkhdmfk	TRUE
keplljhepoialinpea	TRUE
kfajcihiehnjekippj	TRUE
kolpnfclicjjhedjdg	TRUE
komldemammlmdbehfc	TRUE
ljlimmphglfkjapafk	TRUE
ljlinimfehgpncddeg	TRUE
mcgdpbknfnmnmjcmmc	TRUE
mcgkocdgjmofgefdon	TRUE
mmpmagcadjhlgnknah	TRUE
mmpoacncdpnocgpjfi	TRUE
nhbifhelngkmmfoofl	TRUE
nhbmmlpjbenbdfknlo	TRUE
oadookmdigfodkjbbb	TRUE
oaejkfafenlkbbhcdl	TRUE
okkpfomklhonkdimda	TRUE
okookcgcmbekbkekea	TRUE
pekadkpmgefdcpaeij	TRUE
pekccmljpnpcdcapnk	TRUE
aaafoibmpcleapkleb	FALSE
aaaojodkpbngbeemab	FALSE
aimediapgbdkdgdkab	FALSE
ainjclijklbkhmjlab	FALSE
bddefgdilmfgkgabab	FALSE
bdedgdnliiioheabab	FALSE
boekbcobdidpkcabab	FALSE
bofageggbibjgmngab	FALSE
chmiicboddfdhlabab	FALSE
chmjjimmloclgeabab	FALSE
dbdombphmhbgpoabab	FALSE
dbgcmlnefnnafjbkab	FALSE
dmeohjmbcbpmpiabab	FALSE
dmfadpjagmehnccbab	FALSE
ehhpehognpokokabab	FALSE
ehibecmfohbhlpabab	FALSE
fbhgnhnkleponeabab	FALSE
fbhonmpmndehfaboab	FALSE
fmgpbddmmhagpeibab	FALSE
fmieldfjcdaaccboab	FALSE
gfmkdgoibmaemnlbab	FALSE
gfnhnnebilbaodkbab	FALSE
haajphcdnfncjcnbab	FALSE
hacabcageiinnggjlb	FALSE
hlilbdkbbcpancgbab	FALSE
hljpmjhbmjhebgabab	FALSE
ifclfallpppmclbcab	FALSE
ifdmekjidobhkpabab	FALSE
ipdcpepjblhdcgabab	FALSE
ipdekldihahlgmgbab	FALSE
jjhimdllmpembbabab	FALSE
jjhllhfnlijdbafbab	FALSE
kdlngnpggjcfbkabab	FALSE
kdmpiljghobggbabab	FALSE
knkghjekhjebmbabab	FALSE
knldkenbecaklkibab	FALSE
ljajnhigcopabphpab	FALSE
ljcbnkpplhohahnbab	FALSE
mdencificgfdagkbab	FALSE
mdgfbacjbnkihkhpab	FALSE
mnflhfoiljmhneabab	FALSE
mnfngilgpdioajebab	FALSE
ngkhdengjbgiocabab	FALSE
ngkkjeclllimdnabab	FALSE
oaedfcfhcmokilbkab	FALSE
oagmojnejhipamkbab	FALSE
oikammbkdpiojanihb	FALSE
oimfkijbkfndnjabab	FALSE
pdgojdabihnbjbffab	FALSE
pdigemnhljghhhabab	FALSE
aabkjamlnkogcjhncgg	TRUE
aabkmidnmedealahmon	TRUE
akkeiaoajoncjkclgod	TRUE
akndceoplnibilgkdcl	TRUE
bfdmcgkhkbjbndboiad	TRUE
bfegeibjcoadohbgdpb	TRUE
boahfiliicgopjlgfli	TRUE
bobaldiglhmldmofblp	TRUE
ciallflaloaaomdledm	TRUE
cibldefpjgdblfinlla	TRUE
dbnkfbofaknmgebcjko	TRUE
dbogniaegjckcpibljm	TRUE
dlfpaeldnpdkhoeehdn	TRUE
dlgiamjcngcdiioafdd	TRUE
efjgmmdhabggagofbcd	TRUE
efjlhcjnnojjfpkpnbe	TRUE
fabhgbfcmpncjeckldh	TRUE
facgghmafapgkjmppna	TRUE
fkbmmedakjddjijcfif	TRUE
fkchafmadbkollhkmfk	TRUE
geilmmnmefaoknippam	TRUE
gejkbpmfpglifcnoffo	TRUE
gpkbaaodlndnpajjpmb	TRUE
gpllbboicmgeljndmfl	TRUE
hjlfpjkhdobpnghjaco	TRUE
hjmpalbemhnjddmkple	TRUE
ieeaccnhpkohcmjgijh	TRUE
ieekngipdgjioapkneo	TRUE
ipgkakdphpojmokoiek	TRUE
iphbgggleenebaelcao	TRUE
jimpmlgeehidckpniod	TRUE
jipdnpoihadjeohofen	TRUE
kcoemcgcomnmpkejcll	TRUE
kcoepjpbojlhmmdblnd	TRUE
kmofdehllealongggje	TRUE
kmomcabdpjcibnoehpd	TRUE
lhookfnggcknciggame	TRUE
lhpkdgjhengiokkdbcc	TRUE
mdbffklcjifokcnhjnk	TRUE
mdbggnenoeagagjgkmd	TRUE
mnpiaoamdclkdalmghl	TRUE
moajnkncmhpojfaodlo	TRUE
nihmmggnkpdacahoacd	TRUE
niiafakldokpllbfehf	TRUE
ocefabfdcppedpibgnn	TRUE
ocfcpegenponbdioedp	TRUE
omdbmpmfkjfmehjbpcg	TRUE
omeejcaimpkeoklcdfe	TRUE
pgpcpifajlahfonobdg	TRUE
pgppinniiehingedhdd	TRUE
aaaacenogdhbecjmeab	FALSE
aaabjgoicblmljkheab	FALSE
ajeajaadmbbpmalchhb	FALSE
ajfmlnejefcmmapabab	FALSE
bcpgaeneoahoejhcbab	FALSE
bcpnikoilhiakgadbab	FALSE
boddmdlnfojhhpkabab	FALSE
bodoecohfamnlhokbab	FALSE
cgodkdfmcjiofplabab	FALSE
cgpghbhombikeekabab	FALSE
dbffbojjgegkahckbab	FALSE
dbfffgoabdgfcaagpob	FALSE
dlcebmhhchgbjbmabab	FALSE
dlcfonabeeidagncajb	FALSE
egfignagihkofckobab	FALSE
eggdbkhkhfnmndkabab	FALSE
fbbabdimijphpbaeekb	FALSE
fbbhmaifhghmhchlbab	FALSE
floohkenfdagbbeicab	FALSE
flpcpeiokdjepcnabab	FALSE
ggehokbomoonihiabab	FALSE
ggfbeggnkepkhmoabab	FALSE
happkknmfaddomahbab	FALSE
hbaanckidpknkendbab	FALSE
hkkphmoalghflbfdacb	FALSE
hkljpmcmchbhbfiabab	FALSE
ifbobomlpkgccnoabab	FALSE
ifcmmoaapebfeilboab	FALSE
ipaigaopcakohhgblab	FALSE
ipcdmhkldgpekgfabab	FALSE
jjdlgclnlmllhmoabab	FALSE
jjdmendpokdgjlpabab	FALSE
kdjnhbkefelpkcpabab	FALSE
kdkcpjkbbgpjmieabab	FALSE
knpnlnmlhajaabmkhab	FALSE
koabhbkjjghpodmmhab	FALSE
lkjpfimdknlfmndabab	FALSE
lkkdgiplkbojeajfbab	FALSE
mdcdjjdjfphfnjfabab	FALSE
mddblohkjapglgpfbab	FALSE
mnlppemgndhojpbabab	FALSE
mnmekejkhoanfnalbab	FALSE
nifhndioniclfafpbab	FALSE
nifkjhkmmaegikhibab	FALSE
obplooecbghaffbffab	FALSE
ocabbjmhmmpaaaflnjb	FALSE
olegjckooejgjjoabab	FALSE
oleldeillfljiboabab	FALSE
phfpbjagidbjdofkkab	FALSE
phgbmndppdcdbijabab	FALSE
