aaagmkdncc	TRUE
aadmakmokl	TRUE
ajcpoejdgd	TRUE
ajdnfabfag	TRUE
bbppdmoofh	TRUE
bcanboaakb	TRUE
bmfhjbhkef	TRUE
bmhohenega	TRUE
cfpbcjcnpb	TRUE
cfpmbfffbm	TRUE
cooepngpai	TRUE
coopifkcee	TRUE
didagkdmjb	TRUE
diddebfgao	TRUE
ecgpealcde	TRUE
echioppnca	TRUE
elphijjajg	TRUE
elpncgcklh	TRUE
fgkpmamjpc	TRUE
fgldnlodfe	TRUE
ganhlefahi	TRUE
gapdpfoibi	TRUE
glfjghegcm	TRUE
glfkcndhbp	TRUE
hfipdoigjk	TRUE
hfjphhcbnj	TRUE
iaefdgfhid	TRUE
iaeifbeoif	TRUE
imajogggoj	TRUE
imbgbnlbba	TRUE
jginflcmkj	TRUE
jgkfihlmdb	TRUE
kbpoedinmb	TRUE
kccnhogcmp	TRUE
kmcepojeko	TRUE
kmcfnoadke	TRUE
lgimdancoh	TRUE
lgjdmnjkop	TRUE
mccmmbjjdp	TRUE
mcddohhfgd	TRUE
mncgblbcgk	TRUE
mnfekhlonn	TRUE
nhjhbppakn	TRUE
nhjlbidadn	TRUE
ochmipncmi	TRUE
ochodkiojn	TRUE
omjhlgaonn	TRUE
omlehoieni	TRUE
pgchhcjjcm	TRUE
pgehgnknap	TRUE
aaagmkdmba	FALSE
aadbmalnoa	FALSE
ajecmcbaaa	FALSE
ajfglkpaaa	FALSE
bcemcapaaa	FALSE
bchcbiaaaa	FALSE
blkekgaaaa	FALSE
blkihcaaaa	FALSE
cfemgcaaaa	FALSE
cffbndaaaa	FALSE
cohbeabaaa	FALSE
cohjnkaaaa	FALSE
dimdflaaaa	FALSE
dimpacnaaa	FALSE
edbdmbaaaa	FALSE
edbpbdaaaa	FALSE
enbgkcaaaa	FALSE
enbgpeaaaa	FALSE
fghnkoaaaa	FALSE
fgificaaaa	FALSE
gbadpfnaaa	FALSE
gbaobicaaa	FALSE
glegljaaaa	FALSE
glekaehaaa	FALSE
hgfjojaaaa	FALSE
hghphgaaaa	FALSE
iailpoeaaa	FALSE
iajfblmaaa	FALSE
ilioipaaaa	FALSE
iljiiakaaa	FALSE
jgdngcaaaa	FALSE
jgeokiaaaa	FALSE
kcgbankaaa	FALSE
kcgmgbaaaa	FALSE
kmfodoaaaa	FALSE
kmfopcaaaa	FALSE
lgmjidaaaa	FALSE
lgmljfaaaa	FALSE
mcbakmnaaa	FALSE
mcbloiaaaa	FALSE
mmelomaaaa	FALSE
mmgecmaaaa	FALSE
nhpjmpaaaa	FALSE
nhppjiaaaa	FALSE
ocbcmdaaaa	FALSE
ocblolaaaa	FALSE
omfigkaaaa	FALSE
omfoelaaaa	FALSE
pgeohlaaaa	FALSE
pgfapmpaaa	FALSE
aaagmkdmccn	TRUE
aadakmnjlfn	TRUE
ajcdlpnncph	TRUE
ajclcjadfjp	TRUE
bccgkkkiele	TRUE
bcckoghadij	TRUE
bmdiiembhgb	TRUE
bmeemgmofji	TRUE
cfdfagjfkip	TRUE
cfejhoeehco	TRUE
conbikecdfa	TRUE
conijmibflh	TRUE
diiaopjjboa	TRUE
dijajbcebin	TRUE
ecdffiomofa	TRUE
ecdkmpejdmp	TRUE
emolljnmkkh	TRUE
empgbphohng	TRUE
fgpdleljijg	TRUE
fgpemojhgma	TRUE
gbbjojhipdn	TRUE
gbbkkbbidjl	TRUE
gklpbpckhpo	TRUE
gknooofmlei	TRUE
hflfcoeinpa	TRUE
hflondiaiae	TRUE
iafjlodgpfe	TRUE
iafkhcokmcc	TRUE
ilnhkhjpkfc	TRUE
ilnjoofolkn	TRUE
jggfkiolebg	TRUE
jgghakimdcb	TRUE
kbpmolknphb	TRUE
kcdecfkmhkc	TRUE
kmfmgiamhhf	TRUE
kmfplmfklfa	TRUE
lhdnbalidld	TRUE
lhefabnaadg	TRUE
mccghoedgjo	TRUE
mcchmcomnia	TRUE
mmmolnkadld	TRUE
mmnddnkppcf	TRUE
nhlkpiefknb	TRUE
nhlpaeojpoh	TRUE
objnbmhgiai	TRUE
obkepjhibdk	TRUE
olnompdkndc	TRUE
olpflelneph	TRUE
pfpedepledf	TRUE
pgabhbohoap	TRUE
aaalfnlaemi	FALSE
aabccjhbnaa	FALSE
aknebiccaaa	FALSE
aknkekhcaaa	FALSE
behebpamaaa	FALSE
behnkelaaaa	FALSE
bnajjcflaaa	FALSE
bncafllnaaa	FALSE
chiglcbaaaa	FALSE
chinlcnaaaa	FALSE
dddeiddaaaa	FALSE
ddfogglaaaa	FALSE
dokncobaaaa	FALSE
dolmmlkaaaa	FALSE
eilidpmaaaa	FALSE
eimmbhanaaa	FALSE
fcggbbhaaaa	FALSE
fcgmnmgaaaa	FALSE
fldombhaaaa	FALSE
flfbjjlaaaa	FALSE
gfafofgnaaa	FALSE
gfambcjnaaa	FALSE
gpicenlaaaa	FALSE
gpkfaaifpaa	FALSE
hjbkoegaaaa	FALSE
hjblmdiaaaa	FALSE
idfamlamiaa	FALSE
idfonbkaaaa	FALSE
imncchnaaaa	FALSE
imoapponaaa	FALSE
jgnefkgaaaa	FALSE
jgnjcicaaaa	FALSE
kbehncnaaaa	FALSE
kbeiolnaaaa	FALSE
kleoopnaaaa	FALSE
klgohdbaaaa	FALSE
lflgblnaaaa	FALSE
lflkphmaaaa	FALSE
lpoonohaaaa	FALSE
lpopbmbaaaa	FALSE
mkaahcdndaa	FALSE
mkamidloaaa	FALSE
nehpikkaaaa	FALSE
neincpjaaaa	FALSE
npdembbaaaa	FALSE
npeljedaaaa	FALSE
ojfplmoaaaa	FALSE
ojhodabkaaa	FALSE
pemanpdhaaa	FALSE
penaobdgaaa	FALSE
aaalfnlaebab	TRUE
aabcpncjhbnf	TRUE
akmbfmdafmel	TRUE
akmcfokfiocf	TRUE
bfbajbdcoacg	TRUE
bfbbmgohmcig	TRUE
bmocbjbjefjj	TRUE
bmojmgcmbcgk	TRUE
cibadfmebeln	TRUE
cicljfilejek	TRUE
dcobgbobbcji	TRUE
dcokbmpgdbcb	TRUE
doekcibeffhb	TRUE
doekncelfdhd	TRUE
eipnhnhihfmm	TRUE
ejaflnepgjbj	TRUE
fcembbaconnb	TRUE
fceohdamelbo	TRUE
flommkmcjioj	TRUE
flpojkodlnme	TRUE
gfnbchgdibcl	TRUE
gfnbmlfmklfk	TRUE
gpmnfdmikabi	TRUE
gpnephonhpec	TRUE
hjjemjgpliek	TRUE
hjkhiabaccbg	TRUE
icmndolppifk	TRUE
icnalikgolkd	TRUE
infgabkdkbbn	TRUE
infhfjacadfg	TRUE
jgojnickdlak	TRUE
jhbmebhkgden	TRUE
kcaifjoedgmc	TRUE
kcakhffmaceg	TRUE
kldpgigkokfc	TRUE
klglgfkebeln	TRUE
lekcbkkedpdk	TRUE
lekfkhjmpdol	TRUE
lpljjekpbhdp	TRUE
lpmffealjael	TRUE
mldcfaehnggp	TRUE
mleagmpmfpmd	TRUE
nemigaljjbjk	TRUE
nemjdcgcdkdh	TRUE
npcgejdcohcj	TRUE
npcmjkdikpoh	TRUE
okckeeajdeah	TRUE
okcmafeififk	TRUE
pepjalgnedna	TRUE
peplmmmdnhgd	TRUE
aaajkjicgmia	FALSE
aabhmkjgkjaa	FALSE
akajbipkjlaa	FALSE
akcpkbjmjaaa	FALSE
bdhapcdmlaaa	FALSE
bdifojbabaaa	FALSE
bmlamhkkfaaa	FALSE
bmljgjncaaaa	FALSE
cgkffpclaaaa	FALSE
cgkilepdaaaa	FALSE
dbnbomnhaaaa	FALSE
dbngldlcaaaa	FALSE
dmogmoihaaaa	FALSE
dmpipkiiaaaa	FALSE
ehhafkkggaaa	FALSE
ehijhmhdaaaa	FALSE
fcbklkgfaaaa	FALSE
fcbmhikkaaaa	FALSE
fmmaaeegkoaa	FALSE
fmmcppijaaaa	FALSE
gffoeigapaaa	FALSE
gfgbmpekaaaa	FALSE
haiicnegiaaa	FALSE
hajdgfoplaaa	FALSE
hlgngadfnaaa	FALSE
hlhjfbjdaaaa	FALSE
ifngojhjaaaa	FALSE
ifpjjikeaaaa	FALSE
iplhnimbaaaa	FALSE
ipmelakgiaaa	FALSE
jjlinpahfaaa	FALSE
jjmdkkoeaaaa	FALSE
kedeadkfhaaa	FALSE
keeknmeagaaa	FALSE
kodhpiijaaaa	FALSE
koengkhkaaaa	FALSE
lijedjlbaaaa	FALSE
likippjlaaaa	FALSE
mdbeagmbgaaa	FALSE
mdbnbikhaaaa	FALSE
mnplbdeeaaaa	FALSE
mobdmkknaaaa	FALSE
ninapmgkkaaa	FALSE
niobjpcbaaaa	FALSE
ocfjlophaaaa	FALSE
ocfklmjmaaaa	FALSE
ombfklblaaaa	FALSE
ombnfbapoaaa	FALSE
pgbeohkiaaaa	FALSE
pgddiagneaaa	FALSE
aaajkjicgmjin	TRUE
aabkjgkjmadbk	TRUE
akbaknlmebhal	TRUE
akbphflkokepa	TRUE
bdiejefgnehbl	TRUE
bdiohageagckb	TRUE
bnbhjddgfdaab	TRUE
bnbjfolanbhlg	TRUE
cgmhhimhnnknf	TRUE
cgniehfnefdhl	TRUE
dbhmecngipmko	TRUE
dbillbdhdaged	TRUE
dlfpgpcgkfmbd	TRUE
dlgkcdgcbcngo	TRUE
egmjgpbheopih	TRUE
egnhbaonbdahb	TRUE
fbkekolfnkcpo	TRUE
fbmhgpjbpeafb	TRUE
flcmljpjbofaa	TRUE
flegdjeomofgf	TRUE
ghfglmellckfg	TRUE
ghgbhecnhjlnm	TRUE
hanmanmnffoii	TRUE
haoknfdjgjilh	TRUE
hlcjdggjgdlab	TRUE
hlehdlcokkaic	TRUE
ifhehocakpabl	TRUE
ifhggdkcbgbhj	TRUE
iplefpnbppdpl	TRUE
ipmfmehkjnddl	TRUE
jkeilhfhnoace	TRUE
jkejpebhgifop	TRUE
kenipihggnlfo	TRUE
kenjapelgncdh	TRUE
kohogfogdienp	TRUE
koibdaifnhjnm	TRUE
liepdidhkejhb	TRUE
lifeicjiajnab	TRUE
mcldbfkeghikd	TRUE
mclkjckllgkmb	TRUE
modncjamadfcl	TRUE
moedjbgmibdhm	TRUE
nipkfnjngfgll	TRUE
njalbdjhioedm	TRUE
ocbkakmefokdc	TRUE
occcgfogojdal	TRUE
olpjbkebbfmhg	TRUE
ombkappoigdhb	TRUE
pgdgmhcipmame	TRUE
pgelbndlfnocb	TRUE
aaaagpgnneeda	FALSE
aaaohphfbooka	FALSE
akeppgeojpaaa	FALSE
akfefmcfpeaaa	FALSE
begnnokabhaaa	FALSE
behdlplklaaaa	FALSE
bohildmgiaaaa	FALSE
bohnmngipaaaa	FALSE
cjoopcdnpaaaa	FALSE
cjpackjalmhaa	FALSE
ddeoimobfaaaa	FALSE
ddfeecgplaaaa	FALSE
dnkhfokhagaaa	FALSE
dnleimgngaaaa	FALSE
eifcgmglmaaaa	FALSE
eifdogfealaaa	FALSE
fdfifbhpbaaaa	FALSE
fdgbnfbnpaaaa	FALSE
fmakpagjdomaa	FALSE
fmdhihfllaaaa	FALSE
ghbmihddkaaaa	FALSE
ghcmfgaiahfaa	FALSE
haphiljpbfaaa	FALSE
hbcajgnjnbaaa	FALSE
hkiggfehiaaaa	FALSE
hkinoobpkaaaa	FALSE
ieknlbofdaaaa	FALSE
ieljdflmpaaaa	FALSE
jahogkopddaaa	FALSE
jajljnfemnaaa	FALSE
jkpnkifmhaaaa	FALSE
jlafjgjgamnaa	FALSE
kdochhilfaaaa	FALSE
kdohomglfaaaa	FALSE
knnccmndfaaaa	FALSE
knnhioclfaaaa	FALSE
lgoaedocdiaaa	FALSE
lgonngkkbaaaa	FALSE
mbdfpbbhoaaaa	FALSE
mbeangijfiaaa	FALSE
mmjbpejbiaaaa	FALSE
mmjleeleoaaaa	FALSE
nfojolajgmaaa	FALSE
nfpnkejafiaaa	FALSE
oabpffdpjoaaa	FALSE
oacpnbphklaaa	FALSE
olaomcknkkaaa	FALSE
olbdmlomdaaaa	FALSE
pejdlhkdfaaaa	FALSE
pejmnododaaaa	FALSE
aaaagpgnneebab	TRUE
aaaodahphfboab	TRUE
akfpcjohkjijca	TRUE
akfphpkgogkdcm	TRUE
bfeppocpkcdphf	TRUE
bfgjhppaphljeo	TRUE
boldkahchecokn	TRUE
bolekiehckdnif	TRUE
cikcjmohoidnda	TRUE
cjadmgmljhjelb	TRUE
ddigfmghpihpkc	TRUE
ddjdihnaodbpen	TRUE
dnfadafmgomkfb	TRUE
dnggogkfkphima	TRUE
eiomjgcbhceldd	TRUE
eipiinbalfifnc	TRUE
fclkoehcahnkkp	TRUE
fcmnmjhlinokab	TRUE
fmfmoakdjbfcno	TRUE
fmfppofgcmpkeg	TRUE
ghckhokbbenija	TRUE
ghcojnagmefkop	TRUE
haldgflpnljpgl	TRUE
halepkiamhejkh	TRUE
hkneejmhcnhnee	TRUE
hknpeakjocipan	TRUE
ifggldmofcljpk	TRUE
ifiebnomekbplf	TRUE
jaebefemonnknp	TRUE
jaecngambflled	TRUE
jkadmckplkblbn	TRUE
jkajffggfoapfn	TRUE
kdninjmjadgdob	TRUE
kdnpajhlmphldh	TRUE
kmoobjphkejaon	TRUE
kncedjdochfjfe	TRUE
lhagemmhboppnn	TRUE
lhbffajlhncolo	TRUE
mbhinkghhgnilp	TRUE
mbhlbkhifkoljc	TRUE
mmhnncodlkogki	TRUE
mmibmfkgikagmp	TRUE
ngkcnoiafahmeb	TRUE
nglmgbilipaogb	TRUE
oabcmfgaddfmnp	TRUE
oabeidjakockga	TRUE
okjhkkmihoepdn	TRUE
okkanpllcjojok	TRUE
pfdjgojefhbcmp	TRUE
pffapjoedkbopd	TRUE
aaajiimnmpbhha	FALSE
aabeoeempmliaa	FALSE
akembjiiccbaaa	FALSE
akgdnojjjmcaaa	FALSE
beodlidfamgaaa	FALSE
beojdidoloaaaa	FALSE
bomnjilodbaaaa	FALSE
bonpgnfodeaaaa	FALSE
ckcijjjdncaaaa	FALSE
ckdfgbnimiaaaa	FALSE
ddjgdfdmggaaaa	FALSE
ddjhfdfghkaaaa	FALSE
dnpkajblmallaa	FALSE
dobbganimgoaaa	FALSE
ehjdpinfgjaaaa	FALSE
ehjefglmikaaaa	FALSE
fcjjngeaimkaaa	FALSE
fcllkjfighaaaa	FALSE
fnfnilndllaaaa	FALSE
fnfokmgpgcaaaa	FALSE
ghnfdofdgnaaaa	FALSE
ghnlhpnopbaaaa	FALSE
hdccadjhefdaaa	FALSE
hddggfjmkajaaa	FALSE
hnpgfgfenmaaaa	FALSE
hnpmhildgmaaaa	FALSE
ihlpfcodpfaaaa	FALSE
ihmcngmgjkaaaa	FALSE
jbflckmhgdaaaa	FALSE
jbgahgaajnacgi	FALSE
jlmnhlhjgoaaaa	FALSE
jmallnepbleaaa	FALSE
kfnipanbhalcaa	FALSE
kfpjlnjkajfaaa	FALSE
kpkbmnkdlfaaaa	FALSE
kplaidgfmnfaaa	FALSE
ljddjapainmfaa	FALSE
ljggaknamdhfaa	FALSE
meddbiliciaaaa	FALSE
meedhipfcaiaaa	FALSE
mnjjalcokhoaaa	FALSE
mnkjmhiccakaaa	FALSE
nhkmhgbenjaaaa	FALSE
nhknifjoijaaaa	FALSE
obbdlfjogoaaaa	FALSE
obbfeacneachaa	FALSE
ollolfbgheaaaa	FALSE
olnbphodhoaaaa	FALSE
pfigiigencaaaa	FALSE
pfilnkeihpaaaa	FALSE
aaajiimnmpbhhep	TRUE
aabeempmlinmeap	TRUE
akefdmfmfpadhkb	TRUE
akhabchgijggcfi	TRUE
begmhpiopjbpjlc	TRUE
behbgkfiojakpeh	TRUE
bolppfaljhnmckm	TRUE
bomblfeiimmdaid	TRUE
cjencfnbjikohai	TRUE
cjeogkkdceapooc	TRUE
debegocglnbmbcl	TRUE
decambcleanlomb	TRUE
dnpodkkenlkmcjh	TRUE
doaanfakoigloll	TRUE
eimchmbbhifbmjf	TRUE
eimkgchpcigelib	TRUE
fclehiddlhibemb	TRUE
fclfkoiaffiijci	TRUE
fncnjkgigbgjmma	TRUE
fnfefmjdaloafei	TRUE
gicmfepjgcoakmi	TRUE
gidbkfpkkjnegai	TRUE
hclfbpokjkppilh	TRUE
hclimediadhjjik	TRUE
hnjaibdmpaehodk	TRUE
hnjlalbmjgampin	TRUE
ihienpbnipgcagi	TRUE
ihjbpobkflmkjep	TRUE
jbgnndpnimfglnd	TRUE
jbhggbhgnchjcda	TRUE
jlnfgaekdfahonb	TRUE
jlnfmmpfegekfek	TRUE
kepkodllgebmnid	TRUE
kfdffdejnddboeg	TRUE
kplhnffpfpibdhb	TRUE
kplkcombcmipbll	TRUE
lkhfhoppghlnnkj	TRUE
lkhngmjjemddnnn	TRUE
mecdcdbgmbgbeoc	TRUE
mefgohhkaipkedg	TRUE
mnmnjchmdnnamfj	TRUE
mnoimcobfmdpbid	TRUE
nhdlnflhieiohcn	TRUE
nhdmdebnamglabb	TRUE
oapengiaodfpfbk	TRUE
obakkhkbelfooee	TRUE
olgnbggobheocip	TRUE
olhccccakkdpokm	TRUE
pfggdlaoieelfih	TRUE
pfglfgnednjbnlg	TRUE
aaahpbbkhbikida	FALSE
aaaijoihooannij	FALSE
ajoiooogdmhjaaa	FALSE
ajoncmjaiaiklna	FALSE
bedodfknkdgaaaa	FALSE
bedpfgcjdahcaaa	FALSE
bojlcjhddkmaaaa	FALSE
bokkdhldmhjaaaa	FALSE
cjckjkihbplaaaa	FALSE
cjckjkiiilfaaaa	FALSE
ddecmdkandnhaaa	FALSE
ddejaofgjikpaaa	FALSE
dnfafoaoaaeijja	FALSE
dnficlklkocaaaa	FALSE
eigpoflgfnbaaaa	FALSE
eihbioanolegaaa	FALSE
fdccbaonhcliaaa	FALSE
fdcgilggkpacaaa	FALSE
fmabagefahnglja	FALSE
fmagehkamgemdaa	FALSE
ghghmhgkimoaaaa	FALSE
ghhdalpljhmfaaa	FALSE
hbmcaighdpihaaa	FALSE
hbmjkhbaefnhaaa	FALSE
hmcmjfjnjjcaaaa	FALSE
hmcoghjcnljaaaa	FALSE
iggefcdaedfkaaa	FALSE
ighaoahimjmlaba	FALSE
jbfimojgkipaaaa	FALSE
jbfkaeacbnnoeaa	FALSE
jlggmanhbadjnaa	FALSE
jlghnaanhllcbaa	FALSE
keefonjmikpaaaa	FALSE
kefnfbhojfdaaaa	FALSE
kofcgcfmpnoaaaa	FALSE
kofchieoeibaaaa	FALSE
ljgeokbppidaaaa	FALSE
ljgpcocjmmeaaaa	FALSE
mdhpnfbojdiaaaa	FALSE
mdikafolfjekaaa	FALSE
mpgmkoeacbgoaaa	FALSE
mpgmogjjfhdaaaa	FALSE
njdpgdoafdlgaaa	FALSE
njenoalmoaedoaa	FALSE
oebcgimjlojaaaa	FALSE
oecjcipndgcaaaa	FALSE
ommnkjnmkchaaaa	FALSE
omofimjfgdgaaaa	FALSE
pgbbcabfjilpaaa	FALSE
pgbcfmechncaaaa	FALSE
aaahpbbkhbhjhcjp	TRUE
aaaiihooannijbab	TRUE
ajmgmlmndlidgndp	TRUE
ajmjfachbkainfdc	TRUE
beiaahpbakfbfgki	TRUE
beicfimbbggfkkbo	TRUE
bobooppddnocpmfm	TRUE
bodkkjjkkiihibpl	TRUE
cimokijkbdhkcmop	TRUE
cinjmgfhecldlglb	TRUE
dcndlpbiainolhmf	TRUE
dcpppefolkhgfgpf	TRUE
dmbgkgchbmaeicok	TRUE
dmbkfggfgapkafan	TRUE
eidjdebajoidbmlc	TRUE
eidlbldiklbnkmnl	TRUE
fcjcgbcpnigifbli	TRUE
fcmpodaddeodklbg	TRUE
fmkipcilegbokddl	TRUE
fmkmcfhgedjojkcb	TRUE
gghdepnoplfjncmi	TRUE
gghdgifakmjbpfgl	TRUE
hbdlmdjokolbbbea	TRUE
hbeikpnfnnpncgpm	TRUE
hmfgemeknkbedfhi	TRUE
hmggennciadabcnj	TRUE
igolkkhgkdiedpoi	TRUE
igpfjgfbencnoded	TRUE
jbgljaepacnnhdoe	TRUE
jbhggpdjmgjklmfc	TRUE
jlcplkaidojgobbm	TRUE
jlgjjgfbdamlndjh	TRUE
kffmageanomdobjc	TRUE
kfhcoailladhgcjd	TRUE
koojmhfmfklmngio	TRUE
kopcddeohnejjncb	TRUE
ljmjidfikebfkpoh	TRUE
ljmkipnjfffhoggh	TRUE
mefpaknadgdclonm	TRUE
mefpebgoeiklonej	TRUE
mphmpfdhgbhehagh	TRUE
mphomlnogicjdpfe	TRUE
njhjkifingpcaeki	TRUE
njibhnpflennfcmb	TRUE
odmcnnpdcmacojap	TRUE
odnpehlnekladffh	TRUE
onedihgifddgkpnd	TRUE
onencnhcmafakfik	TRUE
phaganjjpoajpjlh	TRUE
phbonlhcmidcfefd	TRUE
aaabjnobhcpebmca	FALSE
aabdhhinibdkmcaa	FALSE
alaekjlhnicafiga	FALSE
alcbjeaokjaihnja	FALSE
bdokeifdpockaaaa	FALSE
bdpbopicaagpchaa	FALSE
bobjccmeknfkaaaa	FALSE
boddfaofbhdkeaaa	FALSE
chnkkebmdnmlaaaa	FALSE
chpdlhnfidpmaaaa	FALSE
dbebpgdnfminaaaa	FALSE
dbeholbgophgaaaa	FALSE
djpeniokicobaaaa	FALSE
djplfbjdcogpaaaa	FALSE
eejcbmljllpanaaa	FALSE
eejicfnjbodiaaaa	FALSE
epnofjdabbeeeaaa	FALSE
eppjmhjlfncgaaaa	FALSE
fjjchcjcifaclaaa	FALSE
fjkebpgdpppkaaaa	FALSE
gdpcpmoicdkbaaaa	FALSE
gdplgjeiciliaaaa	FALSE
gofmllianhndoaaa	FALSE
gogahhdjmlkfnaaa	FALSE
himdmbicmkdgaaaa	FALSE
hiohaaffdlbbaiea	FALSE
idomjcaodgcijaaa	FALSE
idpkbfeejjgagaaa	FALSE
infdkgcekbggaaaa	FALSE
ingjdhpfhipeaaaa	FALSE
jidmopbbacjbjaaa	FALSE
jifgoadbjjkgaeaa	FALSE
kcgekmlliamcfaaa	FALSE
kcjjlojblokeaaaa	FALSE
knaicnngddeljaaa	FALSE
knalghlgdibckaaa	FALSE
liknkcebpmpmaaaa	FALSE
likomcbinpceaaaa	FALSE
mcocifmljjibaaaa	FALSE
mcopifbejfdeaaaa	FALSE
mmcjlhmbofbeaaaa	FALSE
mmdegdklblihaaaa	FALSE
ngidgdapacgdglaa	FALSE
ngidpofpoccmaaaa	FALSE
oaiopgnedkohpaaa	FALSE
oaipakkbhbojakna	FALSE
ojoafomekielgaaa	FALSE
ojokafoahjapecba	FALSE
pfbbppbcpponaaaa	FALSE
pffgaminhmmmbaaa	FALSE
aaagioekpknbpdkab	TRUE
aadabbkdhbppbdlbf	TRUE
akkbplcjeblfiicog	TRUE
aklfeaiiidephegab	TRUE
bekghaajddaajibbb	TRUE
belfohcekniiiefnl	TRUE
bophogbemedmhffhh	TRUE
bopihocoacgaldnkp	TRUE
ciombiddmmobkcjfp	TRUE
ciooajlafnnpcbicl	TRUE
dcikgknggoipolmmh	TRUE
dcmamacpfibmnjbdb	TRUE
dnghnbcaebadngjmc	TRUE
dnhdgkhdnpkpfjlkh	TRUE
ehjclpfmhbkihpmnf	TRUE
ehjnnbigogiknngbm	TRUE
fbgogknbegeobncff	TRUE
fbihjbcicfamolpmi	TRUE
flkdefdmifnkiokbg	TRUE
flmoigeccfblpmkan	TRUE
gemnkpmghgaociali	TRUE
geoijphfehfopgjpc	TRUE
gpcfbhblddbdpfkhk	TRUE
gpeplhenjnjhdfcmm	TRUE
hjlkgebbiphgcinfa	TRUE
hjmafoimbjgahmhpg	TRUE
ieoghhbgekodpeokb	TRUE
ieognhnfcpmhepjcc	TRUE
iolmgpnmeilkkgpef	TRUE
iomdnkljkflhoeklc	TRUE
jjmkhgmkhjkhkmabf	TRUE
jjnhhgcfhbdehefhm	TRUE
keejlcpdmacamfoab	TRUE
kefampomonddoglji	TRUE
kobbaceeboligeagj	TRUE
koceagoomcbehfalp	TRUE
libifhppbdmggahof	TRUE
libiodaojmecojpkl	TRUE
mcfogkekcnbdadeoe	TRUE
mchmmijelpnicchmp	TRUE
mlnkjjpbngmahbgla	TRUE
mlnpbhcjialjbpacj	TRUE
nfpcimajacgidalee	TRUE
nfppebnkmbjiofkfl	TRUE
oaakkfhognibpilem	TRUE
oabinlkokmmckpohh	TRUE
ojjpgpmjjnkcgkhpn	TRUE
ojkcimanikpekhlcl	TRUE
peleclnondbpahdgh	TRUE
pemgbpmljpalfnlma	TRUE
aaacoaceeafjjmige	FALSE
aaanlocjpcbnoloka	FALSE
ajepnpaialjbijena	FALSE
ajfediiadmaijlabc	FALSE
bdmaffjhinjggpaaa	FALSE
bdmjbopifomonaaaa	FALSE
bpgnmpimpgolbaaaa	FALSE
bphpeeekphmahhaaa	FALSE
ciljfheeffanecaaa	FALSE
cinblohoepdjbaaaa	FALSE
dcoknkbjdmbneaaaa	FALSE
dcpbeaaeiecbgbeaa	FALSE
dmodbdhliimenaaaa	FALSE
dmpbdkimnfjmlaaaa	FALSE
ehaoijfhfbmolnaaa	FALSE
ehcbnbkhjaldciaaa	FALSE
fbnddlaohchahbjaa	FALSE
fbnjhhjlafiigjaaa	FALSE
fmgodlhibdbffaaaa	FALSE
fmhnhaokcagoanlka	FALSE
ghjegdjmnemlcaaaa	FALSE
ghjgomjpghkahpaaa	FALSE
hdkhfnemkoapjhaaa	FALSE
hdkiacekapliakgla	FALSE
hnaciffaddanhfdac	FALSE
hnaplplhcmoccaiaa	FALSE
ighcgadeenihnjaaa	FALSE
igheckmdibjlbaaaa	FALSE
ipicljmjobmablaaa	FALSE
ipjeebiahghalcoaa	FALSE
jijnflemdfiobaaaa	FALSE
jijolkeflcapjpaaa	FALSE
kdgackbcconnajgaa	FALSE
kdhlmpgiaochkbaaa	FALSE
koieomhecomahgaaa	FALSE
koimaikeggjhlgaaa	FALSE
liahbcjaklcapcdla	FALSE
lianhjmnmglciiaaa	FALSE
mbpnkbfphbfmiaaaa	FALSE
mcagjiicpagnifnaa	FALSE
mmnchdnkhpkjabaaa	FALSE
mmnohfgnhheonaaaa	FALSE
ngnipllbdjhpbaaaa	FALSE
ngnpkbkdffcbcaaaa	FALSE
objkjdemeppjnaaaa	FALSE
oblejagmfficljaaa	FALSE
olhfngmnbamknoaaa	FALSE
olijpbalnjcagkkaa	FALSE
pfcdamkhohdccalaa	FALSE
pfciopinemijfaaaa	FALSE
aaacoaceeafjjmibab	TRUE
aaangelocjpcbnolol	TRUE
ajekccebcmnaflclbk	TRUE
ajgfpkeobpbdnpgfhf	TRUE
bedmmmalalhgamdgei	TRUE
bednnmijcebkhbmlep	TRUE
bpakccbfmchmbocckf	TRUE
bpbbkkecgidpkoabni	TRUE
cioloflmakfkoigbfd	TRUE
cipcflhoahhcjbidld	TRUE
dcipliccfilcgebaen	TRUE
dcjcbaamaidgkdcpge	TRUE
dljakojmfeanjdghig	TRUE
dlkcanmnlpfpgdoecg	TRUE
ehplkegieocdpnkdhj	TRUE
eiadcghangjllmalhl	TRUE
fdchbnofgmmemddnac	TRUE
fdeibijkoojmonghba	TRUE
fnaidckiidfgkaahig	TRUE
fnbkmdfhekipafiigb	TRUE
ghgimmdghneghanpig	TRUE
ghhggpoeifpdgjnpgm	TRUE
hdihldcclnecmmpdpk	TRUE
hdiimabbkifohhofnk	TRUE
hmkldholfbmehkfnah	TRUE
hmknpglnbjinlojfdg	TRUE
ifpdmphfbdahahndka	TRUE
igaaplodklbpenebha	TRUE
ipfhagmlpjgoabhgil	TRUE
ipfnfnachhelldnhon	TRUE
jigidlaigomophjbkk	TRUE
jihhdmpkplddneknfm	TRUE
kegcjlkfimbcjhbchb	TRUE
kegcnnibomhoehhfjc	TRUE
koapcdbffimabgonik	TRUE
kobbnnepklknibgnmk	TRUE
lhgnbgahkfadmlhlkl	TRUE
lhhingohdmiijmaeff	TRUE
mcangbngnbbeoodkgh	TRUE
mccddhalldhhaeioee	TRUE
mmegegkmmilfffnapi	TRUE
mmeioeeefahckgpjeb	TRUE
nheadfpnnboeffdepk	TRUE
nhfcdohhjpmhijinfn	TRUE
obilpllhccmalhimkp	TRUE
obioffojdkifkaeigg	TRUE
olmiddpfbajejaaokp	TRUE
olnpgfgnnminppjbjk	TRUE
pgkpliegldelcjgoho	TRUE
pgldfmhbliegkcdbmb	TRUE
aaailhobecligegbla	FALSE
aabgdenldllnpmpbaa	FALSE
akfgbbhgdofeofdaaa	FALSE
akfmabajjmpohpgcna	FALSE
behnofoihlmdakoaaa	FALSE
behoelbjkpmabcmaaa	FALSE
bopdbmemonbnieaaaa	FALSE
bopgiammhcdpkhhaaa	FALSE
cjdldlhoiiaclpalaa	FALSE
cjehmfkichjajilaaa	FALSE
ddclbpcojbofebaaaa	FALSE
dddcdchckeneafcaaa	FALSE
dmifbgbigblahpnaaa	FALSE
dmikjkjhdnpkadcaaa	FALSE
ehbomnknpkcpdhaaaa	FALSE
ehellohkiaiifcgaaa	FALSE
fbjbfccieekaknfaaa	FALSE
fbkhejgmbknoecaaaa	FALSE
fmjfcekonfobgbaaaa	FALSE
fmjonpjmfinhjkaaaa	FALSE
ggkoihdhodabekmaaa	FALSE
gglbccohmlcodoaaaa	FALSE
hbdemddicfkapldaaa	FALSE
hbdjgnaggfhpmheaaa	FALSE
hlcbclaoifafccpiaa	FALSE
hldbjdkmjmljehaaaa	FALSE
ifopbmjhnjkhkmaaaa	FALSE
ifpinhhiccjghlaaaa	FALSE
ipompkihkopmifaaaa	FALSE
ipopoblhlggepkaaaa	FALSE
jklcnfjlclpljeaaaa	FALSE
jkmaffoecpggmkiaaa	FALSE
kelanmgnjpbbbofaaa	FALSE
kenojnjinglobcaaaa	FALSE
ladiiigadfclmngjaa	FALSE
ladipcommhpaalkkea	FALSE
lkedinnpkaddnchaaa	FALSE
lkifcopagfindadfaa	FALSE
meiaockeldghdmhaaa	FALSE
meifbhbbgijjjnaaaa	FALSE
mnkmcancfokheibaaa	FALSE
mnkomappaipengohaa	FALSE
nhejeocialgajggiaa	FALSE
nheknmaomcmaloleaa	FALSE
oajijcmmdhkepkiaaa	FALSE
oaklcieceegjkjeaaa	FALSE
omakhnmmlfhiplfaaa	FALSE
omcaleabobmeinnmaa	FALSE
pfjclkbkpgdejdaaaa	FALSE
pfkdocmjjdbjfkaaaa	FALSE
aaameampngollihhbab	TRUE
aablnadkbdflmgpppef	TRUE
albegklcgocifobcjml	TRUE
alcancjegehjkmdknbm	TRUE
bemkiodkiocdcledfdj	TRUE
bfagjkgimoipldgddpk	TRUE
bopablildjpdmfiakgj	TRUE
bpbdoaeiikngobefadh	TRUE
cipkkbpnolhijcpnhjp	TRUE
cjaaangkenmhekmpfbm	TRUE
ddcmabbeopnfcfpbiga	TRUE
dddeoenecfchmmaeapd	TRUE
dmpaookhpemaiaeecgj	TRUE
dnaihniknmabnpikpel	TRUE
ejaegmklfejhgjocpdo	TRUE
ejbkgghhdoldeeolkem	TRUE
fecamaapfhkcodgjedp	TRUE
fecoaepdiimcjhpiibc	TRUE
fneghjlohiohlnlogdg	TRUE
fnffclkhecnpllgcobc	TRUE
ghobcclifpladgcgdii	TRUE
ghokfmnefjdnkpfmmfk	TRUE
hcjlclbbdmphpjbcmak	TRUE
hcjncobheahhfenfjfd	TRUE
hmjglhoiiimemklbaom	TRUE
hmjjdfekhmhjpcnhndf	TRUE
ifbpoidcfpfbpoeihjd	TRUE
ifcffoplcnldbdoalik	TRUE
ipdgecdbjdncmngaalp	TRUE
ipdkmmgdmmlikenafjd	TRUE
jjnpeijnmkojhifloej	TRUE
jjpmikpmeaplmbahcen	TRUE
kcocfabjpbbjfndlina	TRUE
kcoclmgcpbadimgijjj	TRUE
knljddgmclajcakaknl	TRUE
knogiabmkplkikkfodi	TRUE
lidhfdeakjomhghokfn	TRUE
lidnanmkgaljjoagplm	TRUE
mddfjikkcdghoifonjg	TRUE
mdedlfkfgneiclhoddo	TRUE
mmkeokgkhkealnlldon	TRUE
mmlmpkblidgmmnfgaca	TRUE
nfphgkhgcmlljalaipj	TRUE
nfpnhhjiahihjeffgke	TRUE
oaglffaepelgcagjeni	TRUE
oajdogocoeemocekcff	TRUE
olklkeepnfiojdieeak	TRUE
olmehofikllfplgcfnj	TRUE
pfcljfnjgnejablhnbb	TRUE
pfdcikhanokoldanmdc	TRUE
aaaafjchhgllgpcfhel	FALSE
aaaagaefopkcpdafgfl	FALSE
aldphnbfmkiadalfgha	FALSE
alelfopmdmomebceaaa	FALSE
bfkcjbdkalddckkpaaa	FALSE
bflajmfpainpjpgfpaa	FALSE
boohmecadhlapfghfaa	FALSE
boolgalojbclgcapkaa	FALSE
cjkbjmecogpmafklaaa	FALSE
cjmaennmkibhaaninka	FALSE
ddmcbiekiiogjflaaaa	FALSE
ddmeeoflpmociejaaaa	FALSE
dnkcfncnnibdnkdaaaa	FALSE
dnknlnaelldogdadiaa	FALSE
eicbeenlkcldjdlaaaa	FALSE
eidcicmdfofbijpaaaa	FALSE
fbimbgdfompepnnaaaa	FALSE
fbjcgceiaadcadnclpa	FALSE
fmkclapagiobgclljaa	FALSE
fmljongahgabjknkpaa	FALSE
gigcdedaoelcmgfdaaa	FALSE
gigcgkakcjnoelokaaa	FALSE
hcpmlnmkmjbaochcaaa	FALSE
hdajlojaaednnbhboba	FALSE
hndbeichkcbgehiaaaa	FALSE
hndeopnflifjpjeaaaa	FALSE
ihhmkhkfdlkfompaaaa	FALSE
ihhmpfmeemjclmoaaaa	FALSE
jaokokdeicakemlidaa	FALSE
japhahngfcamijpfpba	FALSE
jlnbcdobegnjcbeaaaa	FALSE
jlphieefkpaeliomaaa	FALSE
kflbcjihmgnafdfkaaa	FALSE
kfmeioippmadcfbfaaa	FALSE
laioiibnncombcakeaa	FALSE
lajgmbhclnhjdkelaaa	FALSE
lkijnhgbjpfaednmaaa	FALSE
lklaohadedpbkkpdlaa	FALSE
megjebafonnmjfpcaaa	FALSE
meiadecfdcnnabffgaa	FALSE
momngjhknhnikbbaaaa	FALSE
momokicpncaemipiaaa	FALSE
nkjacflljofaocdkcaa	FALSE
nkjljnaapkdceignkaa	FALSE
oeilhfflmhlndigaaaa	FALSE
oejhofbgkimciakpaaa	FALSE
onhbbipbffkipoeaaaa	FALSE
onhpiollmkmieieaaaa	FALSE
phhahnlplocokgpiaaa	FALSE
phhccdikkcojfnpaaaa	FALSE
