aaebogcijn	TRUE
aaecpljpib	TRUE
akpkifkfgp	TRUE
alahgdjimb	TRUE
bfjfpfafcp	TRUE
bfkkijiocm	TRUE
bpfngkijbn	TRUE
bphcdoohfc	TRUE
cjecegagem	TRUE
cjeecdjnnl	TRUE
dehmecdkgb	TRUE
deiciilpgj	TRUE
eadmcembik	TRUE
eaecomplon	TRUE
ekcliikjem	TRUE
ekdhodgeeo	TRUE
feanjjnkcn	TRUE
febbldcbka	TRUE
fnpnokhmfp	TRUE
fnppdglnjh	TRUE
ghjfeljoep	TRUE
ghkamlolph	TRUE
hbedbhpfml	TRUE
hbejmkafbc	TRUE
hjfadommhd	TRUE
hjfcbhkbjo	TRUE
idljoppaab	TRUE
idmdpfdhkc	TRUE
iocnfmlilo	TRUE
iofcicgbnd	TRUE
jiigcicaic	TRUE
jiimdfcndp	TRUE
keaifonink	TRUE
kecfjmnnib	TRUE
kohmenbppe	TRUE
kohmofbnhi	TRUE
ljfcamdepf	TRUE
ljfhppcogc	TRUE
mcpbidmjpn	TRUE
mdagllcbdo	TRUE
mobdbdipin	TRUE
mocaanmikb	TRUE
njfipdjlbp	TRUE
njgfjolhmb	TRUE
ocgpcclefo	TRUE
ocicdphmbp	TRUE
omolpmleac	TRUE
omopplcjig	TRUE
pgfkfagpmf	TRUE
pggoagiiop	TRUE
aaamgldfej	FALSE
aadhfpagmh	FALSE
aknekjnkna	FALSE
aknlldckka	FALSE
bfgmlggaha	FALSE
bfhgemifaa	FALSE
bpgefnkiaa	FALSE
bpgjclloaa	FALSE
ckodecgdaa	FALSE
claohpdjma	FALSE
dfahhmhhoa	FALSE
dfbbinemaa	FALSE
dpkchbhfaa	FALSE
dpkddncnaa	FALSE
ejhjhljkaa	FALSE
ejhpanohla	FALSE
fclbklenaa	FALSE
fclmkcbmaa	FALSE
fnhpdjkfaa	FALSE
fnimpjjaam	FALSE
ggnodonmaa	FALSE
ggojdlbdaa	FALSE
hajckmmcoa	FALSE
hajjicmjam	FALSE
hlddniccaa	FALSE
hlefgpmpaa	FALSE
iefhodglaa	FALSE
iefihilbaa	FALSE
inpeleaaci	FALSE
inpmhdmiaa	FALSE
jieepoagna	FALSE
jigfkgpcaa	FALSE
kcgojfpama	FALSE
kcieedooaa	FALSE
kmmhfamjla	FALSE
kmmkpogdaa	FALSE
lggccbhada	FALSE
lggiiommaa	FALSE
maljanmmml	FALSE
malkdpojha	FALSE
mmacmfjcda	FALSE
mmaehagokg	FALSE
ngjfhafkoa	FALSE
ngkbhellaa	FALSE
obhfnpofaa	FALSE
objcnefeaa	FALSE
olnaaldefa	FALSE
oloakcclha	FALSE
penhfgljaa	FALSE
penifiicaa	FALSE
aaagnniipjb	TRUE
aaakgfohhob	TRUE
akcegoacelb	TRUE
akeinmmmmio	TRUE
bfcnpjfjjpg	TRUE
bfcoibhokfa	TRUE
bpclcpgckji	TRUE
bpdaapibkbf	TRUE
ckfgelhjkfg	TRUE
ckfnaokkjdf	TRUE
delinohfamc	TRUE
delmlimiani	TRUE
dpjigelfcbe	TRUE
dpkgahmoldg	TRUE
ejcfcpficdp	TRUE
ejcidjkfmpj	TRUE
fcbjmpmdgkk	TRUE
fccjamnccom	TRUE
fnekoioggaj	TRUE
fnfenbciide	TRUE
ghgflcljmhe	TRUE
ghglhahnnkb	TRUE
hajofbpklfl	TRUE
halokphhoin	TRUE
hkhmnjgohlm	TRUE
hkikmloellk	TRUE
iedegifaeei	TRUE
iedihjaolkj	TRUE
iogpbhacion	TRUE
iohdgeanjpo	TRUE
jhphhnihall	TRUE
jieclffodmg	TRUE
kcaglpimjgf	TRUE
kcahkolmafb	TRUE
kmbhjdolied	TRUE
kmbmlpbfobb	TRUE
lggnbppdnof	TRUE
lghgckblpjm	TRUE
mapfchdiohl	TRUE
mbcdendaijc	TRUE
mlkpiifagbn	TRUE
mlmgkignblm	TRUE
ngcgfgggpio	TRUE
ngclpiddimo	TRUE
oaobgklklho	TRUE
oaopekaedgb	TRUE
ollnmbfnoke	TRUE
olmlafikngo	TRUE
pgelgpmoaih	TRUE
pgfbnjibljn	TRUE
aaagpckmdop	FALSE
aaakigifeam	FALSE
akhdkgkhjda	FALSE
akheinipmoa	FALSE
bekgebdfhaa	FALSE
belikpojoaa	FALSE
bpadmcpcmga	FALSE
bpakfaakafg	FALSE
ckaejfjnjda	FALSE
ckbncgepkaa	FALSE
depdeiiliaa	FALSE
depfepkikaa	FALSE
dppbpjpilaa	FALSE
eadhapmimnf	FALSE
ekedmcggeaa	FALSE
ekeplncfoaa	FALSE
ffcjhcnopaa	FALSE
ffckohmljaa	FALSE
fopcgnfpkaa	FALSE
fophahjmhpa	FALSE
gkidemkoaha	FALSE
gkihebiodaa	FALSE
hdilnkhgkaa	FALSE
hdkldpcanpa	FALSE
hoaandhegjd	FALSE
hobaheelajc	FALSE
ihfkbmaimai	FALSE
ihfmpanhina	FALSE
jalaifkjigg	FALSE
jamgkjggdoa	FALSE
jkdhnnakfla	FALSE
jkepnpkpmaa	FALSE
kdngnpjcaea	FALSE
keaalkafeak	FALSE
kofikednkaa	FALSE
kofnljchdaa	FALSE
lijcofinhaa	FALSE
lijiokkhhaa	FALSE
mcnaelploja	FALSE
mcnblkediaa	FALSE
mnhahajoadk	FALSE
mnhlgdpbnaa	FALSE
nidmohpiiaa	FALSE
nigfcmdgnaa	FALSE
obfheebjgaa	FALSE
obhamiplmca	FALSE
oldgndknkaa	FALSE
oldiolfhhaa	FALSE
pgaiahjaenk	FALSE
pgapckepcia	FALSE
aaakijihlkgb	TRUE
aabfkdeoabbh	TRUE
akeehjcafmab	TRUE
akfinncnimnp	TRUE
bfanchpbgdde	TRUE
bfbflmgmdacp	TRUE
bpdmalkbjmbg	TRUE
bpdocpmjmgia	TRUE
cjpmefolbnbb	TRUE
cjpnbafolmbl	TRUE
dfmbabckdnam	TRUE
dfmenhbgajkf	TRUE
dppplmaanhgb	TRUE
eaakdjnoeacb	TRUE
ekdfhoemmmam	TRUE
ekdjipcofiop	TRUE
feepafmjcmhb	TRUE
fehfpeilnhbn	TRUE
fpaealdjoogb	TRUE
fpafjhfedeab	TRUE
gjdhnpmomkhg	TRUE
gjdnepcpbngg	TRUE
hecpceejaodk	TRUE
hedcbppldmgo	TRUE
hoflicoaioko	TRUE
hogdbglkcgch	TRUE
ihodpeichngi	TRUE
iholajfdgibi	TRUE
jakjlegafgbi	TRUE
jalabghooalo	TRUE
jkminfcconhk	TRUE
jkmkhnnggngo	TRUE
kddbalgainab	TRUE
kdfcjgdpbnnh	TRUE
kocapennflbb	TRUE
kocllljblcni	TRUE
likmogibaapb	TRUE
lilcechgbepp	TRUE
mcojhfjcgfoc	TRUE
mdajndbanlfl	TRUE
mmodeimnjccd	TRUE
mmolibhfobga	TRUE
nhgoapdpfdkj	TRUE
nhhcncpalimf	TRUE
obhdcfhmpnic	TRUE
obhedfdjnlfp	TRUE
omlkcpfplghg	TRUE
omneaknddkic	TRUE
pgommdjoifkk	TRUE
pgopajaojgbn	TRUE
aaagpckmdopi	FALSE
aaakgifeamap	FALSE
akfokefngeha	FALSE
akgoikpohnca	FALSE
bfllecohfoaa	FALSE
bflnmmoedmaa	FALSE
bpfddllggdaa	FALSE
bpffelccpgaa	FALSE
cjlomhpceiaa	FALSE
cjlpjaimeola	FALSE
depdcjheahia	FALSE
dfaajokccnmm	FALSE
dppekehikhaa	FALSE
eaaiflakfdod	FALSE
ekfgfhbienaa	FALSE
ekfjonfpanla	FALSE
fehcolcllkaa	FALSE
feidponkigaa	FALSE
fpekcokccfaa	FALSE
fpepcppcnfaa	FALSE
gjbcnnkbcbaa	FALSE
gjbgminaifja	FALSE
hdipnljhmgaa	FALSE
hdlhgobdggaa	FALSE
hnhllkjcjbaa	FALSE
hniokjjiooaa	FALSE
ihjldnlejjaa	FALSE
ihkbecjibcaa	FALSE
jagpknflngfa	FALSE
jahhpignckka	FALSE
jjojjebjjaha	FALSE
jkbdjjbdinaa	FALSE
kdmlmhmflkaa	FALSE
kdnfndkobeaa	FALSE
knihoekmaola	FALSE
knmjojghkpaa	FALSE
linaeenlkpla	FALSE
lioaccjjcpda	FALSE
mcaklhnfcdja	FALSE
mcbdlaeoimaf	FALSE
mmpgkilmlbaa	FALSE
mmplohnhebaa	FALSE
ngkjbpjkhgaa	FALSE
nglacegefgea	FALSE
objpacelghla	FALSE
objpbmomlnaa	FALSE
omepemegcoaa	FALSE
omfahaonddnh	FALSE
pfhjhkhlniaa	FALSE
pfjknnidfama	FALSE
aaahmmfmbjhnp	TRUE
aaajopajihneb	TRUE
akeokcmfhpjpk	TRUE
akfgojoaflolb	TRUE
benbdeenaejho	TRUE
beoienemhgaik	TRUE
bpbinhkoklcko	TRUE
bpcoohhknapdm	TRUE
ckegaibflaaci	TRUE
ckhclejohkaid	TRUE
dedhejjdlnbef	TRUE
deeckapbojcaf	TRUE
doenhilidmkbi	TRUE
dofemmboecfii	TRUE
eipmbbnkebolp	TRUE
ejbccdfamdoem	TRUE
fdehgmmhhiick	TRUE
fdepcmjeomnea	TRUE
fmmgjaldflapb	TRUE
fmpbpgblnjoee	TRUE
ghgnfkfjkgjoe	TRUE
ghipdgapojeme	TRUE
halmgcpkblbgn	TRUE
halmlpnnomdon	TRUE
hlgfnpioggnfm	TRUE
hlgnngbhcocih	TRUE
iflkhfgmdflob	TRUE
ifpkaacfhboag	TRUE
ipcahfidhiogc	TRUE
ipccbedhdipbo	TRUE
jjfieaepjafeb	TRUE
jjgejhlnbcfng	TRUE
kdammmihkgpng	TRUE
kdbbicgggjglp	TRUE
knjbjhobnacem	TRUE
knkhbcmbablnp	TRUE
lhhammjmkihip	TRUE
lhhobheeghgmk	TRUE
mdbpnnkcgojng	TRUE
mddaffdmckgfd	TRUE
mnacgppcngkeg	TRUE
mnaiilponjbnc	TRUE
nhhcpfimbcloc	TRUE
nhhkicngdcldo	TRUE
oaibffofogdbo	TRUE
oaiomfeiobmnf	TRUE
omakdjggncojc	TRUE
ombfebilgmbec	TRUE
pgbcpdhjenged	TRUE
pgddmbjadolld	TRUE
aaacpdmmanhfk	FALSE
aaaigdgicfjdf	FALSE
akklgldplaolm	FALSE
akmcjljgdjooa	FALSE
behekgekdlgaa	FALSE
behiekaemenoa	FALSE
bonkjfdfadlla	FALSE
bonlcdbpahfca	FALSE
cjplceigdnjaa	FALSE
ckadmomdehnfa	FALSE
demjjfdfhipaa	FALSE
demmlmfpjhjaa	FALSE
dongobfcifhaa	FALSE
dophamdgkicak	FALSE
eilmlihagapdg	FALSE
eilpmmamegkla	FALSE
fddodhooicfaa	FALSE
fdfcoolbplpaa	FALSE
fmjamhcdnndka	FALSE
fmjfkohcdaana	FALSE
ghcpnoaehmlla	FALSE
ghdbimlendjaa	FALSE
hankeiieijkda	FALSE
hankjpmkmngaj	FALSE
hmfnjanineipa	FALSE
hmghemjgppiaa	FALSE
ifpeidapkhoha	FALSE
ifpipihdgcdaa	FALSE
ipjkdddekoafa	FALSE
ipkaoekahcjhm	FALSE
jjjhmnfcbhkaa	FALSE
jjjmmmpmpnjaa	FALSE
kdbbgagkodhja	FALSE
kdcdcdembelaa	FALSE
kmmnhajaofipc	FALSE
kmnlfekbpchaa	FALSE
liahidlhapfdf	FALSE
liblakkfadnpg	FALSE
mcoiafogeohna	FALSE
mcolimmlfmiaa	FALSE
mmmhcpfofelaa	FALSE
mmmhhibgoidaa	FALSE
ngpjjidpnclaa	FALSE
ngpmagafmngoc	FALSE
oalahagflfojj	FALSE
oallomcdcilja	FALSE
olkllpdddcfaa	FALSE
ollklgichhkaa	FALSE
pgaehkoihohha	FALSE
pgalgkogdcoma	FALSE
aaaojkbamhilfm	TRUE
aadgpoaceljelb	TRUE
alpbnaceiigkla	TRUE
alpkegcdaelklb	TRUE
bfmghmfkdngdlj	TRUE
bfmjhpdeneincb	TRUE
bplekoncnehfob	TRUE
bplheohnhboiba	TRUE
cjoimhcngcceck	TRUE
cjpfcjkkffkeln	TRUE
dejhnlopffoajm	TRUE
dekjkaamjnmkab	TRUE
dpgekglgcejpea	TRUE
dphibdaninpngm	TRUE
ekkmmiomfcdlkl	TRUE
eklpdekbeldgdf	TRUE
ffkhmanaeaeogb	TRUE
ffkjnpoaelofkb	TRUE
fpnjlccijbnbob	TRUE
gaajnpfijdcobc	TRUE
gjpmcbkilkcffl	TRUE
gkalejoicfopbe	TRUE
hfhhhgcnjgdihf	TRUE
hfhhmebdpjmidd	TRUE
hokpnnnffgdjoi	TRUE
holbialkpbbbaj	TRUE
iimdalmmdncfjc	TRUE
iimiichgcbcfkf	TRUE
jdbaicdcmehcmg	TRUE
jdbfjibeefjoib	TRUE
jnbgdmkpapjmnk	TRUE
jnbljgimophmnb	TRUE
kghafllcongghm	TRUE
kgincjbngndeof	TRUE
kpgjficleiidgk	TRUE
kpgpokkecghooa	TRUE
ljmpgnbgfpfapm	TRUE
ljoialdnfbfoek	TRUE
mdnoimcfdneddg	TRUE
mdocnaohlfooin	TRUE
modiepbhakalkb	TRUE
moedhlgbijnfgm	TRUE
nhopjknhjgogpa	TRUE
nialidnkedlimn	TRUE
obpgefcmhlddga	TRUE
ocbajngojjpgok	TRUE
olmbggjabldmdd	TRUE
olmgbggcccpmme	TRUE
pgfhkklgelheoa	TRUE
pgfniidldkkbif	TRUE
aaalmemfojkjll	FALSE
aaamacnknnfkjc	FALSE
allkgfhaagphde	FALSE
allmimehkiifia	FALSE
bfldeoggclmcaa	FALSE
bfmamogoihmlah	FALSE
bpleobhljhbeaa	FALSE
bplflpghljncaa	FALSE
cjjdjpnpimhcaa	FALSE
cjkhkemgahnkoa	FALSE
dedchjkhaidcma	FALSE
deddemhipfcnaa	FALSE
dpjacjpmgnmcia	FALSE
dpjebfbleeggaa	FALSE
ekodnghiojlnaa	FALSE
ekolfojmckkcaa	FALSE
fgbfillelgidaa	FALSE
fgcoedceafedha	FALSE
fppnnjlfpgbcaa	FALSE
gaaekkimnpfdje	FALSE
gkjdcopedmkiaa	FALSE
gklmjmcoolhhaa	FALSE
hegemjmhkbpkaa	FALSE
hegmnelcfgcdaa	FALSE
hoombenfeifgaa	FALSE
hopaocmpcdooja	FALSE
iioeiagdoohdha	FALSE
iioibcnjplimaa	FALSE
jddifjocpnenaa	FALSE
jddnkfeecbalai	FALSE
jnbmhibmajnhca	FALSE
jnebhdlphgamla	FALSE
kghcfgajnakooe	FALSE
kghoamljhdhpma	FALSE
kpgdomhbmcmnaa	FALSE
kphbjliipebkaa	FALSE
lkmdcmgecaname	FALSE
lkmhaicjfghjma	FALSE
meddghccledaja	FALSE
medfiaeofagocl	FALSE
moadpljdpnflea	FALSE
moajcdpepldkja	FALSE
nifhoaipilmpla	FALSE
nigdahnnghpdoa	FALSE
oboojbhaipigja	FALSE
ocafceiglidpia	FALSE
omhcfcklfcifaa	FALSE
omjanmieoiijea	FALSE
pfopljciejldaa	FALSE
pfphijeflbdgaa	FALSE
aaahanjpekajfdb	TRUE
aaceemdflcndbcf	TRUE
akeodoiajiaiekb	TRUE
akfbnaeicbnchnb	TRUE
bepplplfgahongf	TRUE
bfafgdijompeelf	TRUE
bojclhkefkgmadp	TRUE
bojdinicdhhjgkc	TRUE
cimlhlnmfndboio	TRUE
cinipdojfcmckpk	TRUE
dckagigiplbhogo	TRUE
dckbgkbhfihcbcf	TRUE
dmeheihgcdmennl	TRUE
dmekkackmafjgdb	TRUE
efjeeocakaedlbo	TRUE
efkgapfaeccgjdb	TRUE
eoopheogdplglnj	TRUE
eopalgofilekgdp	TRUE
fkbeghbejeoaeim	TRUE
fkciedggfkfkmck	TRUE
gfgihkjpemjfdcl	TRUE
gfikekpkiplnhid	TRUE
gpipigpkegkmled	TRUE
gploaepepddmplc	TRUE
hkajjbajollcfhg	TRUE
hkajkfelfmaabji	TRUE
idmcdidlpkjdmef	TRUE
idobdfpicpjnofc	TRUE
inkondekgjdlefh	TRUE
inlejdfphhpddim	TRUE
jiclenphlooibgp	TRUE
jidogbpigccgjie	TRUE
kcaigpjeolkdekb	TRUE
kcapbgmpfffdphn	TRUE
knkhaodphjbpghb	TRUE
knkpnjmojhgacok	TRUE
liahcphhfifgfmp	TRUE
liamoooaaeelpob	TRUE
mangckfbbnmoekc	TRUE
mankmnpdpjlgjbo	TRUE
mlddkmeimkpnjgm	TRUE
mlefbejjndlpahd	TRUE
nfejccljhienobi	TRUE
nffgcfaclfoihlo	TRUE
oahlofobmaeolmc	TRUE
oaihpeiddeeekep	TRUE
olgnmmjcnhlceeb	TRUE
olhhomfagdjojdd	TRUE
peochlmaljlhiim	TRUE
pepbooijldcglgn	TRUE
aaaedmamnkmgmok	FALSE
aadakmmmhefapml	FALSE
akcefmmlladncgm	FALSE
akcldegjfdpgdla	FALSE
belgpnpfoihgaja	FALSE
beloglhmoaeeeia	FALSE
bpbdcjenmhfekaa	FALSE
bpbkfkmhmdhboaa	FALSE
cjeojhklogahpka	FALSE
cjflmmcdjlpmdaa	FALSE
ddnlgjmkalihpca	FALSE
ddodfdcfhhcgbaa	FALSE
dnnjgghnelfpapa	FALSE
dnoaljnahhelkpk	FALSE
egoflkhdpifdoaa	FALSE
egpgdnnfeknlbaa	FALSE
fckjjgbepjfcpaa	FALSE
fckpbmojgahoena	FALSE
fnhonmnfimcinaa	FALSE
fniomaggplkkgia	FALSE
ghfbigjlccpopaa	FALSE
ghfodgoadjipaei	FALSE
hbhliglbmhcmbaa	FALSE
hbinkhpahkpkkia	FALSE
hmeahhllpjkpamo	FALSE
hmeeadilkhenjoa	FALSE
ieigaghgedcmcoa	FALSE
ieklomnelkamdka	FALSE
ipdomoeaajllgmg	FALSE
ipeijbnedmcelaa	FALSE
jidmjlfapojcoha	FALSE
jifdlhjmjcgfjaa	FALSE
kcojlkdpefdcaaj	FALSE
kconniiogigmpaa	FALSE
kmegfbnpmacfjla	FALSE
kmgbnmcfnjbfpaa	FALSE
lfmbnbblagejpma	FALSE
lfmibdiiljakfda	FALSE
lpkpmeccebkchaa	FALSE
lpmncjijaliomna	FALSE
mjmobjoebogciaa	FALSE
mjncbaemlhlmpga	FALSE
nenhngimhfpipaa	FALSE
neniaeeopdjenna	FALSE
npbdmaahmdginhk	FALSE
npconegcfbaciak	FALSE
ojmolelhmbmedaa	FALSE
ojnejgnhgjdmlaa	FALSE
pemhfgeekfnnoaa	FALSE
peodljpbeikieaa	FALSE
aaaeniojkcfjehhb	TRUE
aaanhcpljpjamggb	TRUE
ajifdifilkpaanpb	TRUE
ajifldoepplfcbfc	TRUE
bejebnmjjgakbgog	TRUE
bejjaibiehkpkain	TRUE
bpdhopcpbpanjhkf	TRUE
bpfeilklcadfoiok	TRUE
cjgjiokjlmnhabam	TRUE
cjhlgklfakjhcjpn	TRUE
dcpjoidgnldaakob	TRUE
ddbdackihdgplchp	TRUE
dnfogpefhbknmlao	TRUE
dngkbelnacbdepkc	TRUE
ehnlllbpkcbnedhn	TRUE
ehnoaidpfofhhacb	TRUE
fcdhdmfcalfhhalb	TRUE
fcdkflnecnbppiab	TRUE
fnikjeggpfifmkbj	TRUE
fnimjefgldbdkkbd	TRUE
ghipagamkbcjiden	TRUE
ghledmalacdbofjn	TRUE
hbmnmajdmmjfoben	TRUE
hbmoenpcpeiceled	TRUE
hljgkbpogdphlnlb	TRUE
hljmbioolfehfkie	TRUE
iepbgbfjdjdinnob	TRUE
ieplnecamdfecndf	TRUE
ioliifgkldfkploo	TRUE
iolologjibpjjnio	TRUE
jihncaibcbcmfhho	TRUE
jihplnenmclgnice	TRUE
kdgilioffojedgmp	TRUE
kdhcbgomkdaoeenb	TRUE
klphpopbaiaemgfb	TRUE
klppjfeojnfbaagb	TRUE
lfnakkaejjahfipb	TRUE
lfndeajnbilijmgk	TRUE
lpnhonnmkobfdofp	TRUE
lpooggmcccjnilnb	TRUE
mlakcnkoncaefghb	TRUE
mlampmgldminnlnj	TRUE
nfbcadhfmnhgmjin	TRUE
nfbenfmgnibagibf	TRUE
nonokdgmakkjknnl	TRUE
noonboilbnpmmkag	TRUE
okdjjalpmdbklnie	TRUE
okgibpnppdanojdm	TRUE
pfkbpagdoccdjahb	TRUE
pfkkbpikgeciplep	TRUE
aaadgfhiednpfnnk	FALSE
aaffmncodhkgingc	FALSE
akicchhligcdpdca	FALSE
akiihkplaghcekin	FALSE
bccejhcigddpolaa	FALSE
bcdneidblhbfegaa	FALSE
bmalokodnknpngoa	FALSE
bmbkdoflkdgnbjaa	FALSE
cfimlpfjelenfkaa	FALSE
cfjjnfgfaamlhdlo	FALSE
dapclgmjejgjjfha	FALSE
dapcpglcmhacelak	FALSE
dleicigpodnebada	FALSE
dlejiglkodegchaa	FALSE
effiejnjjcejieaa	FALSE
effipiiamikgdgca	FALSE
epkebgllhaohamin	FALSE
epkhfmjanlljaggo	FALSE
fjnciocldpppfhaa	FALSE
fjoaafdldphioeda	FALSE
geddhphdiibgjoaa	FALSE
geedfhdklkekdpaa	FALSE
goldoojodimdfbaa	FALSE
golhgajiamonhngg	FALSE
hiofcfjpigkeinaa	FALSE
hiogjmhangagpkcj	FALSE
idojelohofecmiaa	FALSE
idpgdjnhhdmhdoaa	FALSE
inclpmdkcgpkobaa	FALSE
indmmomgfhoaehla	FALSE
jijkoehkbjlheeaa	FALSE
jikhnhafclhmmepa	FALSE
kcjmbodfmcelpcaa	FALSE
kclkbkhffhooogaa	FALSE
kmfjfdigbahfmcaj	FALSE
kmfnaplngpconeai	FALSE
lgchoojcmggjeiaa	FALSE
lgfflofebdnemgaa	FALSE
maahjpdcgahejigi	FALSE
maajllcloefjjije	FALSE
mlnmfhlagpnlkfca	FALSE
mlnnaaagohdolfkk	FALSE
nfnmcggkjobiffaa	FALSE
ngadpiljkfnafgpp	FALSE
oakecdjngppkflma	FALSE
oalomfonfkdefcda	FALSE
olehbpjedfkaidda	FALSE
olenmkijocjigdaa	FALSE
pfgplkbhelhjbcaa	FALSE
pfhnepkllbcmhcaa	FALSE
aaaaepddfjhejjfob	TRUE
aabbmhipmjngoplbi	TRUE
ajbpnimgeojeagibn	TRUE
ajcahpbpapibhpjge	TRUE
bdnnkhlodleafdbpl	TRUE
bdobhpfckapgafneb	TRUE
bnliclgheghdnobie	TRUE
bnmdhhpgelhhggpgp	TRUE
chhhpaejnkjlmbmhf	TRUE
chjlaeolpkhlfniob	TRUE
dbopabhfkkdobpnhe	TRUE
dbopkleffmmkjcnfp	TRUE
dmhkinkpenonplgak	TRUE
dmjekddlcnkbbfibe	TRUE
efhapbinpieijljpg	TRUE
efhialcgbeihhjahd	TRUE
facenamnaebbebjfk	TRUE
faekfkidmecobddlk	TRUE
fkknfnfgeeankldfe	TRUE
fkmdfbpflehbkdlol	TRUE
gejkolhbheanamfhb	TRUE
gekfpigmhiapbokfl	TRUE
hagllenncmnpagogb	TRUE
hahcijcjihiighkln	TRUE
hkacaigbooblljjfc	TRUE
hkcajkbcdbhlfjikl	TRUE
ifgjcllmimpnfolnl	TRUE
ifhinndembmlopjjk	TRUE
jagpafecplopnnkpb	TRUE
jagppdeldhnhdpabo	TRUE
jjjempjpahankdkfb	TRUE
jjkefmdgegkpbnecj	TRUE
kbpobbajfiihcenmf	TRUE
kcaajddmjggdfafeb	TRUE
kndlgkcdfnhfhldmn	TRUE
knemkdneehpafehoc	TRUE
lhpppbgbmjjlageod	TRUE
liaeadflaljfaiejb	TRUE
mbjdemommfbpeioka	TRUE
mbjicpdjhhmohfado	TRUE
mmdkamdckoeocljgm	TRUE
mmdlhcopgodolande	TRUE
ngfjeapjhpfimglkl	TRUE
nggkmeddoohffgfpg	TRUE
oaoafehofmdlohpbj	TRUE
oaocbfdibkblickak	TRUE
okhhikdndnpkbepap	TRUE
okkbnkbiipaoaaojb	TRUE
pfoflineakecjloen	TRUE
pgcfhhnahcjfldhco	TRUE
aacpmcjafhlgkalfe	FALSE
aaedemaaganomlmoo	FALSE
ajfpigaipghofoiee	FALSE
ajhcgjolegnakpdkj	FALSE
bddonnljmpkojmlaa	FALSE
bdffieekmfflfahea	FALSE
bodeahkggleeminia	FALSE
bodhlpghafakjhkok	FALSE
chejpaekckfceiopa	FALSE
chflkebmhnoghifaa	FALSE
dcdncdmgcjoefojaa	FALSE
dcecojgccfbmbncaa	FALSE
dlpblaeddgomjccla	FALSE
dlpigfpplcddnmhaa	FALSE
efilonhopigbideaa	FALSE
efjjbakciammokgfl	FALSE
fadckcokkencofkja	FALSE
faddpcfeanidmcoid	FALSE
fkmpooellppfhboaa	FALSE
fknbpbahfodlflfpa	FALSE
gfgpilkfckfhjccaa	FALSE
gfhahfogpoppeklla	FALSE
hajgnamajkahhnmoe	FALSE
hakdopgnhnmdnflla	FALSE
hkjokgaeomlagnkdp	FALSE
hkndlbpcibjibkfaa	FALSE
ifgmjigcggaifpcoa	FALSE
ifhagnfclgloggoga	FALSE
jaefdhpignaldoeja	FALSE
jaendnoaapcaieffl	FALSE
jjcmbepfibofcdapa	FALSE
jjegjiglafmpjmkpa	FALSE
kdjgbhlfmlaeedeia	FALSE
kdjhdnoccjpdideaa	FALSE
knmcebdkcafhlgcna	FALSE
knogcapfjkeociaco	FALSE
lhagciohjccfamjhi	FALSE
lhdddpijmnhkfelaa	FALSE
mbhecgfaehnfffeaa	FALSE
mbhigkkfpceladkac	FALSE
mmgaagojmglhemaon	FALSE
mmheopjkfciffpfaa	FALSE
ngdmoaanofhcloigl	FALSE
ngfiknffpojhnojaa	FALSE
oalgapdiddlnpdhkc	FALSE
oalgegfgjpkmjecka	FALSE
olgoocehhcmeegcaa	FALSE
oliogdlhanmnoipaf	FALSE
pflhloogkapgfagpf	FALSE
pfmgkdcjghcolppaa	FALSE
aaanibhblikpdffogc	TRUE
aaapfadjodagldcmnb	TRUE
ajjhehkeefpagdecpb	TRUE
ajkbhicmmgglpmnahf	TRUE
begamdjglikneknhkm	TRUE
begboeanjjhejlneji	TRUE
boafliingcoaaelkeb	TRUE
boaiioojfkbgldfjgn	TRUE
cihadkjbfjgdnmojml	TRUE
cijchiadpghnhebopp	TRUE
dbidlboeoibbkfmejn	TRUE
dbiomckccfcbipoche	TRUE
dkjghcjlejckihnmam	TRUE
dkkfocpdlgdabbimke	TRUE
efafhndbjcnpdendlg	TRUE
efanabmjnnofieeknm	TRUE
faflageoheadbfengg	TRUE
faghjonljgkbeddbii	TRUE
fkhlgeoldpllhgjjah	TRUE
fkhpmnhinedkfajppb	TRUE
gekngcnokmnappbglc	TRUE
gekojocgndogamdagb	TRUE
gnobgfaimjbpmfkkpd	TRUE
gnpahgmaepbenelghd	TRUE
hhnhgjedmlhomcgnhk	TRUE
hhokgfinocniehbhnp	TRUE
icapbmbnjlfdjjgiam	TRUE
icapmeddeohhangikb	TRUE
inbjmobalaefkjgmpb	TRUE
incekklinonegoilol	TRUE
jiibfdhmhbbceepncj	TRUE
jijaidbffboficchbp	TRUE
kdblokmbdhafhnjaib	TRUE
kdeeajmkemglebcgia	TRUE
knipjhmkldeadcgeeo	TRUE
knjkljihdihpagkebj	TRUE
lijaggkncglhmdpnce	TRUE
lijpifkkgboeokhjhg	TRUE
mclpgpapifiihfihkh	TRUE
mcmfclloihbbonabmg	TRUE
mmbdjogdlmngppcmla	TRUE
mmbeodpngbgmoakpdf	TRUE
nhffaapjgpjfllgben	TRUE
nhfochnejenbeaggab	TRUE
obnopndkobccimkhcj	TRUE
oboalkhbofpaadfnoe	TRUE
omfmeaihbemjedacdp	TRUE
omgkibgimnngidgbgd	TRUE
pghffcnecigdijolbf	TRUE
pghmbkodeimfedkjbf	TRUE
aaaemjanmlmneaahmn	FALSE
aaagfldaaifchggfkd	FALSE
akonfoiaplifgfoemm	FALSE
alajmcekgfjgnlklee	FALSE
bemmklfkoaaaedlkgk	FALSE
benagdejfiahgjnhcc	FALSE
bobokjlgbdgfhfpeaa	FALSE
bocgebcjnfhaofaena	FALSE
cihgejmhahiefojhna	FALSE
ciifechbccnhnajika	FALSE
dcodmggfohlcdppkaa	FALSE
dcpjoijeaenkpojmha	FALSE
dmpnmoooapkdfcjnla	FALSE
dnbafnpncnmgjjocoa	FALSE
ehponfebopegcmceaa	FALSE
ehppifaiflkelochja	FALSE
fbilichcgkmjclgnaa	FALSE
fbjbppeajghpfknhja	FALSE
fmmiplejionmjiciaa	FALSE
fmmlnonhklhecoonaa	FALSE
ghjmdccmfmfnaeemca	FALSE
ghjpkgnckeagjgogga	FALSE
hcmaipghigadcpoign	FALSE
hcmebaciokpkfpgjma	FALSE
hnbnofebnliponcfaa	FALSE
hndcfbgfakpjkomhna	FALSE
igineflmmpmdkifpaa	FALSE
igjfifilbilonhnjaa	FALSE
jaggjeophehllepgpa	FALSE
jagnimcmnjcggckica	FALSE
jkbenedlfgpbldfjaa	FALSE
jkbhhoiljibnojoala	FALSE
kfkccfbgbldnflimaa	FALSE
kfngklcfgpcmhhheaa	FALSE
kpmbgneglcldlnfeaa	FALSE
kpopocffoomkdlahda	FALSE
ljlmbjpbnbilmegmaa	FALSE
ljnjljemmbgljcliaa	FALSE
mdpifkebcmkihcfoaa	FALSE
meacjinmoaddhmnlck	FALSE
mogaidieefcegiiona	FALSE
mogdfplmkpopklpkaa	FALSE
njckfgdcppbckeicaa	FALSE
njcnipgjkbgocohkaa	FALSE
ocnmidbnnceohikdaa	FALSE
ocodnencegljjpbfaa	FALSE
omfmomcgmckedgpiaa	FALSE
omfnaikjnlkdidniag	FALSE
pfmkgmlmmgeikkahca	FALSE
pfmmefbnahjfjilloa	FALSE
aaabmaiiglonjgdffli	TRUE
aaacamlklmdapaglmnb	TRUE
aklnjlmlbenlmadenha	TRUE
aknpokhefendllegalb	TRUE
bencbdakcmopljhgenc	TRUE
bendagejjpgnlhbhimk	TRUE
boeececbedomkbiljma	TRUE
boeghahomaljahfdhpb	TRUE
cifpppcecjeldekpkpf	TRUE
cigfemoohohjnmjedcc	TRUE
dclfeemkkddognjfkej	TRUE
dclkdfoocpdkamgongp	TRUE
dnamojaecjadigmbjoj	TRUE
dndbjhfmpidlejalhko	TRUE
ehecabjpogdkdfnglpi	TRUE
ehepiiliognhdmoeadn	TRUE
fcchdbommpijacpeohm	TRUE
fcckgofagghocebiohk	TRUE
fminaklcahninmggkib	TRUE
fmjdfcdnebcadkhoaab	TRUE
ghmhafidfhimloogdjc	TRUE
ghmlahkffmddnlihhfc	TRUE
hcojhphgebdiohglfdj	TRUE
hcoknjokcncodjnflkk	TRUE
hmjpfoikagobibcpjim	TRUE
hmkpgjjiafadilhkepb	TRUE
ifnphghandnjoelbhpd	TRUE
ifoipbjodajlmhhdgfb	TRUE
jagbgjipjakmgggelnm	TRUE
jaggjdedgmeihigcdch	TRUE
jlhdejjkmlpinddodhk	TRUE
jlhhgicehchdljhjgak	TRUE
kgeflcnfcfppmfahhjg	TRUE
kgfjcnejlabgldngkbp	TRUE
kpmlmmejcjienofblll	TRUE
kpnjmfhoplgnfiojdif	TRUE
lkpffodhbkpgipiacab	TRUE
lkplelloepdkammcmgb	TRUE
medhbknaenbnlimlmec	TRUE
meeldilabjakllepeic	TRUE
mohakejpcfeigfcgfme	TRUE
mohcdpeenlnekcbfdjm	TRUE
njfeaijfnloafocjplb	TRUE
njgafbknippfibkiidm	TRUE
ocncokjncppbikpebna	TRUE
ocnoilcplegepjhihhf	TRUE
olicoalgbkndnmhkkph	TRUE
olikhablkbbfhaodnkj	TRUE
pehkkjdnbfibmfekihk	TRUE
pehoaphbbkeedhnjpfm	TRUE
aaacffohodcaccecgcg	FALSE
aacjiahoppjaofckpom	FALSE
ajnkjekjdiahjceaicm	FALSE
ajoaafecainmghldpio	FALSE
bdgjedfecegiobbcgaa	FALSE
bdhobodbpfjgndijjaa	FALSE
bngjfgoejjklnpjcmaa	FALSE
bngkjmnmlbjgkmfalla	FALSE
chgicnljgcccdlkafma	FALSE
chhccfhjbpmpiocdoaa	FALSE
daofjldamignmnhikfi	FALSE
dapoicfolofhdeiojfa	FALSE
djmfgniokjmefemcafa	FALSE
djmjdofmlkkjojimbaa	FALSE
eemamofcojmgnneagdp	FALSE
eembnilcahghofnimda	FALSE
epepaemadlcefoghehj	FALSE
epfncbhbokddlhikkaa	FALSE
fkeibfdopponaijknga	FALSE
fkfegcahjdpohiokija	FALSE
gflodjcekglikfmekaa	FALSE
gfminaofmolaojhjnpd	FALSE
hbdokldfjfcmlkhaeka	FALSE
hbdopldkidnmodkggaa	FALSE
hklidkepgiapandcgil	FALSE
hknipadncdlifkdicna	FALSE
ifehiaonandhngepkmf	FALSE
ifehoflipbnhnfadega	FALSE
iofoaahainnhoamiakk	FALSE
iohfeledocecopphdaa	FALSE
jkhacfajglngpjjpjij	FALSE
jkhbiddkpkjfccdelaa	FALSE
kdkolncigjkdpkmfnaa	FALSE
kdldbdhnbflcpdmenaa	FALSE
klopjdfomikjdgbojaa	FALSE
klpcnogbemmnaggmlpa	FALSE
lgfianjeinggfapopij	FALSE
lgikdificejmgohoeaa	FALSE
mbeckigadidaaidoddj	FALSE
mbfmckdlifilnkbacga	FALSE
mliipchilcbfjoaicla	FALSE
mljijgknhejffmdojaa	FALSE
ngmkobbeieiojbpglaa	FALSE
ngmodendhbijdgbddaa	FALSE
obbcieicijgbifdfaap	FALSE
obchnoeigghafhckfla	FALSE
omfolkcofjoghflgcaa	FALSE
omgafpifpnpofdafpjd	FALSE
pgoeahfoogpfiodokoa	FALSE
pgoeoefimboncgkagfa	FALSE
