aaafdmndlk	TRUE
aabcgnnmcg	TRUE
ajmlmdimob	TRUE
ajmnekdfce	TRUE
bcngonfhmh	TRUE
bcnkodhjan	TRUE
bnbpifglmc	TRUE
bncakkfndc	TRUE
cgeaeeagkn	TRUE
cghpmagobf	TRUE
daiefnoifj	TRUE
dajknbnglc	TRUE
dljbkgbibl	TRUE
dlkajdmfjh	TRUE
egmkofgngp	TRUE
egojpnecbo	TRUE
fcamojjdad	TRUE
fcbcpnljhj	TRUE
flkaefgelj	TRUE
flklpicopb	TRUE
gempjhciel	TRUE
genanldjlf	TRUE
godhchnnek	TRUE
godlmkbiph	TRUE
hilnmpmkfm	TRUE
himfobmoco	TRUE
ickpejeccp	TRUE
iclcecdaek	TRUE
injndamfbg	TRUE
inkclhdpme	TRUE
jhkfmncabb	TRUE
jhkimgiand	TRUE
kbjomeobfd	TRUE
kblnlhndkc	TRUE
kmddmdkege	TRUE
kmeehjjgfc	TRUE
lhcpagmloo	TRUE
lhdcaglkbe	TRUE
mbalplafmo	TRUE
mbbhllhace	TRUE
mkkdodiejm	TRUE
mkkplbocdm	TRUE
ngajccbejp	TRUE
ngccooilcc	TRUE
oabhihmelb	TRUE
oadjkghffm	TRUE
oklojfeenn	TRUE
oknacaonbk	TRUE
pfckpajhfh	TRUE
pfdhbikhbf	TRUE
aaafdmmpca	FALSE
aabkjcgnaa	FALSE
ajnomhcaaa	FALSE
ajobinanaa	FALSE
bcjhaflbbb	FALSE
bcjkmfmbbb	FALSE
bnfmpigbbb	FALSE
bngccfkbbb	FALSE
cgkghiaaaa	FALSE
cgkniebbbb	FALSE
daphgmpaaa	FALSE
dbadpffbbb	FALSE
dmcipanaaa	FALSE
dmeejiaaaa	FALSE
ehdeccaaaa	FALSE
ehelodaaaa	FALSE
fccpbmibbb	FALSE
fcdeknbbbb	FALSE
fmallfmaaa	FALSE
fmaohdlaaa	FALSE
gfkjhgbbbb	FALSE
gflamgiaaa	FALSE
goklfaeaaa	FALSE
goknpfaaaa	FALSE
hicomebbbb	FALSE
hidibdcbbb	FALSE
icpnmfaaaa	FALSE
idcjdeaaaa	FALSE
inkcdnbbbb	FALSE
inklmmaaaa	FALSE
jhjcehaaaa	FALSE
jhjmadmaaa	FALSE
kccabgkbbb	FALSE
kcecbfpbbb	FALSE
kmchchaaaa	FALSE
kmcipdaaaa	FALSE
lhajidcaaa	FALSE
lhbdcobhbb	FALSE
mbbheilibb	FALSE
mbcnohebbb	FALSE
mljiieaaaa	FALSE
mljjjcaaaa	FALSE
nfgmgpbbbb	FALSE
nfknaodaaa	FALSE
oaaipmjmaa	FALSE
oaajaaafga	FALSE
okcgacoaaa	FALSE
okdnecbbbb	FALSE
penffjbbbb	FALSE
penifkaaaa	FALSE
aaafdmmdlkd	TRUE
aabgnnmcghj	TRUE
ajmjdeadffb	TRUE
ajmpieebjbj	TRUE
bcggdmahopk	TRUE
bcglnbhdpgi	TRUE
bmlbeladbmn	TRUE
bmmbehbdool	TRUE
cgmkflimfak	TRUE
cgmpllhfdcc	TRUE
daonffbjffl	TRUE
dapkeopmkdd	TRUE
dlkogcnjjkf	TRUE
dlndfohgbip	TRUE
ehifgccacpn	TRUE
ehjahojpjbm	TRUE
fbnfnllmbop	TRUE
fbngdbiiaoh	TRUE
flnphgadbjb	TRUE
flodbnnhcii	TRUE
gfgaaglaojj	TRUE
gfgjjkflfhn	TRUE
gopehomimkh	TRUE
gpadfeklcfn	TRUE
hipcdpdmgph	TRUE
hipfeillicn	TRUE
icgfjbapabk	TRUE
ichbihceini	TRUE
iniljhnfkkb	TRUE
injgdjphgdg	TRUE
jhookdkpbag	TRUE
jhpckicnkbd	TRUE
kbhoippiign	TRUE
kbifleedffo	TRUE
kmcdknpbcab	TRUE
kmebcoenjnf	TRUE
lgdfmipglha	TRUE
lghbpblhfab	TRUE
mbfkcmkbaoe	TRUE
mbflbccmdnh	TRUE
mlogclnehmc	TRUE
mlogkifmkgj	TRUE
nfncmkidkmj	TRUE
nfoooddpllp	TRUE
oaaklljnekj	TRUE
oabahjfioif	TRUE
oklcikkmafn	TRUE
oknejmbdmgb	TRUE
pfkohlmpnbi	TRUE
pfladbdckep	TRUE
aabhhihbhbb	FALSE
aabjbebbbeo	FALSE
ajlfjglhaaa	FALSE
ajniciidaaa	FALSE
bdfelbilibb	FALSE
bdfholdaaaa	FALSE
bmkfpieobbb	FALSE
bmlplffebbb	FALSE
cifdfahkaaa	FALSE
cifkhdlaaaa	FALSE
dcpddpeaaaa	FALSE
dcpmpagfaaa	FALSE
dmaepojmaaa	FALSE
dmaicpedaaa	FALSE
efmbllbekbb	FALSE
efngnjhbbbb	FALSE
facgjmcoaaa	FALSE
facniafhhaa	FALSE
fkpddjblbbb	FALSE
flanjicbbbb	FALSE
gemgbodebbb	FALSE
gemkjgoaaaa	FALSE
gpadmalbhaa	FALSE
gpecnoiaaaa	FALSE
hkppnepaaaa	FALSE
hlabchikbbb	FALSE
ifkedflaaaa	FALSE
ifkohmjbbbb	FALSE
iomjpcoaaaa	FALSE
iopcffbdbbb	FALSE
jjbkonhpbbb	FALSE
jjcpnocaaaa	FALSE
kdpengaiaaa	FALSE
kdpmgbolbbb	FALSE
knkaalgloaa	FALSE
knkgdfpaaaa	FALSE
lighhpdbbbb	FALSE
liianjcpaaa	FALSE
mckllmmaaaa	FALSE
mcmgfkiaaaa	FALSE
mmekkjkbbbb	FALSE
mmkcgaejaaa	FALSE
nglhpiibbbb	FALSE
ngljjpeaaaa	FALSE
obfiakfjbbb	FALSE
obhbkajfjbb	FALSE
olphnnebbbb	FALSE
omaeccgapaa	FALSE
pfopipeaaaa	FALSE
pfpabjehbbb	FALSE
aabhhihbhjbf	TRUE
aabjbbbeoeaa	TRUE
ajnaboiomkja	TRUE
ajnafaookdkl	TRUE
bddppammnlbc	TRUE
bdebkgbdajnp	TRUE
bnehfogafamp	TRUE
bneinbjfmfcg	TRUE
chndpopobkha	TRUE
chpakbigkaoj	TRUE
dcjofdcimomn	TRUE
dckfbldbnmpk	TRUE
dleefephdaoj	TRUE
dleiogdjfodb	TRUE
efdmajapailc	TRUE
efffkmihpmmj	TRUE
fabicffkdiea	TRUE
fachnelaacjn	TRUE
flgaehmipohj	TRUE
flgdekdooghi	TRUE
gfnpailekjil	TRUE
gfogbhgdlgfj	TRUE
gpahpofobcdo	TRUE
gpcfdekojlgb	TRUE
hkhnmcgbjbda	TRUE
hkhpjagnlhol	TRUE
iemlfmlgkcgg	TRUE
ieoabhmbalkk	TRUE
ionacmbelboc	TRUE
iondadnfcaml	TRUE
jipcmbkdgmgg	TRUE
jipeoidkeihb	TRUE
kdlcilpjfeaj	TRUE
kdlfjpmekfno	TRUE
kngpoebaknjh	TRUE
knheokmnnllf	TRUE
lijgmhbajfpo	TRUE
lilfkimcocbe	TRUE
mdbfgncnlifa	TRUE
mddmghicbpem	TRUE
mmnaadmipfjk	TRUE
mmnfdjgkgncc	TRUE
ngicgbhalnji	TRUE
ngjidpbmmhbj	TRUE
obicpnpgedic	TRUE
objcmcnedcib	TRUE
omamangoblki	TRUE
omanddlandll	TRUE
pgiooahjjaoj	TRUE
pgjckgpagabe	TRUE
aaacnilflmna	FALSE
aabhcignjbbb	FALSE
akoloeffdaaa	FALSE
alabnjjkioaa	FALSE
bfahmfdknaaa	FALSE
bfbikidfkjbb	FALSE
cabljjgljbbb	FALSE
cabmfhlopbbb	FALSE
cknembepgbbb	FALSE
cknmpehfbbbb	FALSE
dejniagonaaa	FALSE
dekjfiecaaaa	FALSE
dofhllcafaaa	FALSE
dofldepbfbbb	FALSE
eiedmpoibbbb	FALSE
eifialhikaaa	FALSE
fcbbofcbnnhb	FALSE
fccgobpccbbb	FALSE
fnemoflkaaaa	FALSE
fnepllllaaaa	FALSE
ggpcbhilobbb	FALSE
ggpmaidpfaaa	FALSE
hbemahoifaaa	FALSE
hbfoloebfebb	FALSE
hkkgcoaomaaa	FALSE
hklocbepobbb	FALSE
ifnbdlhafbbb	FALSE
ifncldgibbbb	FALSE
jahbikfdpbbb	FALSE
jahjjdbbbebo	FALSE
jklpodmpbbbb	FALSE
jkmdgidkaaaa	FALSE
kecomjakiaaa	FALSE
keeihlkoaaaa	FALSE
knmhmcdlbbbb	FALSE
knphpdgbmbbb	FALSE
lipiamlkpaaa	FALSE
lipikehcbbbb	FALSE
mcijobdnkbbb	FALSE
mcikohjebbbb	FALSE
mmoacalpfnaa	FALSE
mmoknjibnbbb	FALSE
nhnheigaiaaa	FALSE
nhnjnnfgbbbb	FALSE
ocdkagknmaaa	FALSE
ocedfmdcbbbb	FALSE
omgolfjjaaaa	FALSE
omhbjmalgaaa	FALSE
pgocigdbnbbb	FALSE
pgojkhnbnbbb	FALSE
aaacnilflnoid	TRUE
aabignjbnbfdf	TRUE
akpcmdhmlafce	TRUE
alaahgjjdoccg	TRUE
bffkfjlckfbho	TRUE
bffmceknegcfe	TRUE
cacikpaehfeji	TRUE
caeigekhndcoe	TRUE
clfgjabjlgfka	TRUE
clghnhmedpefc	TRUE
dfbbfpcckbggk	TRUE
dfbpapafmgfap	TRUE
doklemifilcmb	TRUE
domcnahmllgki	TRUE
eiobjnbgejipk	TRUE
eiopcedepchfh	TRUE
fcjmpnnbofdmg	TRUE
fcmmchkaoekce	TRUE
fmmdpbbkmpeoo	TRUE
fmmgpkbfmjodk	TRUE
ghingmagjhcgi	TRUE
ghipcecngemni	TRUE
hbbhoghcjonag	TRUE
hbcbdlgmlkfpf	TRUE
hkjghgfpadcan	TRUE
hkjgogljdpbca	TRUE
iejjlicgcfpjj	TRUE
iejlcibcdnddb	TRUE
jaedijmddbfgn	TRUE
jaefkbdhplpjl	TRUE
jkmgaamhgmhkg	TRUE
jkmhggmegnajn	TRUE
keggoepmbpfde	TRUE
kehomeihhkkjh	TRUE
kogcmnmccdhkn	TRUE
koglfgdcjelai	TRUE
liklhemkphjee	TRUE
limjafllchjeh	TRUE
mchfnpmgmnadb	TRUE
mcjcaomlgidnp	TRUE
mnienecmndnje	TRUE
mnikphbkgcfkh	TRUE
nhkfnccemgmid	TRUE
nhlgkhnhfneji	TRUE
ocihnloofliok	TRUE
ocijefhkbpohb	TRUE
omapmcieimafg	TRUE
ombfedfaempjf	TRUE
pfecdflnpnilg	TRUE
pfjbcijknjodm	TRUE
aaafihnbgjoda	FALSE
aaaiclalfjhkc	FALSE
aipfcjfmfdaaa	FALSE
aipkehegejaaa	FALSE
bcnbjlgnghlbb	FALSE
bcnkbhnaijcbb	FALSE
bocijjmcaeaaa	FALSE
bocoojllfobbb	FALSE
chjnjadhhhaaa	FALSE
chjphomdnbbbb	FALSE
dcbalbpkjikbb	FALSE
dcbllkfeigbbb	FALSE
dmijdmpicaaaa	FALSE
dmilildlibbbb	FALSE
eidkkjbifkbbb	FALSE
eifdghcdoaaaa	FALSE
fcgacanjjmoaa	FALSE
fcghcihllaaaa	FALSE
fmojomjphaaaa	FALSE
fnaebfkohcaaa	FALSE
ghendcjhobbbb	FALSE
ghfnjfhialaaa	FALSE
hbjkaciendaaa	FALSE
hbjpmmjjpjbbb	FALSE
hmhocbpgdibbb	FALSE
hmibplbeocabb	FALSE
ifpinadldiaaa	FALSE
ifpjaamhleeaa	FALSE
ioklpignfbbbb	FALSE
iokmgecmafaaa	FALSE
jkdnngljdaaaa	FALSE
jkelkdllnbbbb	FALSE
kfgjogendaaaa	FALSE
kfgnlkaihpaaa	FALSE
kolnnjbhoibbb	FALSE
komfhkofdaaaa	FALSE
lhhfcnhghbbbb	FALSE
lhhmhgibilbbb	FALSE
mcllmgklobbbb	FALSE
mcmdgckahhaaa	FALSE
mnceifgdibbbb	FALSE
mndeihofpaaaa	FALSE
ngjejadjldaaa	FALSE
nglamamoapnea	FALSE
obcaadimbijbb	FALSE
obccejnlmebbb	FALSE
omgfmeiokaaaa	FALSE
omhcfiobkdbbb	FALSE
pfpcghkcebbbb	FALSE
pfpiedaemiaaa	FALSE
aaafihnbgjoedm	TRUE
aaaialfjhkbbbb	TRUE
aipahiaklchgcp	TRUE
aipdhanfchkcmi	TRUE
bdbhcgbamhphif	TRUE
bdbokjgamjpgem	TRUE
boamdjlkchkckd	TRUE
boanpjpfanpmhm	TRUE
chfkomhglananh	TRUE
chgigmpakojhlm	TRUE
dbkihkbdgchnfc	TRUE
dblkkgcfgpidnm	TRUE
dnggahcanjjmoc	TRUE
dnhihllcmhpklf	TRUE
ehedlieaajckce	TRUE
ehfmjeohoabfol	TRUE
fcibdchhgdbejo	TRUE
fciklibohkbool	TRUE
fmlhnoonmepfkc	TRUE
fmmfemmfedcgkn	TRUE
ghfebicgddeagj	TRUE
ghffiiclglkolb	TRUE
hccmijgnbpoacl	TRUE
hcdooneabpfaoa	TRUE
hmfgigoelmbcmo	TRUE
hmfmpfecpceohf	TRUE
ifjihdcckldoml	TRUE
ifkegnjhbhpgpe	TRUE
iommajfkdnbghj	TRUE
ioniaalhfaoeck	TRUE
jjmhmmckeffled	TRUE
jjmlioeikbgmab	TRUE
kekdebjegkehdj	TRUE
kelachcfapdenk	TRUE
kojjpjnpmndnmm	TRUE
kokbfmhaipfbko	TRUE
liadahjlcaedbg	TRUE
licdcpgfgmcacj	TRUE
mbpbbcbjeiaaaa	TRUE
mcaploiplfmgpb	TRUE
mmmonooiemdfeb	TRUE
mmnecnmkkbhhfp	TRUE
nhglleeagbmccj	TRUE
nhhffldgakmjfm	TRUE
obgefbmpkpljcg	TRUE
objhcggbnpmiki	TRUE
olnnhkhihmaigc	TRUE
olofollpeeidak	TRUE
pfeikpiemmhgho	TRUE
pfgnooelmjjhcl	TRUE
aaanmefemhogda	FALSE
aacgohocbgmnaa	FALSE
ajohjidpneeaaa	FALSE
ajohmgjaoaajhd	FALSE
bdpboiblmkfhpb	FALSE
bdpgbmhejgdmbb	FALSE
bokljpbimpngbb	FALSE
bolooobfebnjcb	FALSE
cihdjkmhhmaaaa	FALSE
cihieckohebbbb	FALSE
dbeeldbcpjckbb	FALSE
dbfembpobmfhib	FALSE
dmfldgoajonaaa	FALSE
dmfnedcenpbbbb	FALSE
egnepgcbjjhbbb	FALSE
egnfklbbacalaa	FALSE
fcpeniahmldaaa	FALSE
fcplmnmbinnbbb	FALSE
fmipmdmelfbbbb	FALSE
fmjiolccikbbbb	FALSE
ggflgelmknbbbb	FALSE
gggahjjjpokaaa	FALSE
hamehamkppmdaa	FALSE
haminmmkdblaaa	FALSE
hkofhdglnkaaaa	FALSE
hkogjgkjkajaaa	FALSE
ieakbniadojbbb	FALSE
iecpbidmndbpbb	FALSE
iofcakbcdcabbb	FALSE
ioffkihppeaaaa	FALSE
jidgceadpinaaa	FALSE
jigfpoahdfjaaa	FALSE
kdhbfcdnfgobbb	FALSE
kdimedocmiaaaa	FALSE
kmmkianlelgaaa	FALSE
kmnmmobgbklmbb	FALSE
lhaoofjnmfgaaa	FALSE
lhbmiahhnheaaa	FALSE
mbkhbnllnbkfjb	FALSE
mbmlldljpcibbb	FALSE
mliceoabfbpibb	FALSE
mliidnpghgaaaa	FALSE
ngnlpkloaefaaa	FALSE
ngogmgopdnbbbb	FALSE
oaidkfffkegaaa	FALSE
oaifmckhhkgaaa	FALSE
olbacdmlkohbbb	FALSE
olbnmaimaajhga	FALSE
pfgnlbjdihfbbb	FALSE
pfilnienofaaaa	FALSE
aabibemiemadedb	TRUE
aabidnkjfgfjagb	TRUE
ajajihioofnkdge	TRUE
ajbbpiallepedmo	TRUE
bcheefoekegfenf	TRUE
bcicmjhkhdkgnnk	TRUE
bmdapfbehfhodln	TRUE
bmdmemdpgojnpod	TRUE
chaafagiiaibbbb	TRUE
chabfpicnboaacn	TRUE
cpmbejipjilfhjf	TRUE
cpmjcblklaeiihk	TRUE
dlgojedeoehopph	TRUE
dlgokadofbgkmkj	TRUE
efihiamhegfkfem	TRUE
efldbldnhnajeca	TRUE
epopfapbfefbicp	TRUE
epopmohefnaamgp	TRUE
fjgkcocfalochoo	TRUE
fjhgdcnibanfija	TRUE
gdhkkehnbcoennl	TRUE
gdjkilagnmohoai	TRUE
gnddgjnhgmhpddm	TRUE
gneciehbfjfjpki	TRUE
hhfbeagkokjkokl	TRUE
hhfhhepmlmimghk	TRUE
ibiecpanagjnfhj	TRUE
ibkhnbgfodknhpm	TRUE
imglopdmondikjl	TRUE
iminlakhdfcnjng	TRUE
jhclddfalfpdfbo	TRUE
jheadjkpmlngpfd	TRUE
kcgepcjphplpfho	TRUE
kcgnkjkcoaoljff	TRUE
kmmpaenoljmllnn	TRUE
kmobenlkgpjenpn	TRUE
lhigckbdmakedbe	TRUE
lhimadnekfjbnhb	TRUE
mcbioichcfamocl	TRUE
mccgppnlnadmmkb	TRUE
mmfenhkdafogahb	TRUE
mmgbgogehnpijdk	TRUE
nhfncckopofhlak	TRUE
nhgiifmbgngffdl	TRUE
odbbpdcaiockkig	TRUE
odbijcfbaoobggp	TRUE
onebpmbggfcffjl	TRUE
onemljegkfifooc	TRUE
pggphldmilmonlb	TRUE
pgimehimcjnhndf	TRUE
aabibemiemadepa	FALSE
aabidcankjfgfja	FALSE
ajbnaipfdbpbmgb	FALSE
ajbpaadbelppcpa	FALSE
bchkepnekhfobbb	FALSE
bcihggpbafiopbb	FALSE
bmmffefanmdibbb	FALSE
bmnfailbadmjdaa	FALSE
cgieidpdchfbbbb	FALSE
cgijpepgblhbmbb	FALSE
cpmmlcgaehknaaa	FALSE
cpndgffejdfbbbb	FALSE
dlhnoiafbnpagaa	FALSE
dliiagcaembepaa	FALSE
efbagbdhhhefpbb	FALSE
efbekpcjjgmhbbb	FALSE
epnmmlpejjpaaaa	FALSE
epofmhbicnflbbb	FALSE
fjcaemmakdgcfaa	FALSE
fjcanaaiodmplka	FALSE
gdicejfoikoaaaa	FALSE
gdiniahpjbbcnbb	FALSE
gmldhiajjkjcaaa	FALSE
gmmkkldaajmljaa	FALSE
hgmelpieangiaaa	FALSE
hgmlpmhhalllaaa	FALSE
ibodjeokadhadaa	FALSE
iboijakiocmbmbb	FALSE
immbpobnocbpjgb	FALSE
imnkaknhbegdaaa	FALSE
jhbipbpalfibdmb	FALSE
jhbmaaphiegmdaa	FALSE
kbikojhejhfdbbb	FALSE
kbkndkpgikmfbbb	FALSE
kmffbjkpppipbbb	FALSE
kmgogamfanddama	FALSE
lifhbacjidepaaa	FALSE
lifldlpioaopaaa	FALSE
mbmalbpkekellbb	FALSE
mbmcpgjmochlbbb	FALSE
mmfbagkbokofcbb	FALSE
mmfbdlkpapngaaa	FALSE
nhpeplmlfhhaaaa	FALSE
nibgbhhobofhhgb	FALSE
ocekjiinocpaaaa	FALSE
ocenbloljdckbbb	FALSE
onglalndbboebcb	FALSE
onhaklooihjlaaa	FALSE
pggkemnidfbdbbb	FALSE
pggobmegbchalbb	FALSE
aacafdjafcfpbbbb	TRUE
aacffbbekoepckke	TRUE
akbhnghklphppebd	TRUE
akccgaeneonphdog	TRUE
benfobdnliokejij	TRUE
beoiafckagmjjlei	TRUE
bogkaephlchamglo	TRUE
boidaiidfdaeeghg	TRUE
cjlfecjebepmfflg	TRUE
cjnifkcolfgleama	TRUE
ddhglbaeecppkaim	TRUE
ddigkkemdooomiej	TRUE
dneljkcgoinjhejh	TRUE
dnfkhmnbjepackib	TRUE
ejbmapkigampddma	TRUE
ejcbeebaeenbeddk	TRUE
fejeeajgindjldal	TRUE
felcflknoidecfin	TRUE
folpkgalehjnpbnn	TRUE
fombgmlmgbckpppj	TRUE
gijnpnalgaompjgl	TRUE
gikcegeejfafnhng	TRUE
hcoicdigmillfafa	TRUE
hdbpkhniggjicdcp	TRUE
hngalofkbbbckcgp	TRUE
hngfdeohghageojg	TRUE
ihlcemahnnmmpbik	TRUE
ihlllleikpfpgepf	TRUE
jajdbhfjckinahck	TRUE
jakjajehnmbllhel	TRUE
jklnfblmbddjinhm	TRUE
jkopnllnbdekjbeg	TRUE
kdpimbhhmgnniilc	TRUE
keajnocoapaocdpk	TRUE
knlolfghopgakdof	TRUE
knlopmefcdjijcaf	TRUE
lhbephaoipmnpeed	TRUE
lhbnnnicoeikjcjl	TRUE
malkjeddegolbmhl	TRUE
mamcihlkihggeekf	TRUE
mleheiggahlhmbak	TRUE
mlgjdmigdfmaaned	TRUE
nehlgldidojojmdf	TRUE
neiileljmhodnbjj	TRUE
npcdoimpinefcibj	TRUE
npchooeaanjgddjn	TRUE
ojjoheebhjeeipao	TRUE
ojleefmjcnbhjllc	TRUE
pehidmopgonhjdai	TRUE
pehmgndiabhfnhfk	TRUE
aaaiomlchmfakefn	FALSE
aaalhkcabljmjjek	FALSE
akghcpemjdfdgaaa	FALSE
akhggjfiplgpbbbb	FALSE
bfbchadjpjdamjbb	FALSE
bfcfkjmdeebfombb	FALSE
bplaadmeaaljhdop	FALSE
bpldkgedeclkbnbb	FALSE
ckfamagokodcnnaa	FALSE
ckffbfadenjddaaa	FALSE
dfkkeikgdoccbbbb	FALSE
dfldjfpijemobbbb	FALSE
dopomeocchoiaaaa	FALSE
dpcannghhebpaada	FALSE
eimmikdapgojfaaa	FALSE
einfjkpaeglifaaa	FALSE
fdidjbhpkjhnfbbb	FALSE
fdkocbpocdkhbebb	FALSE
fnmlbcohgdlnaaaa	FALSE
fnmneicdongoaaaa	FALSE
ghfejpppaoiahlaa	FALSE
ghgkcajabdainfea	FALSE
hbfgjggjoahhpaaa	FALSE
hbfjdcdehjdpibbb	FALSE
hmdnelgbpcdplbbb	FALSE
hmdohkkacgdbebbb	FALSE
ifkhkakpkendnaaa	FALSE
iflcjgagmmbekaaa	FALSE
jajdjoiibckdibbb	FALSE
jakkkooanhgbmhaa	FALSE
jjneonbdcmhbagbb	FALSE
jjngdjepokafeaaa	FALSE
keckdgappdbpmbbb	FALSE
keclokkeppkkaaaa	FALSE
knmlcldgpfjfaaaa	FALSE
knnfedmbofcjlbbb	FALSE
lhnnibfbekeacfbb	FALSE
lhohbkejeaemhbbb	FALSE
mcjdmhcaphgopaaa	FALSE
mcjeabodkfifbpbb	FALSE
mmohcihhbdbkhobb	FALSE
mmpcfmodjekbfbbb	FALSE
nhcamkkgjbfmjaaa	FALSE
nhcbbijdajbngmgb	FALSE
oaoojdlhfnkfhaaa	FALSE
obbgknjmjchfnebb	FALSE
okjcdbmldfnacbbb	FALSE
oklfgieajgnckaaa	FALSE
pekbdomoemakhaaa	FALSE
pekogmfakljohaaa	FALSE
aaemhkpfaenmdhjpj	TRUE
aahpmnhmadcknbhce	TRUE
akhelbgjjbcijjgpl	TRUE
akkbeimodomfohodm	TRUE
beoieagdjkekabhob	TRUE
beolhlemoelooibid	TRUE
bpgpdchpekeicioab	TRUE
bphedbjojkjlmpkmp	TRUE
cjbkkjpblbjbpaaaa	TRUE
cjcmamdjaacgbjmfe	TRUE
dcnagmaeffmbpollg	TRUE
dcnkeobgjjiiealjh	TRUE
dmkigpepjfeikcolb	TRUE
dmkkkoohcemamklee	TRUE
ehnbhngbhalmlpfle	TRUE
ehnjjplhakhhhjgfa	TRUE
fcmknbecnlnjeemkj	TRUE
fcoebaipcgdiolipm	TRUE
fmohemacophafnkjm	TRUE
fmpffelppjfbeeldp	TRUE
ghaeklepnegbmilgj	TRUE
ghbmjmmpoadaeonmg	TRUE
hbdpanlicoeecfgpg	TRUE
hbgjnnpcddjimgeen	TRUE
hldfmnlggfnblpaaa	TRUE
hldgghajgmfkmleag	TRUE
igbfckkbeiilamfag	TRUE
igckpfddljmfmgkpc	TRUE
jbckjdenhdfiokkbm	TRUE
jbdadilhnpcngnlbi	TRUE
jkgnhagopbhnacnmi	TRUE
jkhndocpfdapbgpok	TRUE
kfacejojpoljkbahp	TRUE
kfaocfelolofbekpp	TRUE
kngohefcdmgpmkhkp	TRUE
knhomamoffabbecac	TRUE
lhgnenpdelhghkobo	TRUE
lhidehfmlbiaolmjo	TRUE
mcbjimhiafmpfgjhj	TRUE
mcccchfadjiefdmkp	TRUE
mlbojidomhafcnkaj	TRUE
mlbpmjifnkoeoiied	TRUE
nffecgeldlpbeelio	TRUE
nfgfcmdgoafhhijgb	TRUE
oaicjlimbdbojannb	TRUE
oaigceddiojklkemp	TRUE
okijfaohjdobhgdnf	TRUE
okjjonndnaiijdgca	TRUE
pfceopgnanmkccbjh	TRUE
pfdmloigdliampoal	TRUE
aaemhkpfaenmdgioa	FALSE
aahipmnhmadcknagb	FALSE
aklnfahkfjjamdeca	FALSE
akmbdocmajjgghaca	FALSE
bfglhhnaakeiljbbb	FALSE
bfhdjoddaahdgljaa	FALSE
bpkhdiohhjpikhbbb	FALSE
bplbiikhoofolppbb	FALSE
cjghpdefbpeggebbb	FALSE
cjhlnfmehppfeaaaa	FALSE
ddickcegjeaeipaaa	FALSE
ddieadkogcfainala	FALSE
dnffhnjehjhffaaaa	FALSE
dnfjhbflfhigdbfbb	FALSE
eiegafcnljphndaaa	FALSE
eiffdoipoammpkaaa	FALSE
fcmakhhhjgfaemfaa	FALSE
fcpfenfdhalncmaaa	FALSE
fmocjkfhhdkehbbbb	FALSE
fmoeffniionahcaaa	FALSE
ghbgpbghlfllcffbb	FALSE
ghbmhjjdojanndbbb	FALSE
hbiflmpbgikcejibb	FALSE
hbilmgbhmgcakdebb	FALSE
hlebnnejcndhmcbbb	FALSE
hlenkialkilkdajaa	FALSE
ifoddaejcbcfepbbb	FALSE
ifogdelmmammfiaaa	FALSE
jbdjmobofheckkgbb	FALSE
jbhhkahifiiamlnaa	FALSE
jklaikeflekncbaaa	FALSE
jkljmhhgepckiaaaa	FALSE
kehflbffihpdkhbbb	FALSE
keiafhcbfolafpcaa	FALSE
knmojknfjliofbbbb	FALSE
knnalppglfganamha	FALSE
licfbpeohgfdlbhbb	FALSE
licliikjbnfnppbbb	FALSE
mchkmealgjoeefaaa	FALSE
mckadmmoejppnnaaa	FALSE
mlhkkgnikpdliaaaa	FALSE
mlhlggmiejknpaaaa	FALSE
nfldlpppohoaknaaa	FALSE
nflnjblkfgbbjplbb	FALSE
oapefmambimcfpjaa	FALSE
oapndjghknmccdaaa	FALSE
olnnpoaehieikpaaa	FALSE
olnpbelblnhnmjcbb	FALSE
pgekgkbboiijdeabb	FALSE
pgenhckiieghhaaaa	FALSE
aabbeaoncpdeiebnfj	TRUE
aadkgbdioflicpinkh	TRUE
ajikbpnpofooegeclj	TRUE
ajjoopebaaefcgfkdi	TRUE
becfgggcoidpkfpncp	TRUE
bedkcjjgbobdlffcmk	TRUE
cbaegnalihenhaiokn	TRUE
cbapgheojimhmaacfe	TRUE
clbjmjhlgcicdhphem	TRUE
clbmoijffbbcphgnpg	TRUE
dfanofmpekjejpjfia	TRUE
dfbeocncgaalklabpi	TRUE
dpomhpeajngcegefpf	TRUE
dponnknhleaehndami	TRUE
eipmeeiannkddlpaec	TRUE
ejaoedfjiadlehfmag	TRUE
femdemeaoggmkgpbjp	TRUE
femlalbgpcabkhklkj	TRUE
fpbiehbkkagkgdmgpd	TRUE
fpcinbafcabdhaogmo	TRUE
gipboiffkjjginacki	TRUE
gipmbkhlbdbkmflicc	TRUE
haknipkeonolnihadb	TRUE
haljkmahnmjmhdcpkm	TRUE
hkadikdhdmnabidlnb	TRUE
hkbomhfalapagkmefk	TRUE
ienpimcjnlhdbkgdpf	TRUE
ifaaelpkdpcbacnccp	TRUE
ioklifgaceoheffkdp	TRUE
iolbkoonackojgpiic	TRUE
jjepihelfnchjfbmjh	TRUE
jjffbjcbeijcffadcd	TRUE
kdmfjafbfdfkhelegd	TRUE
kdnamfpjlkcghncihp	TRUE
kocfkdeiilhpbkcnmo	TRUE
kocjhbceoefblbeeig	TRUE
lhnnhecgonajmiogep	TRUE
lhobjkgolpciifpaii	TRUE
mcfgkpeoanaobbjdcb	TRUE
mcfobejlocnjnhpnnd	TRUE
mlllnjoadhikigejoj	TRUE
mlmincljbebfeppipb	TRUE
nggbjdbkdbdlahpknh	TRUE
nghopdopfncocggoml	TRUE
obfjeciecabikimigb	TRUE
obgidkcflephiaphle	TRUE
olalaomnmekjipaohp	TRUE
olcgkjloipgifoplcn	TRUE
pgeflfnfgmhohhcfap	TRUE
pgekiodcnnckgilcig	TRUE
aaafjhfnhdjeplclga	FALSE
aaalglcjfbjffeklea	FALSE
akhkblmmmmekcghbbb	FALSE
akibdoblakgicbifkb	FALSE
bejinmobcgaandmdaa	FALSE
bekbmleddgkjgenkbb	FALSE
bomjjccngkinhblbeb	FALSE
booiancccpabkgmapa	FALSE
cimhcccobobkfhnjbb	FALSE
cimlpedkbbodbhlnab	FALSE
ddlgcafdodpknfbaaa	FALSE
ddlkciclioloepbbbb	FALSE
dnooghdomaidhogaaa	FALSE
dnplhfeliepanohaaa	FALSE
eifgahfbfbpfgfbmib	FALSE
eiflogeocimgfcaaaa	FALSE
fccnkkjkmgifogbbbb	FALSE
fcflkbidiibjlgfbob	FALSE
fmjhpmcbohfkinkbbb	FALSE
fmjogdpkmilnobabbb	FALSE
gilkocnniacanfleaa	FALSE
gilmcgmepiabdkmaaa	FALSE
hbkjioniobeekfmkbb	FALSE
hbkljkijhegchilbbb	FALSE
hlnhinpmddaabdbfaa	FALSE
hlnjhkibkhaphejbbb	FALSE
ifkefapbgidobfadbb	FALSE
ifleekjnmjafbpmaaa	FALSE
ippdcjgodhdcbcaaaa	FALSE
ippjpconnbongdobbb	FALSE
jjaefoffiihgifiaaa	FALSE
jjanjoknfapcpfphaa	FALSE
kdcdikeemghigcaaaa	FALSE
kddaipdabmnkeabica	FALSE
kmgcoclbpmhbpljcbb	FALSE
kmidcagpcghddidaaa	FALSE
lhmjcdmlniepcaoaaa	FALSE
lhnkbinefgijggjbbb	FALSE
mcidfodeabncmomaaa	FALSE
mcielkjdneagfobbbb	FALSE
mmilmgckkgcfipbbbb	FALSE
mmilpebilijlmkjbbb	FALSE
nhinmglgjopbiigbbb	FALSE
nhkekagbaokgicndaa	FALSE
obpgfknidhmonmgbbb	FALSE
obpnkancncngcnfbbb	FALSE
oldmgpebfgjggejbbb	FALSE
olfkicldabofllfbbb	FALSE
pemjdlpplofeffaaaa	FALSE
pemolpbcieeofajbbb	FALSE
aaaenljhofpiopcbomi	TRUE
aabidpfhnhjnbbhjgce	TRUE
akamjcidgfdhglodlba	TRUE
akbcbmipbaamjfmojjd	TRUE
bejjedmbiddfeoipgpb	TRUE
bekmjfmlfdldfdnackl	TRUE
bppbgihilfdimlhnile	TRUE
bppdelkddcapfogoiba	TRUE
ckcganjlekmmjliinho	TRUE
ckcpaefffhhmlleifke	TRUE
ddopmkkoccfgipkoocj	TRUE
ddpmneojchajggdbapg	TRUE
dogdpmppobgjfhieple	TRUE
dognflpgaemccciclbp	TRUE
ejdmdjekhkggddjhlhn	TRUE
ejhccjihjnlnmcpgpcl	TRUE
fddnnpfkkkjdjhockng	TRUE
fdfalkpgjkddkcnfjfb	TRUE
fnmadlmlopnghjnkfab	TRUE
fnnbghphdcobmnkfgdl	TRUE
gihcmgjmncpdaepapog	TRUE
gihghnjdehinhhnpbfn	TRUE
hcimlalfhpjeegblfig	TRUE
hcioecccnhcninlkcep	TRUE
hmhhkcbmnjkpffbeikn	TRUE
hmhpepeckhnbpnbgdgp	TRUE
ifkpbhoodgjebigibcn	TRUE
iflonnffmofdmfdacib	TRUE
ipdgomaehbfjlmhfdim	TRUE
ipdhjhaedbpibmgkefi	TRUE
jjifahoijhhllbnlicm	TRUE
jjjeceemepihjcifadm	TRUE
kdhpnoaieinhgpkibhg	TRUE
kdiodpokpenflakadoi	TRUE
kneffipgbebnllenhbl	TRUE
kngccjbhbobbcchaaaa	TRUE
lhhfoooogplianaompp	TRUE
lhhojakmoonkcapcihc	TRUE
mbpgeelmfeaigbaohgn	TRUE
mcbfikikbjkinolkeom	TRUE
mmgfiebpfmnoidijble	TRUE
mmggcembdaecanfennn	TRUE
nggamejkcokhjnchfgn	TRUE
nggmngfonnhbocipjam	TRUE
oagfmaimjphpohfkmnc	TRUE
oahaocabclehfegppnm	TRUE
ollaelcfihbafhjabpk	TRUE
ollhfpcmjlealcecpgd	TRUE
pfkmhoifjedpiiacfol	TRUE
pfoeldfaooekjeaepai	TRUE
aaaenljhofpiopcanlh	FALSE
aabidpfhnhjnbbhjgbd	FALSE
akccbldjhbgccgdipbb	FALSE
akdbgjcdlbmbjakfjib	FALSE
beiglhilliphbpbckgb	FALSE
beijdokdmcgfjofibbb	FALSE
bpnjnaamiadkkgbcija	FALSE
bpoobdghdloenbndmbl	FALSE
cjmgchnijijkfajjaaa	FALSE
cjmiopadngonajibmaa	FALSE
depoejlpnojihmgbbbb	FALSE
dfanangefcnpekjeoaa	FALSE
dokhgiadhggipggeaaa	FALSE
dokldibplmihkalmaaa	FALSE
eilblichbbgkmbkjlpo	FALSE
eilfffijolonbfoebbb	FALSE
fddjiiipcfheiehbbbb	FALSE
fdegkhhdghehmbgjbbb	FALSE
fnchgnnioghdplpaaaa	FALSE
fncmbfcfhpdnlfihbbb	FALSE
ghliahkkjhnljkpbaaa	FALSE
ghmcchpmabdncagcmaa	FALSE
hccnciijcbiohcnpbbb	FALSE
hcdhdadgjbmhebghabb	FALSE
hlmgkkcbddegdejbhbb	FALSE
hlnjifgghgjlccpaaaa	FALSE
ifijmhocbbleboipghb	FALSE
ifkgmfgkehmnohpbbbb	FALSE
iopfkbmbefgojagpjbb	FALSE
ipcehjpcbjdojbaagaa	FALSE
jjkeliobbginnnjecbb	FALSE
jjldkkcdikkghokbbbb	FALSE
kcjmdhlglhbgolcabbb	FALSE
kcjnjonmpbcofhmnbbb	FALSE
kmnhbfalganmbingjbb	FALSE
kmobgpibabedhbpkemn	FALSE
lhbndcbegdllkdmkgbb	FALSE
lhdddfgnbamnploobbb	FALSE
mcaflnjkpobiflmjbbb	FALSE
mcbefhaajgajclkagle	FALSE
mmjmihfmodaeijcjaaa	FALSE
mmkmkfbmiaikmmojbbb	FALSE
ngobemcbhdlihgkjmbb	FALSE
ngpapembhhpnaembmaa	FALSE
oaicacikehnmbjkcnaa	FALSE
oaicaolicalpnljkjma	FALSE
olohkndbjjfhbpbodpb	FALSE
ombcegadbhhmkeejobb	FALSE
pgfdcnlbdmgbanojfbb	FALSE
pgglplmbfchadidfbbb	FALSE
