aaahpeefbb	TRUE
aaaicpnobb	TRUE
akcakaeibb	TRUE
akcddfkcml	TRUE
beadbinfda	TRUE
beamechngh	TRUE
bnnchpgcnf	TRUE
bnnicniolp	TRUE
cihhglkcjm	TRUE
cihkdeaehj	TRUE
dcfheoaebd	TRUE
dcfibdjgak	TRUE
dmnkonogge	TRUE
dmobnppoda	TRUE
eichlcncel	TRUE
eidjgggfga	TRUE
fblfffiino	TRUE
fblmkdibaa	TRUE
fljpcdedmh	TRUE
flkfkgiilk	TRUE
gfljphcfcp	TRUE
gfmdbiekgf	TRUE
gpnjlilchg	TRUE
gpoedkinef	TRUE
hjnkgommna	TRUE
hkbfkeioif	TRUE
ididlahehj	TRUE
idimfdbfdh	TRUE
innkdgblil	TRUE
inpancplgf	TRUE
jjafgdhnel	TRUE
jjalalpabb	TRUE
keinalmojk	TRUE
kejjgnoeco	TRUE
kpaciheenf	TRUE
kpchlnkfki	TRUE
ljhbpdlegg	TRUE
ljhldfdjim	TRUE
mcobnbenaa	TRUE
mcpafhikkl	TRUE
mnjlenkadk	TRUE
mnkekencoj	TRUE
nhpdefpamj	TRUE
nhpdkcfohp	TRUE
obnjhkkmeo	TRUE
obodeklomi	TRUE
omdgopbndi	TRUE
omehkihaei	TRUE
pgfldbpgji	TRUE
pggfflbdkg	TRUE
aaahpeefcp	FALSE
aaainoegkg	FALSE
akblcfbmje	FALSE
akcaakmicj	FALSE
belhhjgoab	FALSE
belmocafag	FALSE
bockhimiob	FALSE
bocpcjkcdb	FALSE
ciifiddana	FALSE
ciimpnflbb	FALSE
dcckeabbek	FALSE
dccngaiega	FALSE
dmnmmedmbb	FALSE
dmodgfgbcb	FALSE
ehomlphfaa	FALSE
ehphlhpafa	FALSE
fcfdboojnb	FALSE
fcfglgchaa	FALSE
flngheddaa	FALSE
flnmemecaa	FALSE
ggadfpadnk	FALSE
ggceiphlbb	FALSE
gpmohgfpaa	FALSE
gpnflkohaa	FALSE
hjndjnpfaa	FALSE
hjngjcbipb	FALSE
icnlffghaa	FALSE
icofkijada	FALSE
inikbfbcfm	FALSE
iniphaiiha	FALSE
jiachjdaje	FALSE
jiblehiimb	FALSE
kdhcelpjaa	FALSE
kdiecclmaa	FALSE
kpbifbcdlo	FALSE
kpbinjejlb	FALSE
ligmjcbaoa	FALSE
lihhmdiebb	FALSE
mdjbdinkib	FALSE
mdjmoedebb	FALSE
mnnlpncpbb	FALSE
mnnpdndmbb	FALSE
nibfmodinb	FALSE
nibikdbhom	FALSE
obedehiaka	FALSE
obenccjocb	FALSE
olnmlndgbb	FALSE
ololmbblkj	FALSE
pgdpeeinbb	FALSE
pgekonlkbb	FALSE
aaabokbfond	TRUE
aaamocndjbb	TRUE
akmegipaibb	TRUE
akmkfomeelc	TRUE
bflnnpcihca	TRUE
bfmjiekfnfk	TRUE
bpfpgbjfeaa	TRUE
bpfpnnegagj	TRUE
cjffjhajfoe	TRUE
cjgahadlbgb	TRUE
ddphfhbclkl	TRUE
deahigghkfp	TRUE
dohedllnlbf	TRUE
dohlfaleddn	TRUE
eihbgebaamk	TRUE
eihjjodhkjm	TRUE
fbppcjjihod	TRUE
fcaknimfabb	TRUE
flilapekhlm	TRUE
fliohgcigbp	TRUE
ggkgnmpeoob	TRUE
ggkkbaoljab	TRUE
hbchgimipkm	TRUE
hbdepjbdhaa	TRUE
hlphmdpgkah	TRUE
hlpmjogckmh	TRUE
ifpcieakmeh	TRUE
igagbalcegb	TRUE
ipceapghabb	TRUE
ipchcemekjd	TRUE
jjgelhmbgdh	TRUE
jjldjcbnkel	TRUE
kdohdnamhbn	TRUE
kdpbldbdjaa	TRUE
kobkfpbakga	TRUE
kocgaefibba	TRUE
lijclcdgpjp	TRUE
likakfcbfod	TRUE
mcnkeiipidi	TRUE
mdahdmboaob	TRUE
mmnfkoggjlo	TRUE
mmnlcihcenc	TRUE
nhefcapendc	TRUE
nhemhmdpeee	TRUE
oafgghcohcn	TRUE
oafjccdfejk	TRUE
olebjaojomc	TRUE
olehclabfel	TRUE
pfoilcbdnnj	TRUE
pgafajhhobb	TRUE
aaabplcgpoe	FALSE
aaamocndjna	FALSE
akncfiecjpa	FALSE
aknjkecglja	FALSE
bfccchcgkcb	FALSE
bfdaobonnnh	FALSE
bpfdcbedkjk	FALSE
bpghddeccjb	FALSE
cjcoeaglaea	FALSE
cjdgfjepfbb	FALSE
ddnpkmcccbb	FALSE
ddogamdpeal	FALSE
doliigmkmaa	FALSE
domnnncmiaa	FALSE
eicjhffblaa	FALSE
eicnlafjdka	FALSE
fbkldcpfcob	FALSE
fblfblccief	FALSE
fmamjlbbnmp	FALSE
fmamnhiofla	FALSE
gglpfbpaadp	FALSE
gglplelfhaa	FALSE
hahogkjeacg	FALSE
haidfeofija	FALSE
hlnkdnnlhbb	FALSE
hlnokpgfbmb	FALSE
ifnpdcdcdbb	FALSE
ifodjieegaa	FALSE
ipfdccjbmob	FALSE
ipfkicpfobb	FALSE
jkbdcpinbid	FALSE
jkbekmleghb	FALSE
keeliecdobb	FALSE
kegdlmedoaa	FALSE
knnfkpiffaa	FALSE
knoelemamda	FALSE
lijkkidfcbb	FALSE
liklidgfnbb	FALSE
mcolpfbcdib	FALSE
mcpdnlgoblb	FALSE
mmgonhkccbb	FALSE
mmhoeomfnaa	FALSE
ngdbfgmkbff	FALSE
ngdmonjkmbb	FALSE
oaldnglegia	FALSE
oalppggpgea	FALSE
okecacpnoea	FALSE
okefgpobbbd	FALSE
pgbpnpeccdb	FALSE
pgcbcgkifcb	FALSE
aaaeaokahdbb	TRUE
aaahamflhibb	TRUE
alaeapgbgcpb	TRUE
alalcfbaadpb	TRUE
bfpciiakliop	TRUE
bfppijmodnfc	TRUE
bpmdmockelmj	TRUE
bpoambnlpgfa	TRUE
ckhpbfckoalm	TRUE
ckighohmgfag	TRUE
decklheedamh	TRUE
dedhfgfbccnj	TRUE
eaadjmkipobb	TRUE
eabjpjmadlbf	TRUE
eijdgkjgfbfj	TRUE
eikgafnnfjof	TRUE
fcncempmdcbn	TRUE
fcnlmmckmlbo	TRUE
fnidllmjbfmn	TRUE
fnigaklnpomp	TRUE
giodkdopopio	TRUE
giodmpfghlnd	TRUE
hcpmcnagbkcm	TRUE
hcpncoffmagi	TRUE
hmmicpioagbn	TRUE
hmplakooljog	TRUE
ighcefkoofih	TRUE
igiknddheajn	TRUE
jampiplflbho	TRUE
jaocbojegpab	TRUE
jlmocjodidin	TRUE
jlmpdbbdpbaa	TRUE
kfganeeijabb	TRUE
kfhgccogophc	TRUE
kpdlbiehplhd	TRUE
kpdofjlbfmci	TRUE
ljflmchefimn	TRUE
ljgjmdlpoleg	TRUE
mdbdlmeejcfi	TRUE
mdbhcciocpmd	TRUE
mlpdnknnphdm	TRUE
mmaelhlfbhjp	TRUE
ngapkfedboba	TRUE
ngcndpeconfd	TRUE
oadjgcefhefl	TRUE
oadlpplcncbm	TRUE
oklpemaifpgi	TRUE
okmejjblmfig	TRUE
peljekhfmipn	TRUE
pelokpkdllod	TRUE
aaaeaokahdam	FALSE
aaahflhipieb	FALSE
albbfofgfkme	FALSE
albinadcdpln	FALSE
bgeldhhidibn	FALSE
bgenpbadldgi	FALSE
bplloogmoiob	FALSE
bplmcnngjfeb	FALSE
ckdhdiijnkbb	FALSE
ckdhhbnfmcfb	FALSE
dfidjdipknaa	FALSE
dfijkmmagani	FALSE
eablkphghoha	FALSE
eacfpojdanfb	FALSE
eillkcioimbb	FALSE
eimcjdimjcaa	FALSE
fdblmdfhocmb	FALSE
fdcjeabkenmb	FALSE
fnnephbiijlb	FALSE
fnobjekpinlb	FALSE
gimoaaglkbnn	FALSE
gindhkblfkgb	FALSE
hckfkibfbbfi	FALSE
hckoaafaedec	FALSE
hnbneloehaak	FALSE
hnckebpjbnia	FALSE
ihbnjgadljka	FALSE
ihceklbakaom	FALSE
jbfaeglpjakg	FALSE
jbffaddknjad	FALSE
jlnjcmdbgnbn	FALSE
jlolejchbnib	FALSE
kfjahihjjooa	FALSE
kfjbihgpkinb	FALSE
kpjjabmooina	FALSE
kpkbepcofdjb	FALSE
ljiddddcnjbb	FALSE
ljigbdbafnge	FALSE
mckejdifjibb	FALSE
mclenpehocaa	FALSE
mlojjcmcclaa	FALSE
mlppapdglcka	FALSE
nfheigeangbb	FALSE
nfhkcbgiamca	FALSE
oacmbjmbidph	FALSE
oadfjkjcjalg	FALSE
okkommbmgjjb	FALSE
oklaifeehpha	FALSE
pfjodmfpgcbb	FALSE
pfklnboeplmb	FALSE
aaalkobjjgjib	TRUE
aabnfclfofmab	TRUE
akekglojmbigd	TRUE
akfcaeiblgccb	TRUE
bdnbiagidpeia	TRUE
bdolgdiigdafe	TRUE
cablmdefijfeg	TRUE
cabmpmfmogocg	TRUE
ckniipjpbignh	TRUE
ckphbcinfilej	TRUE
defnomamdkipj	TRUE
dehbckjcioppn	TRUE
docajgnikgemo	TRUE
dofidjfnmcaig	TRUE
ehmkhbpbjljaa	TRUE
ehnnjacebcgcc	TRUE
fbniimhpokgff	TRUE
fboecfphppkgg	TRUE
fnflolnghohbm	TRUE
fngdindoofcfi	TRUE
ghhgfgehjglll	TRUE
ghiihigkigbfo	TRUE
hancdkcedcmpd	TRUE
hancpollhdjpe	TRUE
hlngpheopccom	TRUE
hlodlbeocpcih	TRUE
ifbdmbjpfjjaa	TRUE
ifbggggefmfek	TRUE
inledbbmmhfaa	TRUE
inmljpaincdge	TRUE
jgmomjhpfemag	TRUE
jgnjpbnboloaa	TRUE
kbeondcbcbpaa	TRUE
kbfijbbfaadgl	TRUE
kkimdjfojnodb	TRUE
kkkclamiheicm	TRUE
lfbekhepmjhod	TRUE
lfbmekapkniab	TRUE
lplmhnnfnnhfp	TRUE
lpmgafkopmmbl	TRUE
mlcacnlephabb	TRUE
mldmjmdbhbkaa	TRUE
nggaehgldmnbj	TRUE
nghadhnimmhce	TRUE
oalkpdlnpbiki	TRUE
oalpdfhckbbga	TRUE
okkpbnglfkjpf	TRUE
okmajojnedpfn	TRUE
pfmeaaohibgeb	TRUE
pfmgamhpjehib	TRUE
aaalkobkkhkjo	FALSE
aabgdmgpgnakk	FALSE
akgkifgdookia	FALSE
akhjdoefgmall	FALSE
bengmfemgknnb	FALSE
benkcgoblheji	FALSE
cafboajgmicnn	FALSE
cafdbmlelihmb	FALSE
ckjjpgbiljckb	FALSE
cklccgagdiban	FALSE
dediaiichieja	FALSE
deeaomgdkdhma	FALSE
dnnddikmgpdaa	FALSE
dnngmgndcggaa	FALSE
ehiikegaeibal	FALSE
ehkjbgbdoanmi	FALSE
fcadaanpefklm	FALSE
fcagbkjmookna	FALSE
fnaikmcdbaecn	FALSE
fnehicmapfkka	FALSE
ghjjnbjfpjkpb	FALSE
ghjkfeiaaeekl	FALSE
hamieiigenmla	FALSE
haoejigmondma	FALSE
hlpjmmajhklja	FALSE
hmabodgfgfmea	FALSE
iffdlemmeicaa	FALSE
iffgpaonohcma	FALSE
inpemjlkmhgaa	FALSE
ioalcnodpdjga	FALSE
jhcnoebhbpmba	FALSE
jhdlncgdjghbb	FALSE
kbdmogejdcmeb	FALSE
kbebpmmigicca	FALSE
klgnfhabakoeg	FALSE
klhbbjhmoopde	FALSE
lfkieodgjimaa	FALSE
lflccpbphoaaj	FALSE
lpmgfiafgccha	FALSE
lpmgmknkamcda	FALSE
mlhiekjgjfnaa	FALSE
mlhnlbdkaihma	FALSE
ngblcgaccliea	FALSE
ngcinflomemaa	FALSE
oaiaaekmpnlfi	FALSE
oajfocpanbjdl	FALSE
okkahgndkbgnb	FALSE
okkeeckagappj	FALSE
pepkhjbjmoldb	FALSE
pfahinbnnkioa	FALSE
aaadkmkcefgdbb	TRUE
aaajjkdcpaafbb	TRUE
akopojfoaolmbb	TRUE
alafbcaoepjaib	TRUE
bfenpacgeknmjn	TRUE
bfgkbogemfpbaa	TRUE
calmaecfcphlbb	TRUE
camcmncpddhmdn	TRUE
ckifhicibnlomp	TRUE
ckjacfhbfkimef	TRUE
depmlecfhjkenm	TRUE
dfbfcnhlmodekk	TRUE
dpkbnokbgogmaa	TRUE
dpkmgegnegmkpp	TRUE
eladelnaadgpbb	TRUE
eladmpapgokkbb	TRUE
feipnlcimhmgfl	TRUE
fejbeilcgenfhp	TRUE
fpamoggpjkmlol	TRUE
fpappiahhecebb	TRUE
gjfnjaknjccncd	TRUE
gjgdihjbgaegcm	TRUE
hcihcddlkclffk	TRUE
hcijhkbmifhicd	TRUE
hnejjahohfhpjg	TRUE
hnfgpnoicjdnio	TRUE
ihgihogbbmmeaa	TRUE
ihgnojpdppfdcc	TRUE
jcbffldcchdocn	TRUE
jccbkpeohfnfhi	TRUE
jmliplgdimcngd	TRUE
jmmgibmldedonn	TRUE
kgncejcboejiko	TRUE
kgnficeklnlabc	TRUE
labfnpijcmaajb	TRUE
laclddmeloapbb	TRUE
lkckdhahgdaebb	TRUE
lkcpeaebbldfma	TRUE
meeccfecjnbcli	TRUE
meennnogfjaabb	TRUE
mpbgdfbciekiaa	TRUE
mpdjbblmmbepaa	TRUE
niggafbdeodadb	TRUE
nigjhdfckfhfee	TRUE
ocddegenikkbgo	TRUE
ocdljefklcdkdi	TRUE
omjgbdbbfcfjaa	TRUE
omjkccokcdaefl	TRUE
pgdklpbgigfbaa	TRUE
pgelkilfcaclbg	TRUE
aaadkmkcefgdjk	FALSE
aaajdcpaafidii	FALSE
akoidfdmfbhofa	FALSE
albfophgeboopl	FALSE
beoaegfffjndda	FALSE
bepbmildnlmamb	FALSE
cafgnmifkjimma	FALSE
caghhphkbocmla	FALSE
clbdpinhppdkgb	FALSE
clcobhnmpijjlb	FALSE
dfgccpfdjkglbb	FALSE
dfgedcgcjjenaa	FALSE
dpnmidboocgmhb	FALSE
dpnnolmlagijma	FALSE
ejnfljakdoedfa	FALSE
ekbnjlmghdbhoj	FALSE
ffcjoobpmpnoob	FALSE
ffdcpgimlojpbb	FALSE
foogophkhcicbb	FALSE
fopjofflpbofeb	FALSE
gjdlkhamcgmpba	FALSE
gjehnncklcfjbb	FALSE
hcjdjklekjodaa	FALSE
hcjmeipceljapa	FALSE
hmkkahlcnhobka	FALSE
hmmkbpoamhehea	FALSE
ihjdoakhopddma	FALSE
ihldnfldapaeci	FALSE
jcamcokgofljoa	FALSE
jcfdobfomlagga	FALSE
jmnicngdgibmlb	FALSE
jmnmdedommnoaa	FALSE
kglhcjfnagjcka	FALSE
kglmajipmoghia	FALSE
laaebhjgegmdmd	FALSE
labebcjfkdklbp	FALSE
lkdpjnlhfjjpbb	FALSE
lkeaojaaaidfan	FALSE
mfadkneodaocgb	FALSE
mfbdlmcddldocb	FALSE
mpgngmhlndamma	FALSE
mphfjgdodllkaa	FALSE
nihlpmhcajgaic	FALSE
nikdcebedgflib	FALSE
oclkigdpgnfbmb	FALSE
oclmbomcdpkllb	FALSE
omimgjeoiocpbb	FALSE
omkfbbdahccjfb	FALSE
pgpilhofnamcfa	FALSE
pgpjdiejogdada	FALSE
aacbjjallkggclb	TRUE
aacckckilomfobb	TRUE
akgcpmoolabehhb	TRUE
akhpiejhcmljgen	TRUE
bejncnjcfelbdaa	TRUE
beljogfgikgfefh	TRUE
bohjgaoeegfkhio	TRUE
bohnlhpnaicbeoa	TRUE
chpgnpajkkmlfom	TRUE
ciaiofcmoljgjlp	TRUE
dbolefdaekedheh	TRUE
dbopipfopbhfaoa	TRUE
dmoihfnemmfpcjf	TRUE
dmpcbcedgefopan	TRUE
egkkiachcclhnpp	TRUE
eglhhlcgcbbpjaa	TRUE
fbdfbhjnhkngmaa	TRUE
fbdnccmjpgbfgaa	TRUE
flaeeegllkhgcnm	TRUE
flaoebffcombhha	TRUE
gekjfmkbggomoph	TRUE
gekpfffbeacoghn	TRUE
goffocfncmneoli	TRUE
gofhjecnpcaoekj	TRUE
hiapeplfdgaohbb	TRUE
hiclpddokpddpnc	TRUE
idhfbeponnagmoh	TRUE
idhikpnbkejobaa	TRUE
inkilihohjdmmid	TRUE
innlicnpffomcnp	TRUE
jidpgicocpcagmb	TRUE
jidpimhcgponjek	TRUE
kcdbepdmpajmkgd	TRUE
kcenmihbcohpigk	TRUE
kmpphafepelfabb	TRUE
knaohoekgijmekj	TRUE
lihidhjobefkklo	TRUE
lihonolecejkenb	TRUE
mbpljpojdjfebaa	TRUE
mcbccebjkndicaa	TRUE
mlbgmhfdikekkho	TRUE
mlbkkijnbnjhcaa	TRUE
nfmjhbibempncaa	TRUE
nfocgnedcllckkk	TRUE
npopalofmajbcdb	TRUE
oabiphnecjgleab	TRUE
okhkchomgfdaole	TRUE
okhplaginijncff	TRUE
pepglijgcjfpkli	TRUE
pfafkcbikljlhgm	TRUE
aacbkkammlhhdml	FALSE
aaccckilomfonca	FALSE
akjiijbohelpgia	FALSE
akkbfjbcdkpgdop	FALSE
bdpejiojeggoaga	FALSE
bebjhphnddppbjk	FALSE
bojdigcifoalgcb	FALSE
bokgcmnmiifnfjb	FALSE
chhmcpbdbedglbc	FALSE
chiafamohpbfojl	FALSE
dcnddnnoflgolaa	FALSE
dcobdpconaanpcn	FALSE
dmklfbfajkalppf	FALSE
dmlbdbjcepaghkm	FALSE
ehliehfohnplcaa	FALSE
ehmfaigafcikpgi	FALSE
fbccknienjccccb	FALSE
fbcclfiefkplgbi	FALSE
flfpnkecgaoeaak	FALSE
flgojcijollkcaa	FALSE
gefmklnmnkhbnab	FALSE
gefopbpkjdlllab	FALSE
goebblhcnfidkoo	FALSE
gofalcjfgojkbma	FALSE
hijpknjkdnpbfgb	FALSE
hikaiipbghhgonb	FALSE
ichlokfmcckmiaa	FALSE
ichngjkngfgeaga	FALSE
incmodmlmmldlaa	FALSE
indmehhcaeidkfa	FALSE
jhpiicnjooodlbb	FALSE
jiapcaaapjahnoa	FALSE
kdccacclnlbhdeb	FALSE
kddcnmneoeemfbb	FALSE
kmodbadegchiadl	FALSE
kmpamjcbhlmdeeb	FALSE
lglkabcmhhokbcd	FALSE
lgmfhiohnfhbdlb	FALSE
mcclheajhfapjom	FALSE
mcdmdolljbacmea	FALSE
mlpmacopmjokkma	FALSE
mlpohklmnbclkcb	FALSE
nfhohpcmeenokbb	FALSE
nfjffoogikebepb	FALSE
nppmepkedffonbb	FALSE
oaahohmpglhngkl	FALSE
ojlbmcnnbklkcnb	FALSE
ojlccakphogopfa	FALSE
peoennhmnlpcoaa	FALSE
pephefnfmjkmblb	FALSE
aacckdangfpcpmbb	TRUE
aackkibckpgdoflb	TRUE
akacnbhhlnplmckb	TRUE
akalpafbaakjnngb	TRUE
bedjodpdphgjeplc	TRUE
beeboeojpklbmeaa	TRUE
bojklenecfdeiceg	TRUE
bomelipldgjillef	TRUE
chjmejjkfjhonlnp	TRUE
chklckbdlnjimngk	TRUE
dcanmdmgajbifgmb	TRUE
dccokageghckcncn	TRUE
dmffoimjhoglopcg	TRUE
dmgncjpnloakaebb	TRUE
egjnkfccleojlmfc	TRUE
egkcbigkpbaolkae	TRUE
faickchnmjcaoobb	TRUE
faioefgfplpahhbb	TRUE
flfmdmlgbmflnjak	TRUE
flgdbennkmefbpaa	TRUE
gfdegmbikbfjpeaa	TRUE
gfencepamafkpmbb	TRUE
haaanpnnmljcglbb	TRUE
habchapfnipknaib	TRUE
hljiipdhleikmbgn	TRUE
hljplcldpfbjhgmh	TRUE
igobpecgdoddofel	TRUE
igokfcnkbnkbbada	TRUE
iplienfpacffcabb	TRUE
iplimbiafgaeggpb	TRUE
jkbacaoedbacibhj	TRUE
jkbgnkllbgfdpkaa	TRUE
kfaoiejkmkmbibja	TRUE
kfbbjdglekkpmhaa	TRUE
kpbgfnblhenkmiaa	TRUE
kpbhfmhplhakpbma	TRUE
ljagamapdjpffebb	TRUE
ljcjckncojmojlka	TRUE
mdnjecnkhlhnnbkc	TRUE
mdnlpmofcjeinich	TRUE
moeokeeibbigimaa	TRUE
mofbgmpegffgcfcn	TRUE
nidnhildjmeleclh	TRUE
niffibmopcamjhlk	TRUE
obgldgpdfocfodoi	TRUE
obgmhdmacbhbfpfa	TRUE
olnpnnnanbcchioc	TRUE
olophimefhmbgjef	TRUE
pgakcbajeklcdaeb	TRUE
pgbdddleleiojmhd	TRUE
aaagffkjepeindej	FALSE
aaciabjllleflfjc	FALSE
akikahgifgilnkni	FALSE
akimphffpfbcfjnb	FALSE
bflogbfanchbheil	FALSE
bfmpifgdcciccdkb	FALSE
bpmbifopchiolbgc	FALSE
bpmplcijgoninleb	FALSE
ckoibhcaajhdpmoe	FALSE
ckomoaplomgjcfea	FALSE
dfikhndibfeimfnb	FALSE
dfipbadmneninbfg	FALSE
dpgjjkmkgefkkiaa	FALSE
dpgkcbgaaikcifom	FALSE
ekbcbdakndjmjlom	FALSE
ekbmmlklihmmgcmb	FALSE
fenagldacnpcoicf	FALSE
feogclfafcogpakd	FALSE
fomikhmldioclaja	FALSE
fommnajgkkenbbib	FALSE
gjoinopiibcacjka	FALSE
gjonhjhhkkkmniaa	FALSE
hdiaedmgglhahphi	FALSE
hdigcbkaelmbdpjh	FALSE
hncfnmgacllmiiha	FALSE
hncnconiedgaihpa	FALSE
ihbeaiddnkaeekep	FALSE
ihbokmncbmgidkpm	FALSE
jbbcgjnflmiilikp	FALSE
jbcdenpakjdofamn	FALSE
jkmnjllmamilgamo	FALSE
jknbmojdbckainlj	FALSE
keecakekhdfcecna	FALSE
kegggankngkgojha	FALSE
kpdaopibcbhphnde	FALSE
kpdlmmndclndhmaa	FALSE
lkblllcphlneabff	FALSE
lkckhpkngkbhinkb	FALSE
mdofhaidbjehojeb	FALSE
mdoiionjjcgmbcmb	FALSE
mnaecmdgjabmiigi	FALSE
mnamdhnidcnjncna	FALSE
nhbfbcjgpkpdcokm	FALSE
nhbfoegnjgpkicib	FALSE
oaiddkpeinelmalo	FALSE
oaldfgnengnlihpa	FALSE
olnnmggkfhodjmbb	FALSE
olobejihhcniahfa	FALSE
pflnobiaobddmgpo	FALSE
pflnpkahnpegahpn	FALSE
aaagffkjepeindebb	TRUE
aacjiabikkkdekeib	TRUE
akjibcfjnhcbkegna	TRUE
akknihiecjhoalebb	TRUE
bfonnimmpkklgchph	TRUE
bfpmfhpfngghnkcdm	TRUE
bpjkfabbebdglkhha	TRUE
bpjknllnkpkfpmpcd	TRUE
clacddooegbpnafib	TRUE
claneompggafgbblm	TRUE
dfhcnjmljelleinge	TRUE
dfhncelnaogkohabb	TRUE
dpcgagicichoggocc	TRUE
dpekmneoohojojmkg	TRUE
ekkcamklgciicolbi	TRUE
ekkedogpdepjmfdaf	TRUE
ffcpbdeaohjcbhpfa	TRUE
ffecpjjlcpogpkjfa	TRUE
fojilfanbhcbdlhka	TRUE
fojioajhomphhcmom	TRUE
gjfheepacpmcglgmc	TRUE
gjibjoadfoefkdpdg	TRUE
hebfbepofepghogaa	TRUE
hebldibcapogndjba	TRUE
hndicldneefgbfiff	TRUE
hneodgjhclcnglidb	TRUE
ihanjcajdmddflgbb	TRUE
ihbhljfpjefjpjofg	TRUE
jbhkbigehfndndgaa	TRUE
jbjgmkgeaggomgnfp	TRUE
jkogeeicialmhomnk	TRUE
jkohonhcoediiiddf	TRUE
kebdegkobmamdgnka	TRUE
kedeekhnpllpdljig	TRUE
kpefllkhpmcblnfkl	TRUE
kpelkjeickjblbeaa	TRUE
ljlbphmkljcbpffaa	TRUE
ljllegeackifhoppk	TRUE
mekikebphpkkfajcj	TRUE
memhhnoomaifegkno	TRUE
mncdebcnehmlfodfj	TRUE
mnelbmgpfimehifgm	TRUE
ngehpdkknndbjekdg	TRUE
ngejbimipagnjkoci	TRUE
oajhfgfonnicnffen	TRUE
oaklfdojljkdhbkge	TRUE
olodcnakkokiifhji	TRUE
olpcbpbpenikmmnaa	TRUE
pgfihjmddibnmplpd	TRUE
pghegdegpdleepdae	TRUE
aaaclnfeilcbgkjfk	FALSE
aaadfoefjpkpjdkdn	FALSE
ajpaledbjggdhkcnc	FALSE
ajpconmcimhhckbbe	FALSE
bfjeeknojkoficcab	FALSE
bfjmfndffjinelelb	FALSE
bpmajbkmodhfoplcd	FALSE
bpnfchlcgfmhmdgpb	FALSE
cjmebfhobgifkfkmi	FALSE
cjnleihpnidodijbb	FALSE
ddnpkppkafgejcfai	FALSE
ddojpkdblojclejjb	FALSE
dognnpdjojknlgbjb	FALSE
dohcdehdhmgleaajb	FALSE
ejhcllmflokjmldbb	FALSE
ejhfappcnfldchlla	FALSE
fdcddhdjlefdckcbb	FALSE
fdcfnambglbfgomdn	FALSE
fncfhemlfedkhppaa	FALSE
fndkdnlebkoljhpab	FALSE
gheiklkgekhkkkbhb	FALSE
ghemdhcnjiijfinbb	FALSE
hcbgbmonbnjcoafbg	FALSE
hcbkggebangcknjnn	FALSE
hnedhndiofgpjdlaa	FALSE
hneocmpbghljiemeb	FALSE
iiafklmhencgkjpfa	FALSE
iicjdclfkpjiileaa	FALSE
jbohdcipgclgboolp	FALSE
jbonjbabhfjbjijfk	FALSE
jmikohgchmmgcodaa	FALSE
jmjeimmcglnaeljma	FALSE
kgbeplblfhhibckdj	FALSE
kgcaabononaggiafl	FALSE
lacfgoofojohedina	FALSE
laclgipfnpdikfoae	FALSE
lkhckofebjfofbkmb	FALSE
lkhihkdhcemmalpga	FALSE
mdgaojlakhalkmdji	FALSE
mdhagfchjpanhnmlb	FALSE
mnjbbnldanpdgodip	FALSE
mnknldfcmghfeppaa	FALSE
nhionbefcaknfoaij	FALSE
nhjhbcafdiijlaoch	FALSE
obbccggfbhfnpmbog	FALSE
obchefigdfncmofnb	FALSE
olepbjfehoghnghlb	FALSE
olgnllmohpdlohcaa	FALSE
pegmndgagdhjjmgea	FALSE
pejodilcilkakhjan	FALSE
aacjaclcifmdcbpnab	TRUE
aafmcfipalogoofebb	TRUE
akiaplofbgkefoldjb	TRUE
akinjcgajcdfgccebb	TRUE
beicomgdcbilelkgaa	TRUE
beihpcmgpodalcfhdj	TRUE
bpciffkbohonehjhaa	TRUE
bpcjpaeiigllcifocl	TRUE
cjhfaanbjghbnfnjgb	TRUE
cjhjkhekgiglbpbjaa	TRUE
ddigoglcbfkepphhcg	TRUE
ddjdmijojddcggobel	TRUE
dojkkjmigkpbkmdnmk	TRUE
dokgkemmdgglmnfaij	TRUE
ejfodmonakkoglpbog	TRUE
ejhehkccfgbefnkcjc	TRUE
feolaodhlegioliogn	TRUE
fepinjhbkipjdedbaa	TRUE
fpfbccpieenkngpbaa	TRUE
fpfdjnncgmiphppdbj	TRUE
gjgbfdgacpkbnennda	TRUE
gjggcjoegkeeojnkil	TRUE
hdajmpnpjobdllcgii	TRUE
hdanfocliebojpojni	TRUE
hndcmhfahfbcmpbdla	TRUE
hnehffkdedhkhjccfk	TRUE
ihejacaiopkimokjbb	TRUE
ihfjbacnngekaeghpb	TRUE
jakbphhjfjjpoimnid	TRUE
jalphholdonbgfbkka	TRUE
jlakbbdghnfojhfjca	TRUE
jlbigmjlhmjogoical	TRUE
kgaakjhlhlpbjbhkhg	TRUE
kgbdcafneipcpemgpm	TRUE
laanncpoekefmnpgbb	TRUE
labgfdildoghflmmgf	TRUE
lkiehcejodijajenii	TRUE
lkighonceimplfdndl	TRUE
meobgaccmnamkdjhib	TRUE
mepneciacddacbjabg	TRUE
mpapningocoonbkloh	TRUE
mpbjnfchhmhkgpldce	TRUE
niofgbdlhgegdgljmf	TRUE
njagnlecgihamfadbb	TRUE
occppakhkfclfplcch	TRUE
ocdddkmepdandimdpi	TRUE
olmhdkfkhddjbogkha	TRUE
olmjmdoiffbkkdpbaa	TRUE
pgecheddhjbjcbabia	TRUE
pgemicmffndkcedbae	TRUE
aacjaclcifmdcboand	FALSE
aaffipalogoofejjhe	FALSE
akijlicljlookibaam	FALSE
akipfajhbdgdnoacap	FALSE
bemfmmpelgeclloijb	FALSE
bemfogblipofepieam	FALSE
boiiicgglnnijglpjb	FALSE
bolafopnnkjcmeofib	FALSE
cjgiampfpklbhlndha	FALSE
cjgkadgladpelionkf	FALSE
ddelknaaihdmkjpcka	FALSE
ddjgihiaipnfnldema	FALSE
dopcbgnjpbomhbfkcj	FALSE
dpckjpdnkkakkmjfea	FALSE
ejbcaenbpckbdnnjgd	FALSE
ejcandhghfcblfdijb	FALSE
feefokgcammbemmpob	FALSE
fegbnhnhjjdnlggcob	FALSE
fpdcnifpbgbggefbbn	FALSE
fpemfadnjbdejdahnc	FALSE
gkbgjippiklpfoagia	FALSE
gkcnlmdfhaobbpgibf	FALSE
hchnbknkncjdihpjcb	FALSE
hcloelndgnnilcoiaa	FALSE
hmmiebppkidpekemfb	FALSE
hmnenmihpjdeipjibb	FALSE
ihadmlmnkbolebkdhe	FALSE
ihajhiefplnbeopjjb	FALSE
jakfiofjccennkeija	FALSE
jakibckdicdlboiboi	FALSE
jlgjbjpbmikahloklg	FALSE
jlhmdblmcdhdfaepga	FALSE
kfcnbkdjeidldokaan	FALSE
kfdallainbjjiofkpm	FALSE
ladlipogpjleggfmha	FALSE
ladoofekloobpkadmj	FALSE
lkgcnkhaipkljbmlbo	FALSE
lkhanimbcgnajdhfmd	FALSE
mdlhadfffkdgefkaga	FALSE
mdmpbijkdloogogcfb	FALSE
mpeaefgamifacapkbl	FALSE
mpehmgenclimhmbphb	FALSE
nigpnhdogchkfolfaa	FALSE
nihcghcjoodcgiodaa	FALSE
obmohkilmmicpefboa	FALSE
obnccnpjakginifkkb	FALSE
olcabmpnpimhomfkfb	FALSE
olcamfjjlnanpinebm	FALSE
pfobghcpgjledcafjb	FALSE
pfoihghcgbilacbndc	FALSE
aaabhhfnhophnfpgofb	TRUE
aaajnanjlnkjfdclibb	TRUE
akkamdeeifdklbaipkb	TRUE
akkgeheokhehbkkodab	TRUE
bebfkopiggebgnkdcaa	TRUE
bebkmlkchklipabhhda	TRUE
bncedlfpblibgllbnaa	TRUE
bncocaeefcnpdeanokb	TRUE
chlbdbmffflipedndaa	TRUE
chmmgbcbaclimlajmlp	TRUE
dcggddnnglcgcfbpmjh	TRUE
dchdjnnihjekephdflk	TRUE
dnddamfgpfdonemhdgn	TRUE
dndfijbohjefdmbleaa	TRUE
ehmmalkgafcpodcocbb	TRUE
ehnjmgkidommgegfejl	TRUE
fchlemgaobalnfjgnkb	TRUE
fchnehandpjkejiifni	TRUE
fmbgmhjpfddhglmpggc	TRUE
fmbjeemkbjifadcbmha	TRUE
gfondnfndbdhlcljmcn	TRUE
gfondpndpdkphmapmnb	TRUE
haoppflomlofpjdahbb	TRUE
hbahljjellcimiboppa	TRUE
hlpgdmphpnjldpdfgeh	TRUE
hmacfpafjagadgblalb	TRUE
iflnbfpkhkipadfoffh	TRUE
ifmlpdgdnjbmfgacein	TRUE
ipoggdbpblbhencnbaa	TRUE
ippfhdkcakpamjloebb	TRUE
jjhefgghjegopjkpich	TRUE
jjicdiobngpomhoangh	TRUE
kedodonljeedhhgcigi	TRUE
keehbfajddbcmkaefpb	TRUE
koplbeanfflepndagdb	TRUE
kpaecjhlnifekhnifij	TRUE
lhkmmocndckpnajedof	TRUE
lhmeljfceopcekpldlh	TRUE
mbhojmjjklpaaoomeeb	TRUE
mbjjjibmbdajemcjjae	TRUE
mmcpfmdfjicgbijimgd	TRUE
mmdknmcalcblnppecfp	TRUE
nglnbnchpabifoiohda	TRUE
ngmkodllobmfmnhacab	TRUE
obheefkidiobabmmcia	TRUE
obipocnlkepmllbceaa	TRUE
oljjeojjakihmffljjl	TRUE
olkaoiahopadfghjgbb	TRUE
pghilbngkcfjgeccnno	TRUE
pgikhnmohcnibfbhdaa	TRUE
aaabkjknafgnoophifd	FALSE
aaacdhbanoammkngfde	FALSE
akgodkpkimkkemccpca	FALSE
akgpnlpjhkfnhajohhl	FALSE
bgehdeeajfcalgihpel	FALSE
bgehdfaepbicniojdmj	FALSE
bppolfehahdigkanmdc	FALSE
cackjfdcggiagfemnck	FALSE
cklncnmnbpdiaikcoda	FALSE
ckmehodcgakehjifbhb	FALSE
deoajkmecfaogoanffi	FALSE
deopjikfffcjnjhnkbb	FALSE
dpfhbinakhofaiocmcj	FALSE
dpfpkdcloflchgabhpb	FALSE
ekcbkgcblhokmgiinbb	FALSE
ekcmfmhpicjlekfbccb	FALSE
feaakjpoeloehaepjkm	FALSE
febaljgapcjfcnpgdhi	FALSE
fngfgabphmbhfibbjgj	FALSE
fngmpdhdjfeclmegkbb	FALSE
giedgpfhenaiilajiee	FALSE
gifokmelleamjiipoga	FALSE
hcpggemikoibkmgdehb	FALSE
hdaelabdkphcaedadoe	FALSE
hmekjcccfaannjpecob	FALSE
hmfbcpdmefjadbekoek	FALSE
igpdppjbacdmhojjmla	FALSE
igpigemnlegfhcbefpb	FALSE
ipfnbcbjaelnbcgkmcb	FALSE
ipgbkpcedhgchmpmncb	FALSE
jinophgfbokpfademcb	FALSE
jioecmlegacfnllgnoa	FALSE
kcojbcaiojoohkddpdb	FALSE
kcojjgiklbnikooophb	FALSE
knlpeeknafnliofchpa	FALSE
knmnaebnlcponmcjlca	FALSE
lhgigfefoacoacppcjp	FALSE
lhhfenahcmhclmpphpa	FALSE
mcahbeanhkdlfnpiile	FALSE
mcbapoeodpkljejibhc	FALSE
mmkehihnidlhnmnjmbb	FALSE
mmmbdmmdadoeoidbnem	FALSE
nhhpomdkbpemomjlelb	FALSE
nhikdikbniodffhbjln	FALSE
obflagdmfgcoimhaemj	FALSE
obfldlaeoamfpnamhlc	FALSE
omcckdmaiceeoigeepa	FALSE
omeecdecbobfljinbbd	FALSE
pfmmjnggkpeoafglfca	FALSE
pfmmodnoijpnhmcjibb	FALSE
