aadifcapbb	TRUE
aadkikfibb	TRUE
ajckodaobb	TRUE
ajfpppaabb	TRUE
bdbcjdocbg	TRUE
bdboglchkc	TRUE
bombfkalcl	TRUE
bonddedehn	TRUE
cjpfedboff	TRUE
cjpmgemkjl	TRUE
decbgpjmnm	TRUE
dedaaibocb	TRUE
docnoffdfl	TRUE
dodbbakgab	TRUE
einklkkleg	TRUE
eiocfbbnmp	TRUE
fcikgfijcd	TRUE
fckbklekjo	TRUE
fnbfidbifc	TRUE
fncihiaebk	TRUE
gihalaofbb	TRUE
gihdodkilj	TRUE
hcdklijabl	TRUE
hcegkgfcec	TRUE
hlpmfmpmih	TRUE
hmbfhkdhba	TRUE
igkhijcdnp	TRUE
igkkcmkgie	TRUE
jaojoeofod	TRUE
jaokbihlfh	TRUE
jkdliohine	TRUE
jkefohabbb	TRUE
kdanbgllon	TRUE
kdbckpnhbd	TRUE
kniipkfjkh	TRUE
knjhlnjbge	TRUE
lgniifikjh	TRUE
lgpbilbhgo	TRUE
mbdojmppcf	TRUE
mbedmikfno	TRUE
mmbggoejpe	TRUE
mmcbodoeeg	TRUE
nianjloebm	TRUE
niapcfpnmo	TRUE
obobgcickk	TRUE
ocamchcbdl	TRUE
olkaaemibb	TRUE
olnmapmfln	TRUE
pfoieokjll	TRUE
pfojmfomei	TRUE
aabcnailko	FALSE
aaccdobnec	FALSE
ajnkfdgdea	FALSE
ajnlnndgpa	FALSE
bepkkimgaa	FALSE
bfaficlhka	FALSE
bpfckedoaa	FALSE
bpfgdldjaa	FALSE
cioldhnala	FALSE
cipeoefcaa	FALSE
dchdikdeaa	FALSE
dchglcfnaa	FALSE
dmpgppanna	FALSE
dmphfjlhaa	FALSE
egpmgjljaa	FALSE
ehadooejka	FALSE
fbneimmpaa	FALSE
fboahfjcah	FALSE
flpgpfpcaa	FALSE
flppglciaa	FALSE
ghflldbhaa	FALSE
ghgajhbgka	FALSE
hbgkiapkka	FALSE
hbidoailda	FALSE
hlemgnhkaa	FALSE
hlfbamhcpa	FALSE
iffahaebne	FALSE
iffcfngpaa	FALSE
ipbnjedaaa	FALSE
ipegjknkaa	FALSE
jjjkokahda	FALSE
jjjmnkpbaa	FALSE
kcolhjicaa	FALSE
kcpdachgfa	FALSE
kmmmpcflaa	FALSE
knaepancpb	FALSE
lifdomhlaa	FALSE
lifmdcmhaa	FALSE
mandkplpma	FALSE
maphjgblca	FALSE
mlcenneoaa	FALSE
mlfceeipaa	FALSE
ngbjhhlnaa	FALSE
ngchaeaonf	FALSE
obhdidloaa	FALSE
obipknhnaa	FALSE
olejmbfnaa	FALSE
olfbcjomaa	FALSE
pfadjmkgab	FALSE
pfbanagogc	FALSE
aabbmahkjnc	TRUE
aacdobmdbnn	TRUE
ajngpenoabb	TRUE
ajnkaopkobb	TRUE
bfamieelhod	TRUE
bfbmfbnhjcc	TRUE
bomhahceaeb	TRUE
bomhpbfandj	TRUE
cjdfkdbojib	TRUE
cjdjphbdcgm	TRUE
dcfjjhleifh	TRUE
dcglapmipif	TRUE
dmmipkmphda	TRUE
dmnhpnejpgi	TRUE
egdniimkpde	TRUE
egegnhgkddk	TRUE
fbjjhpohkgp	TRUE
fbjpnnchbjb	TRUE
fmbggkcdjdb	TRUE
fmbhbhagejg	TRUE
ggbpleomnjk	TRUE
ggcfncepela	TRUE
haoojhmghhj	TRUE
hbapemkepip	TRUE
hkkoimhgfbn	TRUE
hkllopjpdep	TRUE
ifcbkmgfgoa	TRUE
ifehgcbbocg	TRUE
ipedhjchobm	TRUE
ipejlbflmkm	TRUE
jimbgaehhlb	TRUE
jioeboojclp	TRUE
kdiapjpfpjj	TRUE
kdilifchdmp	TRUE
kndmhimggin	TRUE
knecohddhdl	TRUE
lgnnhbdefdo	TRUE
lhcjejfkmfl	TRUE
majpkafpdbb	TRUE
makfbjldeon	TRUE
mlnlipcmgfm	TRUE
mloebnefapl	TRUE
ngbmfkllkjh	TRUE
ngcpclblibf	TRUE
oajnpnndpjc	TRUE
oakjjjdegei	TRUE
okiiedlnofg	TRUE
okknahddljd	TRUE
pfckakabbep	TRUE
pfejimoakog	TRUE
aabchkhgeij	FALSE
aaccdhcdmoc	FALSE
aklgcofhila	FALSE
aknaaneeopa	FALSE
bfjaagjomdi	FALSE
bfjanicejea	FALSE
bpkdkpgnkaa	FALSE
bpkeacmhpha	FALSE
cjdekpjclaa	FALSE
cjfdpmaobma	FALSE
deecpfiklaa	FALSE
deeeeefgdaa	FALSE
dodjefdjiaa	FALSE
doegolkpbaa	FALSE
eificgiflaa	FALSE
eigcndemhaa	FALSE
fenpjngdama	FALSE
fephapmopfa	FALSE
fojpjmjhgaa	FALSE
fojpmnjpgaa	FALSE
gikgdfblgaa	FALSE
giliemhjnaa	FALSE
hclkcbmecaa	FALSE
hcnfddnmgaa	FALSE
hmfmockdhaa	FALSE
hmgaejngkma	FALSE
ihfbgkfdkaa	FALSE
ihfhhcjggaa	FALSE
jahigdbijia	FALSE
jahphnhhmpa	FALSE
jkmlbeojmaa	FALSE
jkpihhlneaa	FALSE
kfcmeblmoaa	FALSE
kfdingbpana	FALSE
kpbnhpampha	FALSE
kpbpglcpcaa	FALSE
ljgbdlnfaka	FALSE
ljgkhdaccla	FALSE
mcjkalfpmha	FALSE
mcjklcghjaa	FALSE
mmbcicmfkaa	FALSE
mmbnhgkgoaa	FALSE
ngjdljddeaa	FALSE
ngjnldbdkaa	FALSE
obopjkikdaa	FALSE
ocbhkldogaa	FALSE
olkkoajfoba	FALSE
ollildhfkaa	FALSE
pgbcnknlpaa	FALSE
pgcihblodaa	FALSE
aabbgjgfdhic	TRUE
aacdhcdmocbb	TRUE
aklgidagcfbb	TRUE
aklpjinemfgn	TRUE
bflbmdnocnhc	TRUE
bflidlajadgb	TRUE
bplmlnihiocp	TRUE
bplplgboblap	TRUE
cjnkeencnafm	TRUE
cjoebaefapbp	TRUE
ddfndfekfbpa	TRUE
ddfnhfhngbgl	TRUE
dnmldamklkgd	TRUE
dnodcodmghcc	TRUE
ejadgggjmabb	TRUE
ejafmajeopbb	TRUE
febgjebgdpdb	TRUE
feblpaibaooe	TRUE
fodcpkoiaeej	TRUE
foemcbcneoaj	TRUE
ghbcmfmfdidp	TRUE
ghcdkfhpckej	TRUE
hcpkbedbcead	TRUE
hddfbgnkchol	TRUE
hmmjhbaommcn	TRUE
hmoeakifnbic	TRUE
iggdhjcgoapk	TRUE
iggdnelinkgi	TRUE
jagdhlhabgnb	TRUE
jaheankialbb	TRUE
jlbadeedcjjm	TRUE
jlbdeeeelclc	TRUE
kfenopejlplg	TRUE
kffekobfdbea	TRUE
kpiikdnljdde	TRUE
kpilldbcjhkc	TRUE
lioebadaikdb	TRUE
lipgkiaknbcp	TRUE
mcccgmfjicmk	TRUE
mccpighkfpgl	TRUE
mmgaikkkedon	TRUE
mmggmhbdcnjj	TRUE
nheoahgalcbb	TRUE
nhfdogecahne	TRUE
obimigbclnfk	TRUE
objgjggflipe	TRUE
olnimmoholab	TRUE
olobdmalblmf	TRUE
pgdijkbkkimj	TRUE
pgenbaljklen	TRUE
aabchkhgeijd	FALSE
aacdhcdmocbp	FALSE
akmbdofomdka	FALSE
akndommlieca	FALSE
bgcapcepnmda	FALSE
bgcfidpemnaa	FALSE
bpidaogenppa	FALSE
bpiidlmhemaa	FALSE
cjnpnneolaba	FALSE
cjojbchniaka	FALSE
ddkmljclooaa	FALSE
ddknkgpaknja	FALSE
doeinodcecaa	FALSE
dogebnefioaa	FALSE
eilfcbfajmpa	FALSE
eilfdiehenaa	FALSE
fejiijpmklaa	FALSE
fekapehmkdma	FALSE
fojbfmpnomaa	FALSE
fojlehikcana	FALSE
ghncbiklfjaa	FALSE
ghobikjmooaa	FALSE
hcjcpdjiegaa	FALSE
hcjdghmokoaa	FALSE
hmdhmelkanfa	FALSE
hmeefpcpemaa	FALSE
ifjnmhjomfaa	FALSE
ifjolfgjloaa	FALSE
jahjfakdopbe	FALSE
jaiakjibokjk	FALSE
jkgbgfiiflaa	FALSE
jkgelpniogaa	FALSE
kenglmkegkaa	FALSE
kepbcgidllaa	FALSE
kpfekallfpma	FALSE
kpfhhcghjjaa	FALSE
liejicdmmiaa	FALSE
ligdfpnoggaa	FALSE
mckghmfbmpaa	FALSE
mckhjbcjjoaa	FALSE
mmkffjjmkbaa	FALSE
mmkmlnjhdkaa	FALSE
ngfhpgpdihaa	FALSE
ngfjdpencfaa	FALSE
obpegdfiphaa	FALSE
ocafliiicika	FALSE
olipdnjeojaa	FALSE
oljiemmpogaa	FALSE
pgmdinckhkaa	FALSE
pgmfdildfnaa	FALSE
aaahoclgaocbb	TRUE
aabcmfbbknlke	TRUE
ajkjojmhcmofn	TRUE
ajlnbeapemlnb	TRUE
bfogoddpjcndc	TRUE
bfphpbpdgohcc	TRUE
cabndcfpppbod	TRUE
cadddjhijldnp	TRUE
cliplkjmnencn	TRUE
cljfahabkgcib	TRUE
dgkckclcladkp	TRUE
dgkfolbdphgkp	TRUE
eahkfeinkgpjf	TRUE
eahmhhgminjnd	TRUE
eldhciceiflkd	TRUE
elfmmheilibgo	TRUE
ffakcjjihjdgf	TRUE
ffcfpickipmbk	TRUE
fooclmdaceggo	TRUE
fophibgadlnpi	TRUE
gjbmdphnnhnep	TRUE
gjbpgolgcbchf	TRUE
hddpeigcfgohp	TRUE
hdecceobdjcag	TRUE
hnhbffohlfkbj	TRUE
hnhnddpiohfdi	TRUE
ihfkgofojmfco	TRUE
ihhkpjpmjageb	TRUE
jcplelkbcocbp	TRUE
jcppafncfebmc	TRUE
jncmhdmkjigec	TRUE
jndgpciomdoaj	TRUE
kgmnaagfnkpbb	TRUE
kgobappcopmoi	TRUE
lafekogfkbdin	TRUE
lafkgeaikhnbb	TRUE
lkhdjobnajnkf	TRUE
lkhklkppclckn	TRUE
mekpamkgdcekf	TRUE
memloidjjklbe	TRUE
mnkbcepffjnli	TRUE
mnkgnjndgkadi	TRUE
nihfgmlpiemia	TRUE
nihnhflmogfoe	TRUE
ocghmfoeeieje	TRUE
ochakkajobiab	TRUE
oliklbkmghigp	TRUE
oljjbenglhine	TRUE
pffinolopdenm	TRUE
pfhcgjknbfffb	TRUE
aaahoclgaoccm	FALSE
aabgcclomlfof	FALSE
ajmjojeebfcfa	FALSE
ajmmhchopmloa	FALSE
bfoofdgjmhhaa	FALSE
bfpcadljnilda	FALSE
cadngpnpnnena	FALSE
caenidenkllad	FALSE
ckmalphifpfea	FALSE
ckognfdpfpfaa	FALSE
dgakkjfjmfboa	FALSE
dgbgnkdhdjana	FALSE
eahaialabadil	FALSE
eahmkciomfcaa	FALSE
ekiljbddanipa	FALSE
ekjbekgflcaad	FALSE
felecoinibeaa	FALSE
feljiiioeopaa	FALSE
fpdchjbdfjpaa	FALSE
fpfohfnmmamka	FALSE
gjfkepfaalkij	FALSE
gjhaiemcaoijm	FALSE
hdgdahclcianl	FALSE
hdgonggdimjaa	FALSE
hnjndfndbicaa	FALSE
hnkdjdhdfnaoa	FALSE
igpgglpbflmaa	FALSE
igpogphogomaa	FALSE
jcijeiaafinip	FALSE
jcijjpmaionja	FALSE
jnikkejofgiaa	FALSE
jnjncfjaonfba	FALSE
kgcifeefcggaa	FALSE
kgdeoajeihfha	FALSE
lackfkljjbcma	FALSE
ladfcjpepalhf	FALSE
lkfkngcdichaa	FALSE
lkgbkahgflhda	FALSE
mdoidbkoahmfa	FALSE
mdonogmepaagf	FALSE
mneelchjdhkaa	FALSE
mnhepnnpkdfaa	FALSE
nicnmjljhfdaa	FALSE
nieamfdmklacj	FALSE
ocafhccfpinpa	FALSE
ocalmgfjmonna	FALSE
omdhibicmkhaa	FALSE
omdojmklnhjaa	FALSE
pfafkfbnndika	FALSE
pfaginlpbgcna	FALSE
aaahfcamncdobb	TRUE
aadacabfgjmlnb	TRUE
aklfajjmoilkbb	TRUE
aklinpmblpboah	TRUE
bfpiaciibdagol	TRUE
bgajjehfekfkab	TRUE
bpncgjhpihacnb	TRUE
bpogbgehnbdnok	TRUE
cjmjmamefgcmcf	TRUE
cjmnopmkmoalbj	TRUE
dejilhfjpgoben	TRUE
dekpedejcampdn	TRUE
dpmfbcehbmlgjj	TRUE
dpmgmalnljgcbc	TRUE
ejpgalgibadjhb	TRUE
ekaadoghgbiifb	TRUE
fedfpgjlanjijf	TRUE
feelbmmbhjeemh	TRUE
fncmhkoepgicoj	TRUE
fndkkkgkhmefkk	TRUE
gifimphfjohbeo	TRUE
gifklgaocjgnon	TRUE
hdcflkhfjaafbb	TRUE
hddpminijogkgg	TRUE
hngblbaoenihci	TRUE
hngcfedpjmmhhh	TRUE
iibmjfgjkhgpno	TRUE
iicddglmmakgph	TRUE
jcbhinjadfapab	TRUE
jcchhehkppgdfo	TRUE
jlkealbmgopjab	TRUE
jlmdkdpnlljkin	TRUE
kfhgoanbmcpbjc	TRUE
kfhpnlonogjoeg	TRUE
kplfpfiffkgapj	TRUE
kpmemdlmjbibff	TRUE
ljjecjlbhdaeab	TRUE
ljkcemlnjflacd	TRUE
mehpnbfhmdkpdf	TRUE
mejgjikcimaofd	TRUE
moglnigejklemm	TRUE
mogmmlcfbdcgjk	TRUE
nhkkldchhkbbio	TRUE
nhlajcjcjiplhj	TRUE
obkfleoeeepaop	TRUE
oblmfciljiceak	TRUE
oleodlkckccdck	TRUE
olgaglbpbpejln	TRUE
pepjckkpodjhco	TRUE
pfalgkffokpkkn	TRUE
aaahfcamncdoao	FALSE
aadabghknmocml	FALSE
aknnncbofkleoa	FALSE
akpelkbmihmifa	FALSE
bgfmnpnpimnjaa	FALSE
bggfomeeiecfaa	FALSE
bpnahchfioceoa	FALSE
bpolafchoppgma	FALSE
cjohnldgnjkdaa	FALSE
cjpfpfolifhjaa	FALSE
dfbmmkpmejfhaa	FALSE
dfbohdppejhoaa	FALSE
dpbhghhgednkaa	FALSE
dpdblcgcpjcdaa	FALSE
ekkafiagconkhg	FALSE
ekkcclggjmocaa	FALSE
fdmehoobefagla	FALSE
fdmfgjhkppojaa	FALSE
fmlogddjeeomaa	FALSE
fmnnjghhdhejaa	FALSE
gifodbcmoejdaa	FALSE
gifohlppkoocaa	FALSE
hddhlifpanlcpa	FALSE
hdfceaahiiljea	FALSE
hngeakmnedkjpa	FALSE
hnhmankagdfhhe	FALSE
ihikiodcbjicaa	FALSE
ihikjmeppcfoaa	FALSE
jcckcdnjkjihaa	FALSE
jccmbajeffodda	FALSE
jlpfnmlaenaofc	FALSE
jmaaoenpljnijg	FALSE
kfejnhpdkfofaa	FALSE
kffaeadjanijkb	FALSE
kppabienppgkaf	FALSE
kpphhmieedcnaa	FALSE
ljkiomjbgjldaa	FALSE
ljlblohcjeigaa	FALSE
mdodoaigcnabep	FALSE
mdoegfjeegkdaa	FALSE
molooafldgjeda	FALSE
momamchafgpehp	FALSE
nhgjlnphlkpcaa	FALSE
nhgnkcfdmdmjaa	FALSE
obijhilciodpaa	FALSE
objhjfimgondaa	FALSE
okohodkofipkaa	FALSE
okoihjglkihlaa	FALSE
pfdcjbcdhagnda	FALSE
pfdldpohmkpnaa	FALSE
aabdokennbplaak	TRUE
aabjaohaockgbbj	TRUE
aknobckooelncoj	TRUE
akoadpphkjeapbb	TRUE
bfmipjeecdhdbdb	TRUE
bfmlelcdkjbacfp	TRUE
cafhfgklkolhkip	TRUE
cagdmnfkmalnhbb	TRUE
cjojnndhjcidaic	TRUE
cjpifhekgofgfkb	TRUE
deejcbfjhjpfggo	TRUE
defjajhpkaffbob	TRUE
dpjgcbamljggahb	TRUE
dpjmmncbkmanlfn	TRUE
ekgleoccanmipch	TRUE
ekicjodobepfjon	TRUE
ffnchdnfkffehmc	TRUE
ffnljkgbnpioppe	TRUE
gbbmefbmgmepele	TRUE
gbdddpafihloipb	TRUE
glfoekbenejmmpe	TRUE
glgkeipbolkapgp	TRUE
hegmcegabepkfkk	TRUE
hehdmdieaoechpo	TRUE
hohglegacpccabb	TRUE
hohlbjagdfnhmkp	TRUE
ihnegngnifhcafi	TRUE
ihnoafgbcdpkdck	TRUE
jbmmfnkionddjgk	TRUE
jbncbohdnnbpokb	TRUE
jmghlojbimcmmde	TRUE
jmhalaejkioglbb	TRUE
kflbifempbkggpj	TRUE
kflkjfpjfkkkbda	TRUE
kolbcecieclenie	TRUE
kommdpiikkmfnoc	TRUE
ljmgbiknimejddg	TRUE
ljmgckmiffolmcn	TRUE
mcpegpdnjefnmlk	TRUE
mdapghnbheaeddb	TRUE
mokdhkedhkgedea	TRUE
mokfjbcaaoglkhb	TRUE
nhegoblodmcpgln	TRUE
nhekphpncndhfan	TRUE
ocldogbjeakhomg	TRUE
oclndachedgfigl	TRUE
ominoihnbbcekmc	TRUE
omjjioeolahdilp	TRUE
pgbkicfniojfgad	TRUE
pgcfapbdeejiilk	TRUE
aaalibkfhljoden	FALSE
aabjdelpfmcgpom	FALSE
akklikjboehffoa	FALSE
aklbofgcolkclha	FALSE
beiiiniioalkmoa	FALSE
beijajkgeighdda	FALSE
bnjgnkficdkhfaa	FALSE
bnjolanljajdgnl	FALSE
chnjhmmmpibieaa	FALSE
chnjnooiihndoaa	FALSE
dbhdnnpfpalcfpa	FALSE
dbhgdlnmlplllaa	FALSE
dmfjjjckkpfefaa	FALSE
dmggplcgoalmkea	FALSE
effgfidodamjahg	FALSE
effjegdpediicaa	FALSE
epknnojgejhkpaa	FALSE
eplfjefkiijpjaa	FALSE
fkckmfgjenefpaa	FALSE
fkeeanflakhmcid	FALSE
gfccjcpodnpdkaa	FALSE
gfcenenclecagad	FALSE
hagbljnfjccmpda	FALSE
hagdcdefalomcje	FALSE
hkdmleholbcmfaa	FALSE
hkfdkdhgcihphaa	FALSE
ifcniajfmfhagno	FALSE
ifdgfcgekjfpbaa	FALSE
ipedgloodelpgaa	FALSE
ipffanaijnndcof	FALSE
jjdjiclchkledaa	FALSE
jjdncpoanoejeah	FALSE
kdmoldnpmfccgaa	FALSE
kdninlcfgneogaa	FALSE
kofinbdpglcfmaa	FALSE
kofkkonchphimaa	FALSE
lijnabhkjhomjda	FALSE
likokaabgjcheik	FALSE
mdbhpkacoodfgfa	FALSE
mdfajlhpbcmdena	FALSE
moijmcdofepcpaa	FALSE
mojjokmbhlecoaa	FALSE
nhpmokfcmnifkaa	FALSE
niadegkgebahomm	FALSE
obniggoiknikmaa	FALSE
obofndmocngcaea	FALSE
omdcplldndfomaa	FALSE
omefdbdhcilnmaa	FALSE
pfmahbcmiclmfma	FALSE
pfpfipgnaodgmai	FALSE
aaalibjegkincdmb	TRUE
aabicpdkoelbfonl	TRUE
akhnkggcfpjdnncc	TRUE
akicmlekoljmknln	TRUE
bdnfedlemmkelfec	TRUE
bdnllglgfcaadfib	TRUE
bncpjbnclnbkdbpa	TRUE
bndcehohlmeoopii	TRUE
chlhdooogojodplj	TRUE
chmacoenhhljflgi	TRUE
dbepbggejjpbojkf	TRUE
dbgahmfhblghkbho	TRUE
dlpjjoleaboigjab	TRUE
dlpjonikemjcflkp	TRUE
eghbfdflpaiiflml	TRUE
eghkjoejnjebakab	TRUE
epkbhlkcckjkbnfd	TRUE
epldodbfagnnpnng	TRUE
fjefdagflhbnadpb	TRUE
fjeidanfpjdbjacb	TRUE
gejnejjpclngianp	TRUE
gejopdjabmcnheab	TRUE
haklfnclamlpjabb	TRUE
hakokjendcgldpej	TRUE
hkhenffpdecamghh	TRUE
hkhgcfpifknemfom	TRUE
ienpidafnnnikhid	TRUE
ieolegijlgdpiegp	TRUE
ipejpnomdglgpdoi	TRUE
ipfmiolhljlbigpa	TRUE
jjeklklgpkkbpail	TRUE
jjelcdohgfkmieih	TRUE
kdkgckfblignogma	TRUE
kdkjpkgcnnabgjih	TRUE
konloidkmpfjnkgp	TRUE
kooefafkmlpfbjej	TRUE
linpcbopleecdpmo	TRUE
lioelcnjhfhnbgcj	TRUE
mcmaddembaeahbdi	TRUE
mcoajmklopbncjdp	TRUE
mnofkjgclhefnpoa	TRUE
mnogfmljoifckfik	TRUE
niflgpkiemfbiaem	TRUE
niggepahpanjbaeb	TRUE
oblkokadbkogbamf	TRUE
obmieldnnlibcedc	TRUE
olajfpbdddcpbdnm	TRUE
olandmmmkddbfifo	TRUE
pfpignngpgdhcobn	TRUE
pgaonjlaadhijebb	TRUE
aacbphkhkeocniln	FALSE
aacjmpedecollggi	FALSE
aiiohbmakmlnajkk	FALSE
aijhilkochcikjla	FALSE
becgegmnknomccaa	FALSE
becillmehikgghaa	FALSE
bmhnckadonfooaao	FALSE
bmidokcddepkijaa	FALSE
cgigchbldakejlma	FALSE
cgjogniiledmddaa	FALSE
cpncjbmlacemgkfa	FALSE
cpnekbjpdjdnjcaa	FALSE
dlfhcjdenogmljaa	FALSE
dlfooffmfednfpaa	FALSE
efdoengllafohlba	FALSE
effggekganiecjda	FALSE
eojlijchlilnjdaa	FALSE
eokikaccfjfipoja	FALSE
fkbejekddemljcaa	FALSE
fkdieeabngkkgnpa	FALSE
gejkophbgfjlihaa	FALSE
gelacilimenbnoap	FALSE
hanncboiadonfcen	FALSE
hanolibagmocaifj	FALSE
hlfacbehkomdoafa	FALSE
hlfaoebddapijjol	FALSE
iekehoninndmjeaa	FALSE
ieknbllmdpkgcaga	FALSE
ioabioimhdegiffa	FALSE
ioadbfplhfmihfha	FALSE
jjcoicngjheefbaa	FALSE
jjdkgnpbjhnnkoaa	FALSE
kdlkamhlmncdljpa	FALSE
kdmglollfblmkcaa	FALSE
knomjainjghkoadb	FALSE
knpdiieaoolmhika	FALSE
lhbnodjjijdfolaa	FALSE
lhcndfmgfonlemaa	FALSE
mbckafffffanchgh	FALSE
mbckmongjnohpjaa	FALSE
mmiejbnmgepajnpa	FALSE
mmillmplkegocjaa	FALSE
niohpppnaikdlgja	FALSE
nioopohkadnmooja	FALSE
odhdmkpphnejcjaa	FALSE
odhgmccnliclclaa	FALSE
omepfhjomkcfjjaa	FALSE
omfpcefoncfbdpaa	FALSE
pgidafdnkcollbna	FALSE
pgimllbmldhahpma	FALSE
aaafmohfhkglcpmbb	TRUE
aabijklklbeonkncp	TRUE
aknckjaillkdbcjeb	TRUE
akoappeiflfcgmgbb	TRUE
bennpobpdgaoecbia	TRUE
beoiljcfajpgaplcb	TRUE
bpodmkbbpnbomhnla	TRUE
bpoibedkmdflfooll	TRUE
ckhkkimdflfajoilo	TRUE
ckiccbckkhlpdckip	TRUE
dgbefchojdhikjefi	TRUE
dgcggpbbmefkfgcpd	TRUE
eafmecdfadgeeoibb	TRUE
eafnnokedeclidgep	TRUE
ekhpajajcombjkanb	TRUE
ekijmjmfadaiohmbb	TRUE
ffhcdpanmllpngdfd	TRUE
ffhfhccdebkpogihb	TRUE
fopfgmnbkdhbgpekb	TRUE
fopfjkbbdmfdolceg	TRUE
gifhmngbpgplndlfl	TRUE
gignncoicpefbhpfe	TRUE
hbmdkknkcflglnjin	TRUE
hbnggonjgkpnbmdmj	TRUE
hkkgdjeiblhbapncn	TRUE
hkkjkbbbegbhanjbe	TRUE
idneaijbgdccmaajb	TRUE
idopnjghiaepdafbb	TRUE
ionedmblnebnjjeak	TRUE
iooeggekeghccnono	TRUE
jjlgjelfeebjjhjoe	TRUE
jjlmckoncefkmkegj	TRUE
keclnnnbglpilidio	TRUE
kednanlfhmiahifbb	TRUE
koldladbjledfjdbl	TRUE
kololiobcmhlpenec	TRUE
ljoljfnjlbhhjgnag	TRUE
ljolnkpahdeeibihh	TRUE
mfhlgcjgefnpomefo	TRUE
mfiekeooggnggclmb	TRUE
mopeklhaoheflgnpg	TRUE
mopolepcehcjojhgc	TRUE
njabeccoomklaehnb	TRUE
njbfmabgcfadeeebm	TRUE
ocndbonkccnmgfklo	TRUE
odbhaidkneeffhfjo	TRUE
omhoodnchbndgpdhp	TRUE
omimiefkadmjcfibc	TRUE
pgjebnejbficcmcjl	TRUE
pgjjefilodfgdbeoh	TRUE
aaafmohfhkglcpmin	FALSE
aabkmlmcfpoloddln	FALSE
akkochfhpflmedoea	FALSE
aklkcijiigmbpnhka	FALSE
bgfehoeejiicdaija	FALSE
bgfihceeeoahdmjoa	FALSE
bpofneppmcjnpjdaa	FALSE
bpomfademljfdlgad	FALSE
ckkomgajgaikdkbkp	FALSE
cklllinhjpnmmknaa	FALSE
dgbcndignkmhongaa	FALSE
dgbhghdaomgfjapjg	FALSE
eadafpkbopnfmkolg	FALSE
eaeilgfobopongjda	FALSE
ekaaikcfaplnjnkce	FALSE
ekbdjeioihpghepaa	FALSE
ffgmnnhgignikeiaa	FALSE
ffgngpdllcckamcfa	FALSE
fonnjaiionkapjpdm	FALSE
foolbmpgpmckgimaa	FALSE
ghjpnbpenfjfhjala	FALSE
ghkdimgpbnncjcdaa	FALSE
hbeehlhklenmpamla	FALSE
hbefjapchgeonifea	FALSE
hkckkglaaodpndjaa	FALSE
hkddbeichpkoomiaa	FALSE
idoclpclgcbpefaha	FALSE
idofflchimndlhgaa	FALSE
iokkipofbcnhklnaa	FALSE
iokpicaajfibpmkgc	FALSE
jjggaligjgapocfgl	FALSE
jjgnhmhkeieghkbaa	FALSE
kdjpokajndmgegmda	FALSE
kdkelokhncamnjlag	FALSE
knokenopomcehomaa	FALSE
knpkmafcchcalmhda	FALSE
ljimfihbenflploaa	FALSE
ljiomghecbkihhnaa	FALSE
mfhkdaoiakfdigjla	FALSE
mfhniilccnbjlekaa	FALSE
moohmffhlphpapmea	FALSE
mopfgbfehpkacoiha	FALSE
nieoephnajhcelkka	FALSE
nifonhcagenljffpa	FALSE
ocpmmkiobaakdjmck	FALSE
odamkfgdgidggalel	FALSE
omhehndflcdmpckaa	FALSE
omhijfbdljiihdiaa	FALSE
pgemkbajepllmknha	FALSE
pgfbllgdlnhaaampp	FALSE
aaajhkgcfeaompcobb	TRUE
aabnmgkmcohmojeiab	TRUE
ajlijdfpgpjdcgcijf	TRUE
ajmienmgbnigibdjjd	TRUE
bdopgngfidhimejgdd	TRUE
bebkehmaimmhaandhc	TRUE
boegffpjkgeeeephgi	TRUE
bogkcllbiigofoljjb	TRUE
cjabkngbmcgficklhl	TRUE
cjblojnkglbaenllhm	TRUE
dbmnldbdblohghejgo	TRUE
dbneidckjkecjlhkdc	TRUE
dllaemlelljaphelbb	TRUE
dlmamnkcinggdmapbb	TRUE
efgcmidapackheijbb	TRUE
efhfnnoggfjckpjndc	TRUE
faaepmcnafnefdacbb	TRUE
fadghjjcagopflhmbb	TRUE
fkclpgoalgejjkddje	TRUE
fkdjfokhamgkncggek	TRUE
gfhkhijbobdoekpigf	TRUE
gfigplhojobimmjgnl	TRUE
haknehajhmejhfbdlb	TRUE
halafabmkdgjfidikb	TRUE
hlcjicaigjlnbdimmb	TRUE
hlehhiniagcennhfdj	TRUE
iepieoahjolfpklgmj	TRUE
iepjgbfeojhcmjdhhn	TRUE
ipmhndhemheajlcokb	TRUE
ipmjglebanmibolfei	TRUE
jjpidlpgahmccmmeig	TRUE
jjpjpddpfbkbkbobfj	TRUE
keaimohlhehpnjoghj	TRUE
kedjmdceolnbopjeib	TRUE
kngacffggafonnaobb	TRUE
knhalnmocoigkjonij	TRUE
lhpjcihodkanfcmhid	TRUE
liacebfokcajoniacb	TRUE
mbifmpjpjcdoofcnnj	TRUE
mbkeabhckambfinopm	TRUE
mlkkhhpilnnhidlkcg	TRUE
mllolngjihmjnbekij	TRUE
ngdnhhnncdlbfjhchn	TRUE
ngecnemmdjdnlnpnmi	TRUE
oadihkcaonkbbmbjbn	TRUE
oaeddkdledikpbapdb	TRUE
okiaammbjfklmejdhb	TRUE
okldilfgkcjobgaokp	TRUE
pgbljambeenjbjhmck	TRUE
pgcbjkgbhadaocppjj	TRUE
aaacjolgbconhjmdjg	FALSE
aabmoimgighjecakcl	FALSE
aipjgninadhaleejig	FALSE
ajajegkkhdfphfcope	FALSE
bfajoekedidcodnmca	FALSE
bfdildgkodknleidaa	FALSE
bokaopglkfmipmedja	FALSE
bokhallmccolpfoape	FALSE
cjenaomphcgmmllpda	FALSE
cjeniolceimegegkaa	FALSE
dcfjmlfeoebhpnimaa	FALSE
dcfpkfjffpjlahlfba	FALSE
dmlnbajimnhlfgldna	FALSE
dmmeffneljclbpnoaa	FALSE
ehedmpnocomjfdbjaa	FALSE
ehfjfnhhokcdehdpaa	FALSE
fapimchkmkgpjdmlia	FALSE
fbdjfadejaemolemjj	FALSE
flfdhmdpoiohpeboaa	FALSE
flhaibfapodeffglpl	FALSE
gfgpknenmglhmjjeaa	FALSE
gfhabaofdmmlcnefim	FALSE
gpkchpaijfiakoapal	FALSE
gpknhcpjamhhkjhioa	FALSE
hjndemfaomkbjpdhoa	FALSE
hjomfgadagndegkgma	FALSE
idjpoakcbopimpfaln	FALSE
idkbdifegngklhiaha	FALSE
inmamaddjbhfpgdnea	FALSE
inmoeelbejdeceikaa	FALSE
jhomocnhhkccniaeka	FALSE
jhpjcfagbialfehekh	FALSE
kdggdgodnfpiacnnfa	FALSE
kdgifonndbifkncpaa	FALSE
knjmfolkanplfdnbla	FALSE
knkjdcmocnfbckcfaa	FALSE
ljjknkpcibakncncam	FALSE
ljkgcmglaabianofpa	FALSE
meabaljjafnmlnjaie	FALSE
mealpfflhocmbahpja	FALSE
mmkocogncbpidpjjaa	FALSE
mmmaohgghijmgegmpa	FALSE
ngmofmmhddlnemcjaa	FALSE
ngnfkomphmjghjkfaa	FALSE
nppdfgoofcaemnmdma	FALSE
nppjlidocflgmjnmaa	FALSE
olhafepbkmoljmamph	FALSE
olhcmjbpdhhfknoiaa	FALSE
pgeabfgpkkphaikcgp	FALSE
pgeconafdilfnfpahc	FALSE
aaaahceicbhbeemmkfk	TRUE
aaalpcphmphejddohbb	TRUE
akpjopkdeemdejlbeib	TRUE
albkmhcgkjedhipomab	TRUE
bglkpffkkkenjmbakbo	TRUE
bgnbdgfadjhmkohjdjb	TRUE
cbdncejbpkgodaedmac	TRUE
cbfcfbcgjapeinjkaco	TRUE
ckehplbaeohadimopmb	TRUE
ckhflmcncgbfknaeamb	TRUE
ddhohkppncpcfnmgeim	TRUE
ddjcmapndikjnjhkkfd	TRUE
dohkmhednbkonbjpgdc	TRUE
dohnfbpdbdelkfkehdc	TRUE
ejoijflnlphgldnimjc	TRUE
ekacffpfaddfcldofbb	TRUE
ffakdpcmgndldldkbab	TRUE
ffamgmgoipifgggmiih	TRUE
fojbgfdckddiifnnooj	TRUE
fojkpebmifbjbhcgabo	TRUE
gioimdaenigpekoknpi	TRUE
gipeddneeildhfanopb	TRUE
hdggmpdaefjcpfjcngc	TRUE
hdhgkomlpddhichdjam	TRUE
hnmmmidanglipdagebb	TRUE
hnnohlallpfkhgnjmho	TRUE
igpdnagdklpomldfggh	TRUE
igpkjnihpbfnonnkklc	TRUE
jbhlblglnifeckbjfdk	TRUE
jbignmceaocmlkbgide	TRUE
jlekookjkiiniijjcbb	TRUE
jlfcmejjhpkkpbcaagb	TRUE
kgpacehljgfbldchaab	TRUE
kgpkcckhgommdcbghnn	TRUE
lbdbamnkbiobfiplpoj	TRUE
lbdppejbpbfkejilaoc	TRUE
llkbbeednkldomkndao	TRUE
llkoleialmgodddpgkl	TRUE
mfcnkjjkloaibgflhjg	TRUE
mfeinjnedhieeekenjf	TRUE
moemojdmhklildokang	TRUE
moeoaemdmifohaknkbb	TRUE
nidilaaghfljfhmlmbb	TRUE
nidjchpfmpllhaldlic	TRUE
obpeggfelfmenldblpl	TRUE
obpkjkmmbhedpjlohfc	TRUE
ollkfghdlehpihapgbk	TRUE
ollojapjbfbpffmmfnh	TRUE
pfopljgpjiapfcnfabb	TRUE
pgabjkgljgmmfhieojh	TRUE
aaaahceicbicffnnlgl	FALSE
aaalpcphmphejddohbo	FALSE
aknfpmkaafhecgbmohl	FALSE
aladadmamieajkklaej	FALSE
bghniechglfipndcnaa	FALSE
bgilpjgnhdmaoojgkpa	FALSE
capmofniappoggcoipb	FALSE
cbajfcgljonagmkgnhc	FALSE
ckgibighekcfklkolaa	FALSE
ckgnndjamdhbkpofela	FALSE
ddhbngjpedkemapamfn	FALSE
ddhhbgmaafpllkfiape	FALSE
doihdajcjegkdoabmah	FALSE
dojpbloikifgfcppfaa	FALSE
ejgffpfaddfcldofkja	FALSE
ejhghghfmgnmaohjjac	FALSE
femoopflpneledljeaa	FALSE
feoiojnljnhpdmbpdaa	FALSE
fokhdeamllkphpgbnea	FALSE
fokjhfibeeaaakdmegk	FALSE
gihaplagfmcipcilfnd	FALSE
gihchakmoljmlpdpdka	FALSE
hdhebeeppkmgflfkdaa	FALSE
hdkhgpgllgmhpahbeja	FALSE
hnildlmafjlolaholoa	FALSE
hnionpabikfgcgddika	FALSE
ihhkjojkkljhiinoiaa	FALSE
ihjpklmgcllohmgnmaa	FALSE
jbgaoacfjlomidfaind	FALSE
jbgookdhddnofohekaa	FALSE
jllfhmmkmfkhhfkccaa	FALSE
jlmmljmicbefimappla	FALSE
kgakhghhlhdblolenpa	FALSE
kgcohgccekjghjlaena	FALSE
laoomofbniapddoeona	FALSE
lbakaigjkgdglffhpkh	FALSE
llbppjjmniaeflkhkda	FALSE
llcfkjjpiljbdpigjaa	FALSE
mehcnjeochblemddala	FALSE
mejhajgeiajphjeaali	FALSE
mohebhffhfidjjffcaa	FALSE
mohhmjhemdccidfhnaa	FALSE
ngpmchbjgfjjdgoafca	FALSE
nhaeiddhbpaiimjpmlo	FALSE
oblkokhchgkiciopiaa	FALSE
oblmfknpngiolaclcpa	FALSE
okmcgainccbgmnnakif	FALSE
okpjecoibclilccedaa	FALSE
pfdpmbeojemoplemgaa	FALSE
pfechankkhikkjlchfa	FALSE
