aaajnikfmc	TRUE
aabkcmdpcd	TRUE
akpoofheak	TRUE
akpplefecf	TRUE
bdpnephbke	TRUE
beacbacnid	TRUE
bngmggdodb	TRUE
bnijmibplm	TRUE
chpnnkmnlh	TRUE
ciapoidlbc	TRUE
ddhfpikgpc	TRUE
ddijllcaep	TRUE
dndfdbgfgl	TRUE
dndfheahha	TRUE
ehhpgpolpj	TRUE
ehianjknee	TRUE
fbcphglklh	TRUE
fbdfbbjkcf	TRUE
fmmjdacekf	TRUE
fnalbliicd	TRUE
gihplddcoi	TRUE
gijhpanijl	TRUE
hdgjhfmalg	TRUE
hdiaoomgif	TRUE
hmlfimhjgi	TRUE
hmlhopmkea	TRUE
igbieahpel	TRUE
igcbdadpab	TRUE
jbgpooekmk	TRUE
jbhcggapgk	TRUE
jkjicpjdab	TRUE
jkjljecnje	TRUE
kfaefennce	TRUE
kfcdimbfab	TRUE
kolmliedpj	TRUE
komlalaenf	TRUE
ljehpjphjm	TRUE
ljepdokmob	TRUE
mckennckge	TRUE
mcliabpefd	TRUE
mncfniladb	TRUE
mncpmijnkj	TRUE
ngdhobfocc	TRUE
ngfpdmijmi	TRUE
oalofbdlcd	TRUE
oambnpbacd	TRUE
olfoaaikad	TRUE
olgbopgffa	TRUE
peojmgdaha	TRUE
pfchcmgpha	TRUE
aaajnikflb	FALSE
aabbkcnece	FALSE
akoniaabbm	FALSE
akpfdakdgb	FALSE
becajdomgi	FALSE
beccfmonab	FALSE
bnkmgbdmcd	FALSE
bnnaminmjb	FALSE
chodfkdhme	FALSE
chohejimbd	FALSE
ddfonpkjcd	FALSE
ddgmkjmbab	FALSE
dncjolkdgk	FALSE
dnfjdbobcd	FALSE
ehhnjgfccd	FALSE
ehhpdgleab	FALSE
fchddpjoih	FALSE
fchjcfhkpd	FALSE
fnchhialgd	FALSE
fndcnfnffd	FALSE
ghohcndioo	FALSE
ghojmjnpab	FALSE
hdeiopfhcd	FALSE
hdejpncomd	FALSE
hmlfpfiabl	FALSE
hmmnnejcbd	FALSE
iggnibocgd	FALSE
ighmndfnab	FALSE
jbgbjkhnab	FALSE
jbgijpfbab	FALSE
jklfehpdab	FALSE
jklhpbedab	FALSE
kelhojopcd	FALSE
kelncgklld	FALSE
koleikfchd	FALSE
kommeplmcd	FALSE
ljjjnbpeab	FALSE
ljkbpannlb	FALSE
mcoomdolin	FALSE
mcpifnipgd	FALSE
mmfdfbeoab	FALSE
mmjmnajdlb	FALSE
ngjfihpdab	FALSE
ngjjdmgccd	FALSE
oajlcfnhgb	FALSE
oajpgmileb	FALSE
okkciakjob	FALSE
okkmedmpab	FALSE
pekdkplncd	FALSE
pelailbdfg	FALSE
aaajnikflcm	TRUE
aabcmdpcdfp	TRUE
aknplolajlk	TRUE
akpclnafoho	TRUE
bendjhmknla	TRUE
benncllmaek	TRUE
bnmjaleoaop	TRUE
bnmmbmejlco	TRUE
cikfjbdigab	TRUE
cildfkhidab	TRUE
ddckinngbnf	TRUE
ddeoaoegpdh	TRUE
dmipkajefii	TRUE
dmkmpcefano	TRUE
ehgdgojnmca	TRUE
ehhbpadelea	TRUE
fbpjacekodb	TRUE
fcakjamlobd	TRUE
fmjikendffj	TRUE
fmkadocbjjd	TRUE
gifjmcdhgab	TRUE
gifncfaeklm	TRUE
hdckefcdgab	TRUE
hdedhomdcgn	TRUE
hmieapndnde	TRUE
hminlahjcin	TRUE
iggckbegjbn	TRUE
ighkiebifph	TRUE
jbikinpfeom	TRUE
jbimnhfndgd	TRUE
jkjhklnmofi	TRUE
jkjjoacljgf	TRUE
kejmhebfmck	TRUE
kekogkgkflh	TRUE
kopbinpoian	TRUE
kopldbjpnnh	TRUE
ljdnpodfhal	TRUE
ljficdpgfab	TRUE
mddnikfcmgo	TRUE
mdgciklhhla	TRUE
mmcijemlmek	TRUE
mmdkalcbnjd	TRUE
nglpkpdfcgb	TRUE
ngmljlifjgi	TRUE
oaknodlodha	TRUE
oalfjcfdcib	TRUE
okpjlnhckch	TRUE
olalkmmllde	TRUE
pffkddainoo	TRUE
pfhgidmeoop	TRUE
aaalkihnkkb	FALSE
aabijfmopgi	FALSE
akofohnepob	FALSE
akpdllncdfj	FALSE
bggnehcgajd	FALSE
bgiaapephgb	FALSE
cahmedciiha	FALSE
caijnbilcoe	FALSE
clhegejbfbd	FALSE
clhmpohnlmd	FALSE
dgfpekpbnab	FALSE
dgfpodanbek	FALSE
ebacdcofppf	FALSE
ebadcfkmmod	FALSE
ekojkhbgaib	FALSE
ekplekknjab	FALSE
fgbjngmhhab	FALSE
fgcdkmpbkal	FALSE
fpdjnfpcjdk	FALSE
fpfannngphb	FALSE
gjacdljjjnc	FALSE
gjaldadabeg	FALSE
hdbkeemmlab	FALSE
hdccmbkcjjd	FALSE
hmleoingicd	FALSE
hmlhnladjeb	FALSE
igoopdgfjcd	FALSE
ihanffhleob	FALSE
jannhlahbci	FALSE
jaongjhemcb	FALSE
jkdehjjlpab	FALSE
jkdihajfinb	FALSE
kdldjbgodcd	FALSE
kdliebihced	FALSE
koagfboejjm	FALSE
koaomghhgeb	FALSE
ljoimebkhcd	FALSE
ljpefalipfb	FALSE
mejjilhhkcd	FALSE
mellpjecipd	FALSE
mnkahccgocb	FALSE
mnkcdklfidp	FALSE
nhcegmmbajb	FALSE
nhcgbmmjafb	FALSE
oapmdcdmjkh	FALSE
obagcfhogfb	FALSE
omcjildinpn	FALSE
omdlpmhceod	FALSE
pghfcbjdbcn	FALSE
pghpokhpadb	FALSE
aaalkihnkkjk	TRUE
aabfmopgihcd	TRUE
akpljibkhgcd	TRUE
akplojilnkag	TRUE
bggepkknpkcj	TRUE
bgghfnkiljcl	TRUE
cafjapgeffbd	TRUE
cagpiifficln	TRUE
ckpbmipimnkb	TRUE
claajlddlcdb	TRUE
dgbhhbdlelnd	TRUE
dgbkndloclff	TRUE
ebfmdekeoooo	TRUE
ebgbeojdbogo	TRUE
elbomjkdbdgl	TRUE
elcfmpnonboi	TRUE
ffmefbnfkggp	TRUE
ffmhednnfmde	TRUE
fpbplkbnkhpf	TRUE
fpccjjnncafm	TRUE
gjaodocckmop	TRUE
gjbehoogfemg	TRUE
hchjbdnpibab	TRUE
hcimgbjpjiib	TRUE
hljheiabgocd	TRUE
hljjnbncieko	TRUE
igkkkhnpabcd	TRUE
iglgcdlgclab	TRUE
jamgonolakeh	TRUE
jamlaiacebgd	TRUE
jkfojmdlolhe	TRUE
jkgcchgagjhl	TRUE
kebpfikgdmpg	TRUE
keckilifbapi	TRUE
knnfknhmhapg	TRUE
knoegandgbcd	TRUE
lkihkecbpaco	TRUE
lkijofkneoii	TRUE
mejcibbkkepk	TRUE
mejicmanneek	TRUE
mnjbclbkfcgl	TRUE
mnjbegmbgadc	TRUE
nhgbfdiokphb	TRUE
nhhmpjplehcb	TRUE
oalbjdgonmcd	TRUE
oalomligohoa	TRUE
omnpcmkafhmh	TRUE
ompmjckcbgnc	TRUE
pgblcmmmeblh	TRUE
pgclgnbhello	TRUE
aaalkihnkkib	FALSE
aabjfmopgihc	FALSE
akpbnembmaik	FALSE
akpkioeekbcb	FALSE
bgecnhkjidkm	FALSE
bgfmgggfmbcd	FALSE
cakhdkhfinlg	FALSE
cakkkjinbgka	FALSE
ckjehghmjlkd	FALSE
ckjhgpebcfad	FALSE
dfokfdonjlab	FALSE
dfplgebihmab	FALSE
ebkfidocbnid	FALSE
ebkhaaohepgb	FALSE
elegalhppapb	FALSE
elehoifokiab	FALSE
ffjmkegelhcd	FALSE
fflbfkggpecd	FALSE
fpbijhknhbcd	FALSE
fpbjaopiokmb	FALSE
giobcdhlplmh	FALSE
giobphcflfkd	FALSE
hcejgpcliocd	FALSE
hcgbngacbpaj	FALSE
hmiiggibofcd	FALSE
hmjbbfaldacd	FALSE
igjanidefnnb	FALSE
igkgnakonlcb	FALSE
jahncljnnmib	FALSE
jaijiafpgfjb	FALSE
jiobaphpopjb	FALSE
jioeonkmilcd	FALSE
kecabfaggfeo	FALSE
kechdfneoakf	FALSE
knnfopojgdab	FALSE
knpjlncpkbkd	FALSE
ljpolfbdhpcd	FALSE
lkapbgcfimhn	FALSE
meccligbhpdi	FALSE
medllhannbem	FALSE
mnglfdfdbaeb	FALSE
mnhjnnbjghcd	FALSE
nhakbkfcobhc	FALSE
nhcmedieenpa	FALSE
obfedajnklhb	FALSE
obfllmlnipab	FALSE
ommbchacmonb	FALSE
ommgladogjfb	FALSE
pgiiohnjcjed	FALSE
pginnfhnhgab	FALSE
aabfakgoajicd	TRUE
aachpkfkimmfl	TRUE
aliideecnegpg	TRUE
alippgkidoajl	TRUE
bdojldmpklbah	TRUE
bdonndndonnmb	TRUE
bojfmnngklipj	TRUE
boklkfnecohml	TRUE
cjffgnalademb	TRUE
cjggjndpepoab	TRUE
ddifobdjpoiei	TRUE
ddilinncldbab	TRUE
dnpfokmbhfmkm	TRUE
doblnkhlaainj	TRUE
eingdbgcffogg	TRUE
einibblpodccc	TRUE
fdlhkkneogdie	TRUE
fdlpeiddapnie	TRUE
fofafaohilgin	TRUE
fogabnilahfcd	TRUE
gjddfomkdhnja	TRUE
gjeglnoobbpeo	TRUE
hcogmedjlgbab	TRUE
hcpfgacngiepm	TRUE
hnakhhcejmoei	TRUE
hnaokolfheelg	TRUE
ihbgkpmpeppfh	TRUE
ihdfcjpmknppj	TRUE
jbgekdjgadgoe	TRUE
jbgohfoknpncj	TRUE
jkfdppedkajjg	TRUE
jkfeekafbokcd	TRUE
keojmchajhlol	TRUE
keonlkfepdmnn	TRUE
kokplhmclnjfp	TRUE
kolccocdjhcab	TRUE
lihkhfeohgfhc	TRUE
lihomjhhlpfbj	TRUE
mbjhmgfldddfb	TRUE
mbkdpcioihkof	TRUE
mlnanljfnjmpo	TRUE
mlnhgnekchmch	TRUE
ngehgohbkaajn	TRUE
ngfijmkppgmok	TRUE
oameddmndefep	TRUE
oamefgchdplnb	TRUE
okgilmnalenji	TRUE
okglfgoclhbag	TRUE
pehnkjmgjipjp	TRUE
peiadnnoaahfh	TRUE
aabfakgoajihp	FALSE
aackfkimmfjpd	FALSE
aliofnnlpdbhi	FALSE
aljnkdaceccld	FALSE
bekmbjbfgabkk	FALSE
belbakaicppcd	FALSE
boiobjgcmncjd	FALSE
bojembgpdpecd	FALSE
cjiieffeejagd	FALSE
cjjgapokbaoli	FALSE
ddembmandhdbi	FALSE
ddfiaffkpcgnb	FALSE
dnkpgmbcpaold	FALSE
dnoofdolbjbcd	FALSE
ejeabeggcnlbg	FALSE
ejepdigkehhcd	FALSE
fdimhjegmejab	FALSE
fdinmpndoaglb	FALSE
foipighmabnil	FALSE
foiplahfjgkjb	FALSE
gjfofaflplbhi	FALSE
gjgjkeaigpgeb	FALSE
hcoinbekllied	FALSE
hcolibbdcolfj	FALSE
hnbndodcildlc	FALSE
hncgmffggneid	FALSE
ihealhpkdgbab	FALSE
ihepebgogmeab	FALSE
jbjlloiogggcd	FALSE
jbkadkgcjechd	FALSE
jldakbmfhdhgf	FALSE
jldbnoacpaijd	FALSE
kebiodpojljcd	FALSE
kebplihiioanb	FALSE
kogppgejkmmcd	FALSE
kohcnbgmojjdc	FALSE
libjmnnoalkdb	FALSE
liffkkblhlgcd	FALSE
mbfamhadhkacb	FALSE
mbggkfdcjeked	FALSE
mlpfccdlmngjc	FALSE
mlpkahdnlcmeb	FALSE
ngeimcocjlpnd	FALSE
ngennlonkcmad	FALSE
oakmbaledgnif	FALSE
oambnhimbkpbn	FALSE
ojmiokolgfajb	FALSE
ojngmjklnnpcd	FALSE
pegnbnpacgncb	FALSE
pegomggbfmgcd	FALSE
aabhdllmainecd	TRUE
aabndlacpeoigd	TRUE
ajpagbcoiddili	TRUE
ajppogmbbpkcnd	TRUE
befahaelgeiikm	TRUE
befopaejochplc	TRUE
bodgbjchpifcca	TRUE
bogbanbehcjbcd	TRUE
chmaohjnibgafd	TRUE
chmecmeogkkmnh	TRUE
dbnkegoeideceo	TRUE
dboblkkpjepehe	TRUE
dofmildbfknoma	TRUE
dogjimflnkgedi	TRUE
ejgiiebjplcich	TRUE
ejgjbgmhjpkbcg	TRUE
fddikdlgenaahh	TRUE
fddjeabjamincd	TRUE
fnfijfeciohhmi	TRUE
fngdhcfnikdkab	TRUE
ghfakcalicplom	TRUE
ghflfabejjddcd	TRUE
hbdoonccigdmab	TRUE
hbgjeefnpkpjjn	TRUE
hlnbcnbikgcpom	TRUE
hlnkkhdcjlbnha	TRUE
iehkenimgbalgm	TRUE
iehmahbpnpdncd	TRUE
ioncjpecniihbf	TRUE
ioolnkhfpcmjem	TRUE
jijbcchobokmjc	TRUE
jijjpgaddeecfg	TRUE
kdknpgdgkjokfb	TRUE
kdndpldbckjdab	TRUE
konkpollclmech	TRUE
konmmhhacbpkfd	TRUE
ljampccdhklcmb	TRUE
ljbohjbmpihpkh	TRUE
megpihdhgecnek	TRUE
meidglhleckkmg	TRUE
mnekgdmkolpipm	TRUE
mnfgfjapdgmipa	TRUE
nhbdmklnmmgkdo	TRUE
nhcpiagaflideb	TRUE
odhjahhoagbfcd	TRUE
odjoakkcjbpemd	TRUE
oocanfohaebocd	TRUE
oocojjpojbjiip	TRUE
pgndcacldhbgbm	TRUE
pgnmhoihieikdn	TRUE
aabhdllmainedl	FALSE
aabnacfpjhgeih	FALSE
ajoocchgfcpnda	FALSE
ajppgmikaklppb	FALSE
bdkhgkcdlngcce	FALSE
bdmmekjjhkidcd	FALSE
boalmgjjcnopnb	FALSE
bobckcobjhpgmd	FALSE
ciebabbgnlahbi	FALSE
cieenjpokhajnd	FALSE
dblmjjcphbdbbk	FALSE
dblnhgmoplhnab	FALSE
docfbffgignjcd	FALSE
dockgaillmbapn	FALSE
eicicdflkdglga	FALSE
eidimbhcnbodge	FALSE
fcpfcpalhcpndd	FALSE
fcphoimmlbhmld	FALSE
fnehkamdpgmhbg	FALSE
fngjgglikipahb	FALSE
ghcjbekjokbgld	FALSE
ghcllmnliknepd	FALSE
hbebebdobfbicd	FALSE
hbglphnhmhmgab	FALSE
hmbjfbjiolankb	FALSE
hmbkheaadpdncd	FALSE
ifchdjpmblbmji	FALSE
ifdghmokcfhlfd	FALSE
iohfhiakakaagb	FALSE
iohhofimdjdjcd	FALSE
jifpdibbfffoab	FALSE
jikijbompaeckb	FALSE
kdjoffndpeioab	FALSE
kdkkenmmhillab	FALSE
kohlapollclmeb	FALSE
kohpgmhhacblgm	FALSE
ljbiidpfecfjhd	FALSE
ljbjamcnaafpkb	FALSE
mecaofgjphjfcb	FALSE
medbhfflehhgab	FALSE
mmpelkigcjpdhm	FALSE
mnaidhkdmgblcg	FALSE
nhkapokcdkdmhl	FALSE
nhlpnkompcbhkd	FALSE
ocnndhioidokdn	FALSE
ocnpgapkbkgamh	FALSE
ooahgekcigbikc	FALSE
oobnbidenopkcd	FALSE
pgpajngmmbkkhg	FALSE
pgpgpdacnpbilp	FALSE
aaageblalceljid	TRUE
aaanijacaabmlhd	TRUE
ajgcpccfnfmcakg	TRUE
ajgnoampnbdaicd	TRUE
bdplndaconogogi	TRUE
bebinemkdnlbhca	TRUE
bocbmlkmdgbaoab	TRUE
bocccbbbcihkjep	TRUE
cjhlpogdobpjeab	TRUE
cjhoccjbmhkdeab	TRUE
ddffjelpoeoedmn	TRUE
ddfhpajlgiekeaf	TRUE
dmlahjehhnmdhjh	TRUE
dmlaoolegdndlha	TRUE
ehfibeclhdmmmab	TRUE
ehflbophlfjkjnd	TRUE
faoiafioeinkfna	TRUE
fbaffabcmgcnnkd	TRUE
fmjfpldnpopfpeo	TRUE
fmjiponejlcdakb	TRUE
ghcjfimmjakdpib	TRUE
gheameefblbhdcd	TRUE
hbcaegnnohalipm	TRUE
hbcimcmbfdlgjab	TRUE
hljoieookghdfni	TRUE
hlnncenblndfkab	TRUE
igfbjnjodggalif	TRUE
igfblobkncbfiap	TRUE
jalmjdalmnnjikh	TRUE
jammmhfkkmkigoc	TRUE
jkjgajfgffpgbcd	TRUE
jklnkdicpbdjoab	TRUE
kdogafcidkjgclb	TRUE
kdohbdnjaaelndc	TRUE
koiamlchjopceap	TRUE
kojjaoamijdjode	TRUE
ljffgipeemmkkjf	TRUE
ljgmibmccpgmhag	TRUE
mdbeepkcgbnpgbn	TRUE
mdbejfeliaclmeh	TRUE
mnmmdlghppjhehf	TRUE
mnogdbaaeagfelf	TRUE
nhkkpigcneldnab	TRUE
nhkphdhnogkohjh	TRUE
ocdajmohccklnlb	TRUE
ocdgdpmpgnabafk	TRUE
omccnebnpdlfbab	TRUE
omcpnlhpaggaeje	TRUE
pfojfhmahebgpcd	TRUE
pfopndaehhgdapg	TRUE
aabahfclhenncfe	FALSE
aackmfmbmjnebib	FALSE
akaepmclphdagdm	FALSE
akbianneedaoade	FALSE
bgebbdpinmmmbcd	FALSE
bghbmjgfgfllbcd	FALSE
canejphfhhobpie	FALSE
capjngafbicfbaa	FALSE
cmapndjplnfgjck	FALSE
cmbkligefiaoegd	FALSE
dhjphfhdlgabfje	FALSE
dhkpfllekiiheab	FALSE
ebjkcpbohkhpkhd	FALSE
ebjnkaghmkhfanb	FALSE
eknhdbfkbialgob	FALSE
ekofaleccodghnp	FALSE
feffnhiagpihleb	FALSE
fegbbdhkidakbpi	FALSE
fpgdnbdbmemffab	FALSE
fphgkifihhechjd	FALSE
gipgkgmobljcghd	FALSE
gjamkgfaagmodfb	FALSE
hdgpihbgoocinod	FALSE
hdhpamgigpfojnb	FALSE
hnlogabphfolobj	FALSE
hnmlgfeoopkdkab	FALSE
ihjmldhejcdcink	FALSE
ihllklkhklaijjb	FALSE
jbigmkedhgmgbcd	FALSE
jbklkonnplaeaob	FALSE
jlcfofndkogebac	FALSE
jldcmojhnmipmgd	FALSE
kfmadjjbnjenhkf	FALSE
kfmcfpnnojclpgd	FALSE
koncbgjakmbpcag	FALSE
konchjmddgdlbdn	FALSE
lhjiikaedncficb	FALSE
lhjjklpnjofcbcd	FALSE
mchgjhlpdaldgam	FALSE
mchmgkagloifcjb	FALSE
mmemljcnoejikod	FALSE
mmfjigmkpppcjpd	FALSE
ngmicfkheheogld	FALSE
ngmngdoaibkpeaa	FALSE
oambjbhnnaaklnm	FALSE
oamdmcbffbklkpa	FALSE
okofloldmkihjcd	FALSE
okopdjikahmikcb	FALSE
pfimjnbjahebkkd	FALSE
pfkkljlcnndfjjd	FALSE
aabahfckgdpmmced	TRUE
aackmfmblimdbhpb	TRUE
akbmpfihgegiiacd	TRUE
akbnfcilmdgbbpna	TRUE
bgekgmpdgnjohpmc	TRUE
bgemjfkncknackoi	TRUE
cahmmbifbmkbddkp	TRUE
cajjbdcalajakdco	TRUE
clhakjeldpokpaab	TRUE
cliooblemakndaib	TRUE
dhddejkobhiiefap	TRUE
dhdfncnjhfanbdcg	TRUE
ebghmbflldfehedl	TRUE
ebgoojedjfebjagn	TRUE
eknabkmmabekilcd	TRUE
ekpmpjgnafboceod	TRUE
ffgfhhlilgnlacdb	TRUE
ffgmlnioibekacfe	TRUE
fphajjemcmojikoe	TRUE
fpkophhfmlijnhha	TRUE
gilhecdgdjmakneb	TRUE
gilmnghgojbcklge	TRUE
hcpinjohckifodab	TRUE
hdbcifcgedlgefab	TRUE
hndkccjheangnhee	TRUE
hndocdgfgdgkbpab	TRUE
ihpdkaogjmjighig	TRUE
iiachpdghgmlppab	TRUE
jcaneiepaalefehe	TRUE
jcdmkiafakdffllb	TRUE
jmbkaakfpdpogehk	TRUE
jmbklgcdbicnmpab	TRUE
kfhapnjombjhobcd	TRUE
kfiaefecjkflacgg	TRUE
kondnjebpfojifen	TRUE
koocnognkggblogj	TRUE
lieocenmfbpekffk	TRUE
liffnfdenkhlegfl	TRUE
mbodkmhandeckfbd	TRUE
mcabmiejdhcekjao	TRUE
mmooajcabbkgpmbd	TRUE
mmpalfjmemlfblcd	TRUE
nhiobopgfdbaajdk	TRUE
nhkaimaochjdnfcb	TRUE
oanacmhiaimklchj	TRUE
oanchadbnijjmocc	TRUE
olelnjdpmgncogfp	TRUE
olfehfkdgjbdnkng	TRUE
pgeiehjjpcdjimab	TRUE
pggddpojmphfajac	TRUE
aaccicfdhmadlami	FALSE
aadlogdjoolbfeda	FALSE
albpbigfkmoonhjj	FALSE
alcagjkkopkpbbbn	FALSE
bfdjmamhjonhcipd	FALSE
bfelhhiljocdncgo	FALSE
booahanebhajcocm	FALSE
boophpeaadddonib	FALSE
cifieonbdobbdcem	FALSE
cihnmmnlbgeelgnd	FALSE
ddbilhlgbfnfiicd	FALSE
ddcicipbahegpolb	FALSE
dlcliidmllhahlol	FALSE
dlcobkphgaofcapd	FALSE
efmjbnmlnjmmhmab	FALSE
efmomohamhgldaob	FALSE
fahfibkbdolnnjam	FALSE
fahgakficianmimb	FALSE
fkmnkoeheghccifd	FALSE
fknodnijfjedhnab	FALSE
geopafhocjndalmh	FALSE
gepgcbhbikeblond	FALSE
gogbjjgjnagdjacd	FALSE
gogdmcdghfphicmn	FALSE
hifofnjboefnbbab	FALSE
higkfjnfojlgpeab	FALSE
idbecjkimklaampb	FALSE
idbfmociajabickl	FALSE
imbfdhokficjccad	FALSE
imbkhmjbkbajbngd	FALSE
jgkeihdojholaodb	FALSE
jgkiflgelhckjjpd	FALSE
kbjioaeofkcnbola	FALSE
kbkpaplehiffjidb	FALSE
kmmbolhkllnjinab	FALSE
kmmojljkmpciffpd	FALSE
liahnmhkomannfcb	FALSE
liciajjbgbakoana	FALSE
mcbldbpmcjfehcob	FALSE
mcbpnbjlkmdbdglg	FALSE
mmgphmmajcfckffb	FALSE
mmibnmmcmdfcggce	FALSE
nhebjiinahanghdb	FALSE
nheclalahnhfkpcd	FALSE
obnenkdolgmibeab	FALSE
obnhbbemlolcefid	FALSE
olmempfnknohejcd	FALSE
olncmkipdegobfpk	FALSE
pfmeojaogkpdibap	FALSE
pfmmlpdihdfndmab	FALSE
aaangklpkcmapligo	TRUE
aabfgnneklahmmecd	TRUE
akdfgpfmofdbmedcd	TRUE
akdpmpolapdlpnimj	TRUE
bdfplfepceofhpmhi	TRUE
bdgmhgillhdjaplhp	TRUE
bodnclbcjfklohcgg	TRUE
boekdflclkefmgjfn	TRUE
cigfdghnbmhojbnab	TRUE
ciikopffpadplabgd	TRUE
dbgcijhdohlppebab	TRUE
dbgeljjbbaeigneaj	TRUE
dmeogpejckcikkgmk	TRUE
dmfmcipgekpbaieha	TRUE
ehgogbaopdljgmhpd	TRUE
ehhgklkbdhcnlkjai	TRUE
fbmlfegdibnbnljef	TRUE
fbnplmcehljcammaf	TRUE
fladlonfckbmpebbd	TRUE
flaeoglndhklfiaig	TRUE
gfncmccehdikgmiab	TRUE
gfodghmejoaeoalcl	TRUE
hacjagpofnlgbbigd	TRUE
hadnnmmenplljjema	TRUE
hkgfahfnhpkfikdkm	TRUE
hkggfgeggolkbpgln	TRUE
idfmndmdkdfbphaog	TRUE
idgaedmgmnjgppfnc	TRUE
incjkamnpocoahkoo	TRUE
indkgnkfifkkdfojl	TRUE
jhabkelihhhedggcd	TRUE
jheoalkipaplkmeme	TRUE
kbobphemfepmonljp	TRUE
kbpcmcacdddkedlab	TRUE
klklkdhmihjkbhcec	TRUE
kllfemaonjonjhjog	TRUE
lendloideofaimoel	TRUE
lenoofjdgmboeempm	TRUE
lokfhafgfcglldngb	TRUE
lokgfphcfcdonoagb	TRUE
mjhicbkbchohagphg	TRUE
mjihfmcafckakjijl	TRUE
ndnhonlfeligknnnm	TRUE
ndobblkonhanpnojf	TRUE
nojbkglkackhgopkf	TRUE
nojjpoabclljamdol	TRUE
oinmiohpmjmalgoga	TRUE
oiocephicpkikjaoh	TRUE
pehonamkjcmdmdhab	TRUE
peibkbghocdfopadb	TRUE
aaangklpkcmapligb	FALSE
aabfgnneklahmmebo	FALSE
akbgeafakpaohlnmd	FALSE
akdbgmdmieifeghap	FALSE
bdcnkclghgjbockbd	FALSE
bddhdfdnokdgelecd	FALSE
bnobhdffgnicekjkd	FALSE
bnokokngbpbanjbnj	FALSE
chhcjhjbeijncdhok	FALSE
chhgmhijaddlheljg	FALSE
dbcmdlpnalajmaaep	FALSE
dbcnkdfdnkfkpfilg	FALSE
dmldpchagfjghblnm	FALSE
dmleplblmajcabppf	FALSE
egndlecmnnkepelab	FALSE
egocgflniapidpocm	FALSE
fbfjeadgnameinnfb	FALSE
fbgjgglkajmbkjfme	FALSE
flfjbfjgaefeohfjb	FALSE
flfpeglbehnpgfocd	FALSE
ggefbhppneipjkdcd	FALSE
ggefkbnnlmibbdpcd	FALSE
hadkhghddfbnecclg	FALSE
haegfnkijpnnmmofb	FALSE
hkbpjfloaplikennb	FALSE
hkciijeidkcnnhnbo	FALSE
iclbekemilbhcdglb	FALSE
icmcmfbnehgeeofhd	FALSE
inmdanlmoicoabome	FALSE
inocglbjdngpljlaa	FALSE
jhbmigohjbekkkncd	FALSE
jhcfbldhhfpkmmmlb	FALSE
kbklhajljdffpikob	FALSE
kblmiibnepmclipad	FALSE
kllalcbffolfobnjn	FALSE
kllhfmagnbknlkddk	FALSE
lekogohimialolfbo	FALSE
leljpnlbdkmbggapb	FALSE
lonahldgmgdookigb	FALSE
lpabhdmhplhdhnmdb	FALSE
mjjhmioggbjligeab	FALSE
mjkelhladcholobio	FALSE
nebeikbcmjndakfpf	FALSE
nebkfeodllhpcpjjd	FALSE
noicdkhnihibbpjik	FALSE
noieaalfaehdhakdb	FALSE
oilgdokhkfcchpakb	FALSE
oilkcalfccbimfpmo	FALSE
pdeeimlanlfoihgmb	FALSE
pdfhlomdiaihkomeb	FALSE
aaambnhihphcncfknd	TRUE
aaangifnmjedpipkoo	TRUE
akapbcndljmpaoclab	TRUE
akbbnhfelfpmmekpcd	TRUE
bejikjiodaggpmdoac	TRUE
bejoeakpkheopjbfcd	TRUE
boddnoibbljaimpfhg	TRUE
bodhifdbeaokcgjdcb	TRUE
cihfgdijepoijggpab	TRUE
ciikpgpjklmghjfgja	TRUE
dddcommdpfmpkkheab	TRUE
ddfaebgncjkndpdcma	TRUE
dpddbmpankpmpkcpna	TRUE
dpeicdkdibfhgkhcab	TRUE
ejeojbgfkcncfbhboj	TRUE
ejfhfnlihiioegiadn	TRUE
febclechcilmidgkab	TRUE
febhmoenajdppnkmpk	TRUE
fncepncbinpjpdadjb	TRUE
fndefhodlmgihanhip	TRUE
ghbonieonnmalnkdmm	TRUE
ghbpajieeackmcncoh	TRUE
hbolkckmhpjfldfbab	TRUE
hcbchplgjjdgolelab	TRUE
hlelelofhoeihnkggd	TRUE
hlfaapaeekclckfmkk	TRUE
ifcmhpkmaejabfhnld	TRUE
ifdiifnhpcbndeplab	TRUE
iplhknjpcmgndeopab	TRUE
ipmcelpbiegfololcg	TRUE
jjndnchbmhfamoeine	TRUE
jjnffpddkpdagjpdak	TRUE
kefjolmmbeglacmham	TRUE
kefnbgggmbdeoodhjg	TRUE
kobkhnigdgmaambhcd	TRUE
koddobagbhhmooficd	TRUE
lhehhhhpghnpdadnhn	TRUE
lhghgladnaccbfkkjd	TRUE
mbdloiabmombncepjd	TRUE
mbedlagnjfejjfjmfm	TRUE
mlmijmkdlbpnoejaec	TRUE
mlmmjpgejdjghmaeha	TRUE
nfpbifhmpmohkgnaoe	TRUE
nfpmfaheclopomcdib	TRUE
obadmcgljbdngkhnao	TRUE
obbdanhagkkjdppbcd	TRUE
olkfkdomojkhepcobk	TRUE
olkjkknpjocilggdab	TRUE
pfoilmmbfkpklfaaio	TRUE
pfplfbelllcmmbggki	TRUE
aaagdnbkibklihphfj	FALSE
aabmlbfkcjinanhlhh	FALSE
ajoimflmeogjdlkngb	FALSE
ajojkdgjoloolaijgb	FALSE
bdbfmgoghocebjfmod	FALSE
bdbgackljafbbhmllh	FALSE
bnmadcndmkganmgamj	FALSE
bnmncmjbodjknmdgil	FALSE
cgoimjgogehbcckkgd	FALSE
cgphddafldlgenaioj	FALSE
daljempjchemegnnfd	FALSE
damlilpakfiofepjfb	FALSE
dlclmanpjfljcocjgb	FALSE
dlcppmhmocfahgflnd	FALSE
eejfedjnollinbkjab	FALSE
eejgehfnbclhdanljk	FALSE
fachngdlmidmplnogp	FALSE
fageeklmhddjekfcfd	FALSE
fjiklbncepkajpihpd	FALSE
fjlfnlmcekflkaeced	FALSE
gddjeekbfobpiefmcd	FALSE
gdfcpmbnjddpdponfp	FALSE
gmilidefokfnfgladb	FALSE
gmipgkdkibapcbablf	FALSE
hgnpnboakhgfgeomeb	FALSE
hgobhdadclmfppiemb	FALSE
ibglkachnaeoelkipb	FALSE
ibhajoccppbniopcfc	FALSE
inigbaaaeaeljaijcd	FALSE
inikhkjhdjenocigdh	FALSE
jiieafjdiejbeajhag	FALSE
jikbhgoomoaalmfccd	FALSE
kconofppdajdnigejj	FALSE
kcpohdoghogfclbdgl	FALSE
kmjfkmadeimfidmflb	FALSE
kmkdibleolclncodgl	FALSE
lgpnjcemfpggegppgd	FALSE
lhalfejgclghnklebb	FALSE
mcjklpnoogcheafbgc	FALSE
mckbdengkilpmiojnc	FALSE
mmgdalgoceepplhobc	FALSE
mmgondkcddcbahepdg	FALSE
nfffpoaabikdgbihoc	FALSE
nffgodnonicikljpkd	FALSE
oapfgcebahmampgkbl	FALSE
obahmagemdjdgobkml	FALSE
olpffccllneohlibmd	FALSE
olpfhabggoenloobak	FALSE
pfjopkiojokllkehcd	FALSE
pflofjfhfcmcjlkgmd	FALSE
aaaafflmakgmnpnbcjd	TRUE
aabgjijfpjpepcmfpfd	TRUE
aliflbedpokkipdeced	TRUE
alikdbdegbooagolncd	TRUE
bgdcbhnefbajnpnejkg	TRUE
bgefncflaamjeocndlb	TRUE
cbfadhgmjoohjnmfgmb	TRUE
cbfgniochkmjpajjpjl	TRUE
clkfmglbpkheefnahie	TRUE
cllcpgbigjhnamhfdeb	TRUE
dfghmjeibjbckldiiab	TRUE
dfhpghlclljfakfofch	TRUE
dpijcaojpcnpfgbgofd	TRUE
dpjoijbneobjhcngihg	TRUE
ejippigaikdfflophml	TRUE
ejjccmahpkghbjkmefd	TRUE
fcbofhnklojpochoncl	TRUE
fcekdjmmgkdgkoieadb	TRUE
fmcmekgekpgppknffej	TRUE
fmecnaeicgfkeagpfem	TRUE
gfjfjlpodnldfhdbeib	TRUE
gfjjmdacopeoaedcjbg	TRUE
gpjfopbacklhbcealdf	TRUE
gpjigbledcjnngkhmgf	TRUE
hjejmbdgjdmcbhhlona	TRUE
hjhaefjpgcpjncommeg	TRUE
idijdlbadbgnbdbhhcd	TRUE
idjlfobmekflglnheeo	TRUE
inkkjipmjfmfmbkfikm	TRUE
inoghjaclageacblakd	TRUE
jhgpfabofahlkomhocd	TRUE
jhijolflnnljnnndmll	TRUE
kcdkdjnmojkobhcjafb	TRUE
kceejhcmphkihlmhdab	TRUE
kmiocofhgnboigccfbj	TRUE
kmioehmhoeafgdpeaed	TRUE
lhfcppmbopbjmkaakha	TRUE
lhfefoeekmnfobblopk	TRUE
mbaihciidomopfgkcob	TRUE
mbakccamnogfnnflgbd	TRUE
mllkmngcnlhkidadkcb	TRUE
mlmcmhmgdbmhojfmiab	TRUE
nfkjfckcmgghlaoncmn	TRUE
nfkpfiknmmdgmjkgbol	TRUE
oaakckfjcagmaeeehgo	TRUE
oadebjmblmhbeebfbcd	TRUE
ojnencgogfegolaajfm	TRUE
ojpnjefkgijokfbfldm	TRUE
pfedcmjmicndkoeicab	TRUE
pfeeljalfbjgkdpfacd	TRUE
aaaafflmakgmnpnbckl	FALSE
aabgijfpjpepcnggolm	FALSE
alhkkkkfmajeclppiob	FALSE
allaifanegbnbldbmah	FALSE
bgalpbaocgkfjehgkep	FALSE
bgckdkmnomepalejock	FALSE
cbhmimcbllefmkgolgd	FALSE
cbjggpefbplimlgnlcd	FALSE
clnhjpipmkcheangied	FALSE
cloacbkegjliikamnkj	FALSE
dfcgcgdgkgegkljjddm	FALSE
dfdcepemnflhhojdkmd	FALSE
dpkpennplfepnnapaeb	FALSE
dpkpnkmdkjelfjaejjb	FALSE
einnmjkbcllnpkkmjmd	FALSE
eipahnpihdlcbfekeec	FALSE
fcdkghdfapgllnhffej	FALSE
fceniahcdildcfaohig	FALSE
flnmdlaohmpnmdlkdab	FALSE
flpijdkcagjdcmempaa	FALSE
ggbdlalgpcnnijgcbgl	FALSE
ggbjmicbhcneehgfkhd	FALSE
gpildpmiokapadeehgb	FALSE
gpipkdpmcndaljcpndd	FALSE
hjhkjbelpcfnmmkmlhd	FALSE
hjhmicjlnfedmfpklbg	FALSE
idhefijbmfbhbpnjaeb	FALSE
idhjabiopjinnolnngo	FALSE
iniffbageapemgcccmb	FALSE
inllcdlikneckbcednj	FALSE
jhpgiaodbikahjfdpki	FALSE
jhpimnlbbggkkngklcd	FALSE
kcbblhmojpeeiadpahn	FALSE
kcbjkkaahhheakmcilb	FALSE
kmhamegkadbnbamkenp	FALSE
kmhdciohcapgbejgcin	FALSE
lhbccfflpndcbdgmkmb	FALSE
lhbfpmkbbphnonjepab	FALSE
mbimhilmijdmdnojhab	FALSE
mbipoeblmhcghciblfd	FALSE
mlmphcdnmegplaeelie	FALSE
mlnkfgjpdcakokofkob	FALSE
nfkofiggagdooggibij	FALSE
nflnedbembdoaffmhpb	FALSE
oaaheillgdkgpejpeib	FALSE
oaakefmjoojcbkfihph	FALSE
okkcgnbggdhjfphnopl	FALSE
okkflcihokpdponjpgd	FALSE
pfhalbmdlicphglnhem	FALSE
pfhfljhiflfablahnid	FALSE
