aaabafcldb	TRUE
aaabahhaop	TRUE
aldanbebim	TRUE
aldipimici	TRUE
bfkhphebgm	TRUE
bfkkdkbkeg	TRUE
cadnnjomkc	TRUE
caecngklbl	TRUE
ckfchlebcp	TRUE
ckfgdabggc	TRUE
decgdigmok	TRUE
defkfcpelb	TRUE
dofbfjlkli	TRUE
dogmnncfad	TRUE
ejhbcpibpa	TRUE
ejhddnpnae	TRUE
fcmmfblfck	TRUE
fcndinfbhe	TRUE
flmmghapmd	TRUE
flnnjebcha	TRUE
ggngbgnpal	TRUE
ggngjdcobg	TRUE
hakclnglgk	TRUE
hakejfnild	TRUE
hjibafhino	TRUE
hjlpgdmnbd	TRUE
idolhachce	TRUE
ieaenldldh	TRUE
iojadiakci	TRUE
iojkaeonjl	TRUE
jiecjpkeao	TRUE
jiegnfgllg	TRUE
kccaccekhn	TRUE
kcchodffdk	TRUE
klohhflimn	TRUE
kmacamhimg	TRUE
lgkjjpbapl	TRUE
lgmijnhbdh	TRUE
makcdpmkcd	TRUE
mallmbghao	TRUE
mmenlnaehn	TRUE
mmfoaencfo	TRUE
nfpfkgiafi	TRUE
nfpkniecnd	TRUE
npmnmkafln	TRUE
npnlgppjbe	TRUE
olbnnnlkff	TRUE
olcaaeplji	TRUE
pecjfnlmli	TRUE
pecjgmfnbg	TRUE
aaabafcldi	FALSE
aaabahanob	FALSE
albdkglpab	FALSE
albljkdpcd	FALSE
bfcgdpabab	FALSE
bfcoacfbab	FALSE
cadhonibab	FALSE
cadjiibbab	FALSE
ckjepdabcd	FALSE
cklapggbab	FALSE
dekffpabcd	FALSE
dekjglabab	FALSE
doeddoabab	FALSE
doeobbabab	FALSE
eieibabjab	FALSE
eiepdfabab	FALSE
fdbdllabab	FALSE
fdcnbfabcd	FALSE
fncphhabcd	FALSE
fndkpbabab	FALSE
ggggdkabab	FALSE
ggjeboabcd	FALSE
haldocabab	FALSE
halghjgbcd	FALSE
hkeinmabab	FALSE
hkepmeabcd	FALSE
idncddabab	FALSE
idocbcabcd	FALSE
iolkomabcd	FALSE
ioobbpabab	FALSE
jihacldbab	FALSE
jiiebhabcd	FALSE
kceoaggbab	FALSE
kcepodabab	FALSE
kmjaldfbcd	FALSE
kmjodbabcd	FALSE
lgpigbabab	FALSE
lhadpedbab	FALSE
mamdbmopcd	FALSE
manobohjcd	FALSE
mlibijabab	FALSE
mligloabcd	FALSE
ngfmlkabcd	FALSE
nggcbhabab	FALSE
npnmalkbcd	FALSE
npnmogabcd	FALSE
ojkifgabcd	FALSE
ojkmfajbcd	FALSE
pdmhabbbcd	FALSE
pdnaabjecd	FALSE
aaabafcldhb	TRUE
aaabahanohm	TRUE
alejpijjnid	TRUE
alhaggpighf	TRUE
bfnppdkinhl	TRUE
bgafhlfdhel	TRUE
cagkdehnmjk	TRUE
caiaggilffp	TRUE
ckdjegbaklj	TRUE
ckflopdhjgm	TRUE
ddkghjjapfo	TRUE
ddleahiknhd	TRUE
dodgpfhhlka	TRUE
dodpihaonmj	TRUE
eighaidphkc	TRUE
eihpjkfpegb	TRUE
fcnlcpagmjm	TRUE
fcpgapmdonj	TRUE
fmebpmdgigj	TRUE
fmfhdnpncfd	TRUE
ggiimbmddff	TRUE
gginjhaobki	TRUE
hakminddbce	TRUE
halbnpmgdhb	TRUE
hjkbopgcaan	TRUE
hjkmojbjbgk	TRUE
idifigknfae	TRUE
idkkpnaeabj	TRUE
iodhbmmclie	TRUE
iodmimneona	TRUE
jinkeidhebi	TRUE
jiocochfggd	TRUE
kcfcobodgfp	TRUE
kcgolebebpm	TRUE
knbkdifinjj	TRUE
knblbbhajkf	TRUE
lgeihmljojb	TRUE
lgejhmmbamk	TRUE
mainhohcdac	TRUE
majnoahgkmg	TRUE
mlfapjbbkfh	TRUE
mlfmbapedco	TRUE
ngbnmfcdmgo	TRUE
ngciahpckfc	TRUE
npnjigcgnmp	TRUE
nppanblfkcn	TRUE
ojejgcdlhfi	TRUE
ojekegcagmi	TRUE
pebmacfelmh	TRUE
pechlgdedld	TRUE
aaaggdidbcd	FALSE
aaaipflbgab	FALSE
alhohicgbab	FALSE
alichejkbab	FALSE
beippghabab	FALSE
bekjamnfbab	FALSE
bnlndjcabab	FALSE
bnmkaakmbcd	FALSE
cjgaocbdanb	FALSE
cjhgeceabcd	FALSE
debinbiabab	FALSE
dedjpobabcd	FALSE
dphefialbab	FALSE
dphodbcabcd	FALSE
ekdkmlnabcd	FALSE
ekepbidabcd	FALSE
feikiigabcd	FALSE
fejpaohkbcd	FALSE
fojkpdiabab	FALSE
fokbchjabab	FALSE
gijlelkabcd	FALSE
gijmadhobab	FALSE
hcplhllabab	FALSE
hdagkjmdbcd	FALSE
hnmmhdgabcd	FALSE
hnnfafoabcd	FALSE
igjioppabcd	FALSE
iglfppjabab	FALSE
jbgaakpobcd	FALSE
jbiekebabab	FALSE
jljeelcabab	FALSE
jljfjbeabcd	FALSE
kfpjpolabcd	FALSE
kgafpkiibab	FALSE
lamcofogbcd	FALSE
lampjnbeocd	FALSE
ljooaaiobab	FALSE
ljpoddpabcd	FALSE
meckendabab	FALSE
medbnelabcd	FALSE
mohipnoabab	FALSE
mojimcbabab	FALSE
nibglcaabcd	FALSE
nicefpiabcd	FALSE
ocfjbjeabcd	FALSE
ocgbbodabcd	FALSE
omdcmlnabcd	FALSE
omebbjoabcd	FALSE
pgggemambab	FALSE
pghpknaibcd	FALSE
aaaggdidhpfl	TRUE
aaaibgoacddb	TRUE
alggcbcpohfj	TRUE
algglfkhpfhn	TRUE
befikdilhjkb	TRUE
befklljgdimi	TRUE
boefjjcmapca	TRUE
boeljpkakhnd	TRUE
cjcebjkacdkb	TRUE
cjcigjopmnie	TRUE
ddpkhihihdcd	TRUE
dealdpghgalc	TRUE
dpchndoinnbj	TRUE
dpdjpkmjionf	TRUE
eklifmglhphg	TRUE
ekljbcblplih	TRUE
fehacalplogb	TRUE
fehghplpfpic	TRUE
fohhmfmppgmg	TRUE
foifppnondcd	TRUE
giemnnknnnen	TRUE
giepdkngffhc	TRUE
hdaenljmpkjk	TRUE
hdceijgjofac	TRUE
hnaglkkbiggc	TRUE
hnbhmoobdbhk	TRUE
ihclideffglh	TRUE
ihdjjgahndjl	TRUE
jbdocpgmfape	TRUE
jbfjcehkckcb	TRUE
jlfdonmeoejb	TRUE
jlfmblkmebbb	TRUE
kgjidgonpgoo	TRUE
kgkbdlaljhkb	TRUE
laigphebkeog	TRUE
laimgdpkbkdg	TRUE
llefoeegpojo	TRUE
llemlaifohnh	TRUE
mehabnnlijdi	TRUE
mehffdfabldd	TRUE
moknbjgbjofc	TRUE
momddigbinng	TRUE
nimjkpemohkp	TRUE
niofhpkfhokm	TRUE
ocfaejikpamb	TRUE
ocghgpifbobn	TRUE
omlemnfbedio	TRUE
omlnngpcbmhl	TRUE
pgfmafkccgdl	TRUE
pggemmldhgmf	TRUE
aaaahagelbab	FALSE
aaakkncfebab	FALSE
akceflcbmnab	FALSE
akcnfcbadphb	FALSE
bdklfphbabab	FALSE
bdlmncloabcd	FALSE
bnjnnpndabab	FALSE
bnkmghpnabcd	FALSE
cgffeocpabab	FALSE
cgfjoidhabab	FALSE
dalalbgfnnab	FALSE
damnahigibab	FALSE
dkpafgifabab	FALSE
dlbikbemabab	FALSE
eeocbiniabcd	FALSE
eeonacfaabcd	FALSE
epnbpoelabcd	FALSE
epnooeaaobcd	FALSE
fjacmnbbobcd	FALSE
fjaflfgmfbab	FALSE
geajgekmgbcd	FALSE
gebjijgiabcd	FALSE
gnmfhgbeabab	FALSE
gnnldhnpabcd	FALSE
hjdnpkfpabcd	FALSE
hjfoflegabab	FALSE
idghgjbjabcd	FALSE
idgijelmabcd	FALSE
ildanneboocd	FALSE
ilfoflijabab	FALSE
jgengonoabcd	FALSE
jgfinkgcabab	FALSE
kbcendgoabab	FALSE
kbchabkgiaob	FALSE
kmmhpkenabcd	FALSE
kmneeedoabcd	FALSE
lgccplpeabcd	FALSE
lgcegnbpabcd	FALSE
lpmhiibfabcd	FALSE
lpnidpcgabcd	FALSE
mjjdcgcfabcd	FALSE
mjkpembjabcd	FALSE
neabjaoiljib	FALSE
neahdeklmbab	FALSE
nohklnegabab	FALSE
npaogokpjbcd	FALSE
oiikpnimabcd	FALSE
oijboihpabab	FALSE
pelfemaffbab	FALSE
pelhldfdabab	FALSE
aaaahageloknc	TRUE
aaakfeiafegpb	TRUE
akaibgdpjddlk	TRUE
akalammnhmgmh	TRUE
bcnjinbdkihad	TRUE
bcoeimnkdhjgh	TRUE
bmhomoidhggaf	TRUE
bmjdmkniolbnj	TRUE
chebnbfbpeaai	TRUE
chegomkgnlpdn	TRUE
dahncffncbini	TRUE
daiafaaloceed	TRUE
dkeiggecgljip	TRUE
dkfpefahdaleh	TRUE
efenggadlnpla	TRUE
efenojacmfhkl	TRUE
epnajielegpdm	TRUE
epncmgajgimgc	TRUE
fkbodbdhdjhih	TRUE
fkclghafneeog	TRUE
gdladmomecjha	TRUE
gdlmiifkekana	TRUE
gnphpjiegadeg	TRUE
gnpklncojagko	TRUE
hjhbnjfakjnjp	TRUE
hjiimdhkjnioi	TRUE
iddflnkakecdc	TRUE
idefhchgnefng	TRUE
ilkmpnngldoji	TRUE
ilkplgkegfjmm	TRUE
jfdiheoglidao	TRUE
jfdoppemkofmj	TRUE
kaonnbcbnicej	TRUE
kbaiembkkckom	TRUE
klnfmpiihajbn	TRUE
kmadmfbmfnipi	TRUE
lfhgncedkfncc	TRUE
lfhmdgnhbdmil	TRUE
lpjjnhoajdlnj	TRUE
lpkjdckikegip	TRUE
mkkngiibjahdf	TRUE
mklfoaggaffeo	TRUE
ndhkljlgjajch	TRUE
ndicklibmgnmi	TRUE
nodefjifagifn	TRUE
noebfnknonlce	TRUE
ojaeiafcpjnhp	TRUE
ojbelfdccjjnd	TRUE
peedmbdhdphhl	TRUE
pefaoennjbbgo	TRUE
aaaaodlemibcd	FALSE
aabbnlliljgab	FALSE
akmlkhffpkbab	FALSE
aknfkmjgelbab	FALSE
beglpelghabcd	FALSE
behljnoibabab	FALSE
bnmejnmmkabcd	FALSE
bnmhdkfjkabab	FALSE
cicfcfhaofbab	FALSE
cidcnlfclabab	FALSE
dcmhlnlepabab	FALSE
dcnhkdbaebmab	FALSE
dngifkaeafbcd	FALSE
dngmaecfagbab	FALSE
ehafincaobpcd	FALSE
ehamiacfnpbcd	FALSE
fbidoejgcabab	FALSE
fbjepoepjabab	FALSE
fmglcelhafbab	FALSE
fmglfohniabab	FALSE
gfogcboekabab	FALSE
ggaiphfdlabcd	FALSE
gpafefihhfbcd	FALSE
gpainkkkhebcd	FALSE
hkcamhnblgfab	FALSE
hkcpihalpebab	FALSE
iemobegnpabab	FALSE
ienahkmmoobcd	FALSE
ipjggifojabab	FALSE
ipjigohgambab	FALSE
jleligbcfabab	FALSE
jlfmlhegkabcd	FALSE
keablfkiojalb	FALSE
keajehebiampb	FALSE
knpfbkdmnabab	FALSE
knpkgcafhmbab	FALSE
liepaamlapbcd	FALSE
ligjcobdbabab	FALSE
mcdlajneidbcd	FALSE
mcejagpnfmbcd	FALSE
mmkpipmfcabab	FALSE
mmlngioaelbab	FALSE
nhfiomkfiabab	FALSE
nhgmpceabmced	FALSE
obejhibhlabab	FALSE
obfogfnnalbab	FALSE
olhkkelpeabcd	FALSE
olklmannlkbab	FALSE
pficbofdaabab	FALSE
pfjldlpkmabcd	FALSE
aaaaodlemipbdn	TRUE
aablijgeoleage	TRUE
akncgdplfaeehi	TRUE
aknojphekoaein	TRUE
bemmehlmcfbkhn	TRUE
bemnnehogogckp	TRUE
bnhildkepmfgnb	TRUE
bnhmhcbpdbbfbn	TRUE
chkhhojppiikod	TRUE
chlcnjaoaibcpm	TRUE
dbpdhpjgdengom	TRUE
dbpoebpmbplgke	TRUE
dnkndafekgfboh	TRUE
dnmmfjfgpebpok	TRUE
eicbdipgamlhpk	TRUE
eiddmnekkbabnn	TRUE
fbefgneigjbebb	TRUE
fbeohppbedmglg	TRUE
fmhgggkmmieknf	TRUE
fmhmbmpjfbjoed	TRUE
gfaihpjogjaebh	TRUE
gfddkdbckipgfh	TRUE
golhkjpefdoglj	TRUE
gonenhjbhooeok	TRUE
hjipbkpofoplda	TRUE
hjkdhnbnimjnmc	TRUE
ifdielbchbackf	TRUE
ifepkenngiedmn	TRUE
ipffmnmneiaebk	TRUE
ipgajpjiflbpjn	TRUE
jkfdlbeepcjhkd	TRUE
jkgnodpcahhoeg	TRUE
kelafkbeajelok	TRUE
keogjkglejifgh	TRUE
kocmfdgobalahd	TRUE
kohdapenondnlo	TRUE
lidbcepenglhko	TRUE
lieeihcccmcjgi	TRUE
mceejefcaaiphp	TRUE
mcfemgbbhlojhk	TRUE
mnfigfhjdpibcj	TRUE
mngagaibcdgdab	TRUE
nhjghajekjjaij	TRUE
nhlbngjmkiekad	TRUE
oapdaecpaickdd	TRUE
obcchmkapkofgj	TRUE
olegojcgbdebjn	TRUE
olejcbegepkbim	TRUE
pfibcgkiimnebp	TRUE
pfigijgngjdgbj	TRUE
aaaahneegifbcd	FALSE
aabeccfnhjcdkf	FALSE
ajeafjdnjnhbcd	FALSE
ajfmnandgjabab	FALSE
beihfloeeiabcd	FALSE
beijjfpbbjabab	FALSE
bofcimjbmlabab	FALSE
bogeebmikjabcd	FALSE
cichpjkneoabcd	FALSE
ciebdhjkpcabab	FALSE
dcbifekljdabcd	FALSE
dcckonnebpabcd	FALSE
dmbkcbhbpoabcd	FALSE
dmbnhgihjpabab	FALSE
egooopegcfabcd	FALSE
egpdgknicdabab	FALSE
fankcdjebkiagb	FALSE
faoofececckbab	FALSE
flijogfhihabcd	FALSE
flimiiobmdabcd	FALSE
gfjelpaileibcd	FALSE
gfjnbnicckabab	FALSE
gpmkhaoejgkbcd	FALSE
gpmophjckpabcd	FALSE
hlclbfflniabab	FALSE
hlcobongohabab	FALSE
ificamkdddlbcd	FALSE
ifipegcofiabab	FALSE
ipmfdhnfahgbab	FALSE
ipmmnaegipobab	FALSE
jjhbjeeogkabcd	FALSE
jjimflamnnmbab	FALSE
keknklbeeeabcd	FALSE
kemcoeomdpabcd	FALSE
komokmaphnnbab	FALSE
konllkkaiacbcd	FALSE
ljehohpneeabcd	FALSE
ljeoclfgghabcd	FALSE
mdihbkkoaadbab	FALSE
mdlekpjghoabcd	FALSE
mndcealgmpebcd	FALSE
mndgmnbpeiabcd	FALSE
nhllimaefhabcd	FALSE
nhmgbkciliabcd	FALSE
objdlcobpnabcd	FALSE
objlpgopkfabcd	FALSE
omcajkdpkgcbab	FALSE
omdkdodfpcabcd	FALSE
pgfapoeemegbab	FALSE
pgfidfnhmcabcd	FALSE
aaccebailheeggn	TRUE
aaccphboajkklne	TRUE
alckeiobeaefpid	TRUE
aldafdlihcpbhpm	TRUE
bfihdabgjpifkij	TRUE
bfiokkhoomjndhg	TRUE
cajmjblbbgdmcej	TRUE
cakfafaophcegpm	TRUE
ckbphjeckfbmjnd	TRUE
ckcibgfcnlbiohc	TRUE
deafdnonfcapjhl	TRUE
debalbdlkhfohln	TRUE
dneikbmfniahgdn	TRUE
dnejaldpmpbkcij	TRUE
ehbdpghabieidkh	TRUE
ehbmapgdhdchnbk	TRUE
fagejnaeodfdhji	TRUE
fagnapdlclfoppc	TRUE
flfoabknaflhlmn	TRUE
flfoddlgbbicecg	TRUE
ggcklpgijaiajom	TRUE
ggdnbdjpkpmfioe	TRUE
hajfpelbnnnpoaj	TRUE
hajglgkfpjainjh	TRUE
hkkmlepaghngcfa	TRUE
hklcbkmjadhfjhl	TRUE
ieeagbhljjaifhn	TRUE
ieekamkhhbmcfkj	TRUE
injbjplhlapmlde	TRUE
injliojegfleade	TRUE
jhgnocppnjlkoko	TRUE
jhhofpokbdcpkmf	TRUE
kanlecjmdechbgf	TRUE
kaoefbadaiagdkf	TRUE
klkgokcggmdbcne	TRUE
kllhdikkgohclfc	TRUE
lepfpafkoolhnbo	TRUE
lepmhnfddihmone	TRUE
lpjnlpacfjfjdmp	TRUE
lpkggogfmoejodb	TRUE
mjfklbpakpiacnn	TRUE
mjflgljkoggbkee	TRUE
nfdebcgcmhpajpm	TRUE
nfdhbcpglohnpeh	TRUE
nonidikmmgcgihf	TRUE
nookpnjgidchckp	TRUE
ojmnlnjgecfflhc	TRUE
ojneieopaonpiof	TRUE
pfgjijjfljjppcd	TRUE
pfgjjbfcbnpnnen	TRUE
aaccebailheegfb	FALSE
aaccpmhboajkklb	FALSE
alcejammpphmbab	FALSE
alfdpbdinagalnb	FALSE
bflpiekfcbpabcd	FALSE
bfmcgcncbbeabcd	FALSE
caglgbjhlhjoakb	FALSE
cahlnlceaclgbcd	FALSE
cjphahnfabbphab	FALSE
cjplgpaipacjbcd	FALSE
ddkdhkihllbabcd	FALSE
ddkkmdafaakibab	FALSE
dnbfedfmgbjabab	FALSE
dnbigpdoaobiaob	FALSE
egmknaldpmpbkab	FALSE
egophilodphabab	FALSE
fajmppamjljjbcd	FALSE
falfeeikkjhibcd	FALSE
flacegkjlmhgbcd	FALSE
flcojkbcfpgabcd	FALSE
gfdcpiingaflbcd	FALSE
gfgehjbjgodabab	FALSE
haglbndgpheilab	FALSE
hahaoijmloiblab	FALSE
hkgghcieepaibab	FALSE
hkgmbdgdpgbabcd	FALSE
ielojhpifmhabab	FALSE
iemincnjbjjabcd	FALSE
iniklpggjlkabcd	FALSE
injbeoplbhkabcd	FALSE
jhdbngmmjkhabab	FALSE
jhdkjjmgcadabab	FALSE
kbdjfofginfabcd	FALSE
kbdlbloobhjabab	FALSE
kkpfllokflkabcd	FALSE
klchchghbplabab	FALSE
lfkndjknmjkabcd	FALSE
lfkpabchmnddnnp	FALSE
lpkafpmhfcjfbab	FALSE
lpkkadgodkfobab	FALSE
mkpbodplhdlabcd	FALSE
mlbfjamfnfgobcd	FALSE
nffheabjgpkhaab	FALSE
nffibmmpcjdabab	FALSE
nopoiobhgohabcd	FALSE
npcihpfhcjcabab	FALSE
ojklommcpmdabab	FALSE
ojljganafpggbcd	FALSE
pfmlkmldjfmabab	FALSE
pfmmacecpbalapb	FALSE
aaaekmfpelcggnoh	TRUE
aabfdnofcajbkmnd	TRUE
ajkpfdomclaocihn	TRUE
ajlkcjaijeodplaj	TRUE
bdgpibohoaalekon	TRUE
bdhdgnadcmlmhalb	TRUE
bnckeceeicahonfk	TRUE
bndahihbkohdebfp	TRUE
choddoabnohmioeo	TRUE
choklloehopgfgmg	TRUE
dbdbpbggaadnlipp	TRUE
dbddojbchaheepba	TRUE
dlnhleombekhheab	TRUE
dloaindhjdpjhnkc	TRUE
efghpfjifdgdfknc	TRUE
efglfkbjapjobncg	TRUE
faihecbmfcajlhih	TRUE
fajfialeghfhamcj	TRUE
flbmjfahkfphpbpd	TRUE
flcdeelbeefijllp	TRUE
gejoobddlhlnfagh	TRUE
gekkmboajgeimagi	TRUE
gpjcbldheggocpib	TRUE
gpjjkncoadjmcplm	TRUE
hkfigmjokiemjnja	TRUE
hkfmbajjlaoipebm	TRUE
igecjoflpiabkhah	TRUE
igeppocfdenhdadb	TRUE
jbadbppgadccflfg	TRUE
jbalpmkpknnbofnc	TRUE
jlkccdldfgllhopl	TRUE
jlmjoihaiienffaf	TRUE
kfnmmplccmfbbpba	TRUE
kfobelhomgmngnbi	TRUE
laddhklfpbhjieim	TRUE
lafjehddnagcbflg	TRUE
ljhaeadjalkdhjid	TRUE
ljhaejfepfgebilf	TRUE
mdfhhfdmblihelmc	TRUE
mdhdbiiopbaifpkc	TRUE
mndbacehhpinejom	TRUE
mndbklnddnindkfe	TRUE
niafpmcnjphmjode	TRUE
niaijojicfcafjmn	TRUE
ochbopceecafcpof	TRUE
ocjbmjecbofibbcb	TRUE
omigadncmfdophee	TRUE
omilbanjjekfilaf	TRUE
pfodjgaodlbfpfdn	TRUE
pfoiahafmpnapkne	TRUE
aabmcfbchjfoonkd	FALSE
aaecllehkecmlbab	FALSE
akebdedkokhchgpd	FALSE
akehpinddliokbab	FALSE
becgkkhghmcnabab	FALSE
bedfnbmhdnlfabcd	FALSE
bolecaoemombhgcd	FALSE
bolegbmnfbiiabcd	FALSE
cjkdigfjekeoabcd	FALSE
cjknaliopcojobab	FALSE
dcekhckgiddlabcd	FALSE
dcemngjjafdfobab	FALSE
dmhddcepknpmabcd	FALSE
dmhpncgnjmggabab	FALSE
ehcggdhaeangmbab	FALSE
ehdcffdopffiabab	FALSE
fahmagiignihebab	FALSE
faibnddghdlcchkd	FALSE
flbkmncajgdiabcd	FALSE
flbogceflhlcabab	FALSE
geipfbpdlheeabab	FALSE
gejlkekdobjaobab	FALSE
gpadjkpfjjpafbab	FALSE
gpcbhamkpcceibcd	FALSE
hjochfhlnnbmabab	FALSE
hjoidaidlgdnebab	FALSE
idnfgaafdogoibcd	FALSE
idoghlgomdjeabab	FALSE
iobihfnoaaaaibab	FALSE
ioblhleanmgjgbcd	FALSE
jhmikfcemjdnabcd	FALSE
jhnaobndcfmibajd	FALSE
kclpjdohlngoabab	FALSE
kcnllflpcpilabab	FALSE
kmnlkppnablhegcd	FALSE
kmnpmjlcmaakmbab	FALSE
lieddgmflpjhabab	FALSE
liemambbejekdoab	FALSE
mcmhalpejjdlmbcd	FALSE
mcohbfmeijceabab	FALSE
mofgpigpefabhfcd	FALSE
mofhamhiiblmbpab	FALSE
nidaaieaffnhnbcd	FALSE
niebakbeebbodcid	FALSE
oailkdebcoaglelb	FALSE
oajllfnbicdicjhk	FALSE
okppgehimldbabcd	FALSE
oladiicppkhmobcd	FALSE
pfddahnbfapakpmb	FALSE
pfdokgbdfcooabab	FALSE
aabmcfbchjfoonkcm	TRUE
aaelehkecmlkammnf	TRUE
akcfnchhomoafomhk	TRUE
akcmlkpblfaddilmo	TRUE
bedblabfcanhjeebd	TRUE
bedcehdahpkhfdomi	TRUE
bomlgjooicnniejab	TRUE
bonfecngkcmdkoepk	TRUE
cilgnnemlgdhibgne	TRUE
ciloiehbkcoefliff	TRUE
ddemkghialfgggjjl	TRUE
ddeohppheefnegngj	TRUE
dmonmkknphmoophej	TRUE
dncckmffnkhfdglbl	TRUE
eglidjpjejfjhkkfm	TRUE
eglmampaoomnliock	TRUE
fabjhjfobgmbijheg	TRUE
fabjloiaojmcbhfdk	TRUE
fkbnejanfokiofngj	TRUE
fkcdfmhkbbfnefeag	TRUE
gelokodbbnckmpoae	TRUE
gemdhppfbaoogkdgk	TRUE
gpfmnlhadcoakdial	TRUE
gpfndniihoppehanc	TRUE
hjfhjgoplpnlpogjk	TRUE
hjfjmihiajgbjglof	TRUE
ieciicnghmkmdhaod	TRUE
iedcboeplppbnhlcp	TRUE
ioggaippjiopifbhp	TRUE
ioinjijjlcedkccde	TRUE
jinbfekbhjemfcjjf	TRUE
jinbgmbigifjedhdm	TRUE
kdcdnonleplnaecdh	TRUE
kddlgpbpcolcfnlel	TRUE
knfnmelhjigjcadad	TRUE
knieflhakooepanbh	TRUE
liaiehicopgpdhndm	TRUE
libeahmeijdehoeik	TRUE
mddojelffepnmkgah	TRUE
mdelddkechnoofbog	TRUE
modheohfnfamnnoon	TRUE
moehefcjdfgcnhejn	TRUE
nhhcahadcollppocc	TRUE
nhhgabbcplaiiicfp	TRUE
obfnihecgmhnoekfg	TRUE
obgecfbnbdiomdfko	TRUE
oljmfmeinpagehaph	TRUE
oljnpbnemnkgakhhk	TRUE
pffpgpmbjknjddmhc	TRUE
pfhinobjkofgddpoj	TRUE
aadiandlbfanooeib	FALSE
aadofabeeipbkjaib	FALSE
akeepbkoajiheejhb	FALSE
akgfppbnndbmhffab	FALSE
bfhjccfdmnjmjabcd	FALSE
bfhkbcklmhbhpabab	FALSE
bpofalmnoiaajcbab	FALSE
bppnhcgibojmhabab	FALSE
ckjdobllamiiphbcd	FALSE
ckklechegagbjcffd	FALSE
ddjplhhgnbenpabcd	FALSE
ddkfnbdhfbifjabab	FALSE
dnhabhipeimpdbfab	FALSE
dnhpelgfffoofabab	FALSE
ejaocfaookbeihlcd	FALSE
ejcbgjallhadgbadb	FALSE
fdpkcgkkaammjabcd	FALSE
feabkcdcjafokpccg	FALSE
fnclffacdnbnloicd	FALSE
fndejkfendhedabcd	FALSE
gicljcppiippdabab	FALSE
gidohoagldhkdebcd	FALSE
hddgcckeljjilabcd	FALSE
hdembflkcoollabcd	FALSE
hnimjdpkchfmbabab	FALSE
hniodbehljbmpabab	FALSE
iihfkcadpnncdfbab	FALSE
iiicbbnbcjjiiabab	FALSE
jboodjfbchlghabab	FALSE
jboppmgojkhlmabab	FALSE
jlmlginpbnnflabcd	FALSE
jlnkioenmnhjbabab	FALSE
kgkhjemfjdhejabcd	FALSE
kglaleijcdgidebab	FALSE
ladmbolpndjnmppab	FALSE
lahbkbbcjeodjmfeb	FALSE
lkgbckmednlokabab	FALSE
lkhhbcapncbhjmgcd	FALSE
mejnhjnibfcmlabab	FALSE
meonmcjejgnfkabab	FALSE
mokpcphkgealgjbcd	FALSE
molncdafaaojpmbcd	FALSE
njggmbhmpmedgabcd	FALSE
njhehodnakahlbfcd	FALSE
ocmekoclabofnpadb	FALSE
ocmhjlahkldjgebab	FALSE
ollfoiiclcdnhabcd	FALSE
olmmjchbccdphabab	FALSE
pgiffebafpegdgbcd	FALSE
pgjemkeddbklgabab	FALSE
aaagdjobippkmkbnae	TRUE
aabnlejdncdlemabdo	TRUE
aihgaapbajnipoiapf	TRUE
aihgbbepcjfhaakjdb	TRUE
bcpmdamebjlmgbpnlk	TRUE
bcpoekmhdmminniigh	TRUE
bnnapkfbbkbkdpnjlk	TRUE
bnnkkammmacncdcaia	TRUE
chkpbioocnlpgipgjg	TRUE
chlldehjabopjinhok	TRUE
ddgdafalfjmmlmcnko	TRUE
ddhfjcgncodhbpimad	TRUE
docijladhmbbgalmli	TRUE
dodbpinfeokbnimibm	TRUE
eidcgjdnohgbipnojm	TRUE
eigfmbgoihknoebdfi	TRUE
fcbddgkedenbolmoic	TRUE
fcbfdnflefhnjkobci	TRUE
flbmjpealenfpicdcf	TRUE
flcpemkgmpdjcbdjbc	TRUE
gekjnmljonncebfkhl	TRUE
geldgcknfephkdjagm	TRUE
gonpnlifdafmfgacne	TRUE
gopbcbocngpnhiafno	TRUE
hiohbfikgbpaeongkl	TRUE
hipaoijjfnhbimadeg	TRUE
idgmiffjbejmpffjlk	TRUE
idhchmcfbmfahpgelg	TRUE
innpnabdfkgiacalmn	TRUE
inoffbedhbiknfmlbb	TRUE
jiaahoceoiefodmonh	TRUE
jiabmidhggnlppopbk	TRUE
kbkenkodponnagocgk	TRUE
kbkgdhhbonjamkcmka	TRUE
kmibobhlkgmlppplid	TRUE
kmilhogenmdmofpmaa	TRUE
lgpopmehnfdphjahfi	TRUE
lgppfmipnlchnaanpk	TRUE
mbndbilhonppaghpoc	TRUE
mbniikniohcjlgbpcg	TRUE
mmokppmcihoghhjdna	TRUE
mmoomfkoghecaljmao	TRUE
ngbpmapfeiddpjkffp	TRUE
ngcbnmpgmdagccodnh	TRUE
npooabdoecdlchefab	TRUE
nppefbjnmeclgpjjoc	TRUE
olhmkoompokfkbblho	TRUE
olhnemhpflmckficnd	TRUE
pgfcchbnllfgipfehc	TRUE
pggaehlhgdehibmflk	TRUE
aaaeehahemhbgkigcd	FALSE
aabifcmjpdnjlddmob	FALSE
ajcfdhilgphkiaebab	FALSE
ajckmjhapbkpigjmab	FALSE
bdcdgihaiondfjmbab	FALSE
bdcfhilooaljiddbcd	FALSE
bpfihpbpcgmkgbabab	FALSE
bpfkhimldfhbenabcd	FALSE
cjjaeoilegojhmmbcd	FALSE
cjljedpgkhgalppbcd	FALSE
dgddbpkacdhbojeocd	FALSE
dgdldagpegmjdgfbab	FALSE
ebngkgbjkmoedpabcd	FALSE
eboanimbadggodebgm	FALSE
emgccbdbcibeepabab	FALSE
emgdhbngdafdepobcd	FALSE
fgfkmhdepngcojabab	FALSE
fggicjniicflppabcd	FALSE
fplcpenmbnpnjdabab	FALSE
fpmdmihmhifocfabcd	FALSE
gjehnlkkopdfmlabab	FALSE
gjenfljncdpmpiabab	FALSE
hblebhfhmdaagfcbab	FALSE
hblncocalldadjlbcd	FALSE
hkdgdjflklcpklabab	FALSE
hkdlcmdpmokibiabab	FALSE
ielnfpkmjjgmjhabcd	FALSE
ielodloecjkedjabcd	FALSE
ipehldpaplnfbhlcld	FALSE
ipfmclclppgmokabab	FALSE
jjbhipkijdohknabab	FALSE
jjbncmfhgjgpbgabab	FALSE
kdglhpcbdbdmikabab	FALSE
kdgpelpjkbbdfeabab	FALSE
kngbgmepghjgheabcd	FALSE
kngnoommagemacfbcd	FALSE
lhajchaddgeenjfbcd	FALSE
lhbimedlednekbabab	FALSE
mafcaoohbcllofiled	FALSE
magbalmoonbdnacchf	FALSE
mkggldejmddiadfbab	FALSE
mkhjmflpghdlghabcd	FALSE
nefcheddbnjbllabab	FALSE
nefhlckcdldlgkabab	FALSE
nopgopfalmkepgmbcd	FALSE
nopopmnophecdcabcd	FALSE
olflmhdkfdfnicabab	FALSE
olgghfbelkobbjabab	FALSE
pgbchnpdekoikjabab	FALSE
pgdhciigonjadhlbab	FALSE
aaaeehahemhbgkigpji	TRUE
aabfcmjpdnjlddmobab	TRUE
ajdfgfegmpfialhofin	TRUE
ajdgoplcbbenlnmhklb	TRUE
bdgehnofnknaeiamllg	TRUE
bdhgjibbefeojmdfgei	TRUE
bpaljjjacipgmedogkd	TRUE
bpbfbikkjhpcokeifdd	TRUE
ckhebljfkfdnkdjjdii	TRUE
ckhndceoacicfpipejf	TRUE
dfpohlegipiejhbneko	TRUE
dgaagijiiadkdbegfpp	TRUE
ebkilnhfgmcjfolbepb	TRUE
ebklmbmacieofnnboim	TRUE
empempkeeikkakeilpf	TRUE
emphgcioikkmmfgdklk	TRUE
fgfahggobdabceddbob	TRUE
fgfklbeibpgjfjneemc	TRUE
fpjcdcpgmlihogheiae	TRUE
fpjdhnajndlmhknggjb	TRUE
gialaphfkicnhdhoiba	TRUE
gibjfmoojcabdljjhjc	TRUE
hcdjmihejgoamahejno	TRUE
hcedklkdjdgkdnbibpk	TRUE
hlomkfkjejpboallibb	TRUE
hlpifembdanmiabmimi	TRUE
ifhlcbbddmfpgfpbljn	TRUE
ifjbekmjndphclmmacd	TRUE
ipeikndapkljcljcfag	TRUE
ipekbehjgnpljdgfjcn	TRUE
jinpamkekfnicpickmm	TRUE
jioombldfoihjehinab	TRUE
kdfgicfhbkmiaaggkjj	TRUE
kdghohipmjdajmfhghj	TRUE
knkojmnmkdoppojihpa	TRUE
knlnepdimgkgcepkcic	TRUE
lhhmmjgfijchcccgedm	TRUE
lhjmljclollonhikajd	TRUE
mafkieimebnlddjdfgi	TRUE
magifofpnmjnmneaeia	TRUE
mlhofkmfaflkceonobn	TRUE
mljefkeikfepepeebbo	TRUE
ndmdcjlfmkekddciaac	TRUE
ndnfhdnclbplajfbekc	TRUE
noopabobabcbjafpdfa	TRUE
nopdafjkamdphkeihnl	TRUE
okjbimfdggoapbonjkb	TRUE
okmmjcckblnmiioblnf	TRUE
pgdhibgoffibgcfcjel	TRUE
pgdidhmhaojgmnpcmbj	TRUE
aabiffgdnddagcaefpd	FALSE
aacinbgligilkpfliab	FALSE
aknlheeaponpclopbcd	FALSE
albbaldmcmklcmjmcjb	FALSE
bgfimbikmlchofcabcd	FALSE
bgflglpajifhnpfhbab	FALSE
calnepbjakghofcljab	FALSE
calolicehplkbdfnmab	FALSE
cklioigpmhknamlnbcd	FALSE
cklkdighdpnahnigbab	FALSE
dencigelanamgkifbcd	FALSE
denmhapmihgeiippbab	FALSE
eaaknhbidlnolljmbab	FALSE
eaddnpgggheblngbdab	FALSE
ejiomgdgilhdkpfabab	FALSE
ejipldcbogdnlgkabcd	FALSE
fdkfnhogealoohgabcd	FALSE
fdlkndolfnakgpakbab	FALSE
fnldmpdcapnelekfbab	FALSE
fnlecemdahmmcndmbab	FALSE
gipojockkildonfabab	FALSE
gjblefoopleeckhabcd	FALSE
hdjamaphlpggkhmjbab	FALSE
hdkcjmnnojnlpkjabcd	FALSE
hoiomafnfanepamnbcd	FALSE
holignakbokeppnidcd	FALSE
ijcjcljflkjidoiabcd	FALSE
ijcjfhpidlihkpeabab	FALSE
jdcjmeccpmkjomcabab	FALSE
jdcloncekebjkieabab	FALSE
jnapopahpmfjkagebab	FALSE
jnbmlmkfbkhhofkabcd	FALSE
kgalieflkpfklkafbcd	FALSE
kgbclmnndbijkgbabcd	FALSE
laifmommbhkmnhajmob	FALSE
lajhoobbiioiailomlb	FALSE
lkgdadcfkmghmgbhdab	FALSE
lkifmcjcmcapdmoobab	FALSE
mdpkinpeilckfdiabcd	FALSE
mdpmjgmgekohnmoabcd	FALSE
mnoeedhccpcmaegkbab	FALSE
mnphligfcpdnoahebab	FALSE
nickcjlmkhbmnakabcd	FALSE
nidfjepiaajnkplhbcd	FALSE
obooaifagnlghcgdbcd	FALSE
obpfbcaggboifjejced	FALSE
olkbghhclkckepkabcd	FALSE
olkkfgjbmelgcadobab	FALSE
pfnokebjoocbdgoabab	FALSE
pfofkflngnadiaddbcd	FALSE
