aaalbnhbjg	TRUE
aaapgcejpn	TRUE
akgpkblpol	TRUE
akhgomgdac	TRUE
becocoilen	TRUE
bedfcalmnc	TRUE
boblgfbhcp	TRUE
bocohodhap	TRUE
cilmgildki	TRUE
cinkgfcpaa	TRUE
ddfopddddg	TRUE
ddiiigpbkb	TRUE
dnggghjjkf	TRUE
dngigclpob	TRUE
egimpkdhcb	TRUE
egiobhdohp	TRUE
fablahhfme	TRUE
fadlooghkk	TRUE
flfmlamcln	TRUE
flhakemjah	TRUE
ggakeajmjp	TRUE
ggaocpmeib	TRUE
gpmjfcimho	TRUE
gpndadfohf	TRUE
hjicodnhkc	TRUE
hjjfbalcoi	TRUE
icjfngoncg	TRUE
ickmgimaff	TRUE
indclgkmop	TRUE
inehglapol	TRUE
jhhhiaaccp	TRUE
jhidojknpe	TRUE
kckaphjmbo	TRUE
kckkkhkfmp	TRUE
knacfpkogo	TRUE
knafdfhong	TRUE
limnemcckh	TRUE
lipgbnlocc	TRUE
mdpccdijef	TRUE
mdpgcbkbpm	TRUE
mncfcjjeaa	TRUE
mnfplbjdla	TRUE
nihfldihpo	TRUE
niikhdplbk	TRUE
ocffgblifi	TRUE
ocghhefpmb	TRUE
olklojdkbh	TRUE
olmmfocbhh	TRUE
pgflappgok	TRUE
pgghndpilh	TRUE
aaalbnhbja	FALSE
aaapfgceia	FALSE
akfbnfjbab	FALSE
akfpaahgba	FALSE
bdjhafdbab	FALSE
bdjinhabab	FALSE
boiminaaaa	FALSE
bojdppabab	FALSE
cijalaleaa	FALSE
cijfjoabab	FALSE
dcimbgaaaa	FALSE
dckoghaaaa	FALSE
dmbgldabab	FALSE
dmdllnabab	FALSE
ehbfkgabab	FALSE
ehblnoaaaa	FALSE
faanfgbiab	FALSE
faanogcaia	FALSE
flhhekabab	FALSE
flhpbdaaaa	FALSE
gfphodabab	FALSE
gfpifpaaaa	FALSE
gpnlnoaaaa	FALSE
gpompgaaaa	FALSE
higiliaaaa	FALSE
higipaiaaa	FALSE
icoibhabab	FALSE
idadkgfaaa	FALSE
ingjmcaaaa	FALSE
ingkinabab	FALSE
jhhocjabab	FALSE
jhhodnaaaa	FALSE
kbifoalaaa	FALSE
kbijojaaaa	FALSE
knhhpmaaaa	FALSE
knjcmfabab	FALSE
lhimkbaaaa	FALSE
lhjgmdaaaa	FALSE
mcooilaaaa	FALSE
mcpjfdaaaa	FALSE
mnkkdhabab	FALSE
mnlifgabab	FALSE
nibhieabab	FALSE
nicdlaakaa	FALSE
occofmaaaa	FALSE
ocdbmkabab	FALSE
omdhobabab	FALSE
omebedaaaa	FALSE
pgckdoaaaa	FALSE
pgdkfiabab	FALSE
aaalbnhbjfh	TRUE
aaapceionmj	TRUE
akgbcdjpbic	TRUE
akgbmbdbnhi	TRUE
bdkfmdildca	TRUE
bdkghfbllof	TRUE
bnphgnkknmc	TRUE
boagoafockl	TRUE
cicnkkdkdlj	TRUE
cidehplekcg	TRUE
ddbpikfophe	TRUE
ddcbekbhfln	TRUE
dmhnhiphdnk	TRUE
dmibllggcjf	TRUE
eghgdhkeobl	TRUE
eghimpmdpai	TRUE
fabolamcloa	TRUE
fackemjahkc	TRUE
flbaphlgcij	TRUE
fldhpbpmlll	TRUE
gfpopjahmam	TRUE
ggamlhmimpp	TRUE
gpinlhiffkl	TRUE
gpkopgmjdln	TRUE
hilbacjinge	TRUE
hilgomoonco	TRUE
iddkakiklgj	TRUE
idebhjdfeih	TRUE
innjgmeajil	TRUE
innoaaobnfg	TRUE
jhfijllbbcj	TRUE
jhhbcjdhdok	TRUE
kcbegaeolem	TRUE
kccbbbhbpdh	TRUE
knjcpddhajl	TRUE
knjpdmhdeap	TRUE
ljbeleigoco	TRUE
ljbjgjefoga	TRUE
meadpbfdoin	TRUE
meaimcmeoof	TRUE
moacjlakohg	TRUE
moaeobfhgmb	TRUE
nilnhlcooop	TRUE
niloccnomjn	TRUE
obpaajhcgmh	TRUE
obphnegaekd	TRUE
olnoamdhiod	TRUE
olocbfffooh	TRUE
pghdcpiilmn	TRUE
pgheckodajc	TRUE
aabinmenfab	FALSE
aadffamakge	FALSE
ajpnggjpbab	FALSE
akbkmchiakb	FALSE
bdopajlmbab	FALSE
bdpkoknaaaa	FALSE
bpchhfagbab	FALSE
bpdceogabab	FALSE
cicmgngabab	FALSE
cicoabinnab	FALSE
dbgkkehabab	FALSE
dbhnndbaaaa	FALSE
dmakhnkdaaa	FALSE
dmbikchabab	FALSE
eiehphaiaaa	FALSE
eifldgeaaaa	FALSE
fbnkdpoabab	FALSE
fbpmbalalaa	FALSE
fkmjjafanaa	FALSE
fkmlcefabab	FALSE
gemilplabab	FALSE
gemmijlaaaa	FALSE
gogpebeabab	FALSE
gohpfigaaaa	FALSE
hijpfcfabab	FALSE
hikbcodabab	FALSE
idiihedaaaa	FALSE
idijpecaaaa	FALSE
ioadnmombab	FALSE
ioaoealigaa	FALSE
jjaclmdjaaa	FALSE
jjaenhahfaa	FALSE
kcmdeeeaaaa	FALSE
kcmfmejaaaa	FALSE
knmgjidabab	FALSE
knnefkeabab	FALSE
lgjabjjipab	FALSE
lgjfcalcbab	FALSE
mafnbefgeab	FALSE
maicnbpjfab	FALSE
mmclgcpabab	FALSE
mmcobjhabab	FALSE
nhbjdbgaaaa	FALSE
nhblhlpabab	FALSE
obhlnaodbab	FALSE
objmknoaaaa	FALSE
oljmoecabab	FALSE
olkaklhhbab	FALSE
pejdnojabab	FALSE
pejejikaaaa	FALSE
aabinmenfhhf	TRUE
aadfaakgebab	TRUE
ajnnbokmgkea	TRUE
akaamcfkjmon	TRUE
becndjegiilf	TRUE
beefchfeakml	TRUE
boopcibjlkin	TRUE
bopapncklccg	TRUE
cibldnnkgbjb	TRUE
cibllcjahgjn	TRUE
dcaemdemeijm	TRUE
dcahkjlfhgae	TRUE
dmkhbafcopfn	TRUE
dmkkhhcmgkkl	TRUE
eicmgdpaphee	TRUE
eidhnfjfnjbo	TRUE
fcgimfomobde	TRUE
fcgnlalejajk	TRUE
flgjdolcgpjm	TRUE
flhmihebcaoe	TRUE
gejmhbbimlkk	TRUE
gekapfbcmfjc	TRUE
gokeijenkbfn	TRUE
goklimfcipam	TRUE
hihgndfbgcdj	TRUE
hiijggmhfjib	TRUE
ichndcekgnfk	TRUE
ichnonchbbpb	TRUE
innkmiagnedi	TRUE
innllldmbeng	TRUE
jimijmjkblng	TRUE
jinbapaeakoi	TRUE
kcomompphkii	TRUE
kdakjdbnfaio	TRUE
kngegcjklndg	TRUE
kngobdfmbjpd	TRUE
lgjgpkdegifd	TRUE
lgjojmgnnenk	TRUE
malkkajoklcf	TRUE
malpboakpnhh	TRUE
mmkgmjljfjcl	TRUE
mmlgnbgaebjc	TRUE
nglkdmiaepan	TRUE
ngmfpfddmplg	TRUE
obcgcpkmgemm	TRUE
obcnibnmlooh	TRUE
olchedmddacf	TRUE
oldniebflpcj	TRUE
pfjhmpgnallf	TRUE
pfleihjhfmgk	TRUE
aaadlmnaobba	FALSE
aaakiapgbpan	FALSE
ajgldbecpjab	FALSE
ajhcpbgbmfab	FALSE
bekdnockabab	FALSE
beklbmkhaaaa	FALSE
bojgnlipabab	FALSE
bojmlohdaaaa	FALSE
cjbohmhiaaaa	FALSE
cjcbjhkdaaaa	FALSE
ddkgignhaaaa	FALSE
ddkonhmhaaaa	FALSE
dnjefpdiaaaa	FALSE
dnkgjomajaaa	FALSE
ehkkgcfhaaaa	FALSE
ehkpcjklaaaa	FALSE
fbmkcgjmaaaa	FALSE
fbndjhpmaaaa	FALSE
fminonbiaaaa	FALSE
fmjniolambab	FALSE
ggmmhaddpaaa	FALSE
ggoecpolabab	FALSE
hbgcjeenabab	FALSE
hbhkmclcabab	FALSE
hmcdncogabab	FALSE
hmcgcefiabab	FALSE
igflohebabab	FALSE
igfpgdnkabab	FALSE
jakmdihhcbab	FALSE
jaknmakjfdaa	FALSE
jkhcgphoaaaa	FALSE
jkhhckipabab	FALSE
keahlkhncbab	FALSE
kealpmhapoaa	FALSE
knmchnjnaaaa	FALSE
knmeoldmabab	FALSE
lhdenmeoaaaa	FALSE
lhefimjmaaaa	FALSE
mbogonapaaoa	FALSE
mbppbjjaebab	FALSE
mmhbgiahbaaa	FALSE
mmibccnlabab	FALSE
nhecebhnabab	FALSE
nhegfkblaaaa	FALSE
objmgobeabab	FALSE
obkofeljabab	FALSE
olnmgbdiaaaa	FALSE
oloabjlflbab	FALSE
pfpamdokjbab	FALSE
pfpdckloabab	FALSE
aaadlmnaobbab	TRUE
aaakaiapgbpab	TRUE
ajbnoidhfdmhk	TRUE
ajcbgbknaamne	TRUE
beijkklmaafok	TRUE
beilocnbjpkfh	TRUE
bomkdcoffpajh	TRUE
bommmlmfoekap	TRUE
cimkaemjkpgmi	TRUE
cimlpdgeidala	TRUE
ddicpgoiodibd	TRUE
ddingefonkonb	TRUE
dngkakknaipid	TRUE
dngohcaanailh	TRUE
eihdclhmoelnn	TRUE
eihflbkmigoje	TRUE
fbnoehlcaeaap	TRUE
fcaipmjcneeom	TRUE
fmbdpdiihphlm	TRUE
fmdfghmldafja	TRUE
gghbljbnhdfij	TRUE
gghdjiljfocki	TRUE
hbfgpnhoojegf	TRUE
hbikocgbkokbk	TRUE
hmicflnablhfk	TRUE
hmiepnmkmnggm	TRUE
ihdfedfhpojbm	TRUE
ihekopcbnchjp	TRUE
jaipnhbmgemco	TRUE
jajhefhaefadj	TRUE
jklgoihfnjpki	TRUE
jklibdbpieflf	TRUE
kedcfilebadhl	TRUE
kedegjjfjkocc	TRUE
kocbcmmlpbjkj	TRUE
kocjlfolacobp	TRUE
lhgokficjfhbe	TRUE
lhhamodkhijnn	TRUE
mbhnddhlniili	TRUE
mbhpbjfdnefhi	TRUE
mmgkoknodkkje	TRUE
mmhcbnjhkeakf	TRUE
ngjmdffmmiamd	TRUE
ngjmhndkichon	TRUE
obpcaekjbgmke	TRUE
ocaejhnmlidpg	TRUE
ombbkinpcljni	TRUE
ombebnaldckpp	TRUE
pffpndoekdgcj	TRUE
pfghhajpnmlbf	TRUE
aadkcfhnemfaa	FALSE
aaeememojjkaa	FALSE
akgpojmkagdaa	FALSE
akhdfgokeibab	FALSE
behibcgcdaaaa	FALSE
behjabmemkjab	FALSE
bpnkjlpopaaaa	FALSE
bpnlafjjdkbab	FALSE
ckgolfopiabab	FALSE
ckgpiepikaaaa	FALSE
demkpcbcgabab	FALSE
demnofkmhaaaa	FALSE
donkmembnabab	FALSE
doojdcchcaaaa	FALSE
ehlnfgaccnaaa	FALSE
ehmoadglaijaa	FALSE
fcegghpkoaaaa	FALSE
fceoohbmcaaaa	FALSE
fmdcdhclkabab	FALSE
fmdnkgaibclab	FALSE
ggnilelhbaaaa	FALSE
ggohaboaofmdb	FALSE
hbljdjaanbpaa	FALSE
hbmclenngaaaa	FALSE
hlnofciigabab	FALSE
hloecnfopabab	FALSE
igbclhjgbabab	FALSE
igdieofpcaaaa	FALSE
iplbcgmnlabab	FALSE
iplbeoahnlbab	FALSE
jjflbaopioaaa	FALSE
jjgcfifogaaaa	FALSE
kdahmjmgpdbab	FALSE
kdapkchghbkab	FALSE
knfjgdcfhabab	FALSE
knhhjijahebab	FALSE
lhbagclgghaaa	FALSE
lhbcicdemabab	FALSE
mbacglmhihaaa	FALSE
mbajaoinkbdaa	FALSE
mkhoielglaaaa	FALSE
mkilgfjoabjab	FALSE
ngchaklfapfaa	FALSE
ngcikpcldabab	FALSE
obbpheckjabab	FALSE
obcncdgplaaaa	FALSE
oljiamdkhhbab	FALSE
olmpdfnbnabab	FALSE
pgchaogfobpab	FALSE
pgcoonoagfaaa	FALSE
aadkcfhnemfefm	TRUE
aaeeojjkcaabab	TRUE
akenkfbkmmhdmm	TRUE
akeoldffkgkkpj	TRUE
bekkfdncgdcbck	TRUE
belognpbhcfpmj	TRUE
bpkllbeikclcko	TRUE
bplbhnaailhokl	TRUE
clehddikocljbp	TRUE
clfnmpokifdfhg	TRUE
dfbjamfphammfo	TRUE
dfdeejbdkcbkpp	TRUE
dokdmpclomfcoc	TRUE
doklcjaomeflla	TRUE
eiglcfhihmfeoi	TRUE
eihijadfkliigp	TRUE
fckhmjgapncaib	TRUE
fcmggebjogolpa	TRUE
fmianbfeodcnii	TRUE
fmiiognnejfehm	TRUE
ghglopfadimpdo	TRUE
ghieckgbbgbfoc	TRUE
hbmocdmfcokcmo	TRUE
hbmoiljjipecfp	TRUE
hlcadjikbhhmjf	TRUE
hlcifpalglkppc	TRUE
igfojcaappjela	TRUE
iggjgmfjfmdlfj	TRUE
ipikhipfamkioh	TRUE
ipjfmbflijpgdj	TRUE
jkndlgaiejdnmn	TRUE
jknpaoebfbjgll	TRUE
kdenjeioflaokb	TRUE
kdeonmkbemgohc	TRUE
knghgfkilojjjn	TRUE
knhbijcfkjligk	TRUE
lhgfpfncbgjjej	TRUE
lhgmlpjbgbjdpb	TRUE
mapicmbpjoljmn	TRUE
mbabojdinjlamn	TRUE
mlffbfcpaohoob	TRUE
mlfkkkjgocnlai	TRUE
ngehlnadaffojo	TRUE
ngffgbjnhopomb	TRUE
ocancbongpeiji	TRUE
ocddbgbagllpfn	TRUE
omfgodnjhnbfpf	TRUE
omfifcmmiikpdh	TRUE
pfnbfmcjjdbhdp	TRUE
pfnbjjofjakcca	TRUE
aaaebpganeojcn	FALSE
aaafogpbhncgfa	FALSE
ajpjjdijbjacpb	FALSE
akbchcdjjmaghb	FALSE
bebedhbgjoaaaa	FALSE
bedcjdopegaaaa	FALSE
boeloneamloaaa	FALSE
boemkanaibhanb	FALSE
chlkmpocdiabab	FALSE
chnmkinpmnaaaa	FALSE
dbnhgcbfgdaaaa	FALSE
dbodfchhbpabab	FALSE
dlpbgfcembabab	FALSE
dlpbpdlnifaaaa	FALSE
eelnoakpgliaaa	FALSE
eencglfpgeabab	FALSE
eoejddgecnabab	FALSE
eoekbpdmheabab	FALSE
fhmjkcmlecaaaa	FALSE
fhmlcnhafggaaa	FALSE
gcfdoncdnbaaaa	FALSE
gcgjalbcpfgeab	FALSE
gmlkdgcjodaaaa	FALSE
gmmjbdhhamlaaa	FALSE
hjclobkpjlaaaa	FALSE
hjdkmpjemiabab	FALSE
iefppoaclkpbab	FALSE
iegnddiaapakba	FALSE
iombfffahgblab	FALSE
iooonajhefkbab	FALSE
jjnhamojheibab	FALSE
jjnhpedncnabab	FALSE
kfdgclenbeabab	FALSE
kffhgjjpglabab	FALSE
koeihcodgpaaaa	FALSE
koelbheoigaaaa	FALSE
lioamfddagkana	FALSE
liojjmbkabgbab	FALSE
mbnniidhjagbab	FALSE
mbobmhilfeaaaa	FALSE
mmjgkiidicaaaa	FALSE
mmlmbcbnjkaaaa	FALSE
ngndbcafiipbab	FALSE
ngnnncbpmlabab	FALSE
oakdkphmjmkbab	FALSE
oaldpgbnchllab	FALSE
okpgdickndaaaa	FALSE
okpignoeieabab	FALSE
pfdgjppedlaaaa	FALSE
pfebalnamojmaa	FALSE
aaaebpgamdpnibm	TRUE
aaafogpbhncgfem	TRUE
ajneemblifgfklc	TRUE
akaedojbbhjondo	TRUE
bdoefljdcbbhfdd	TRUE
bdogehjknlpincl	TRUE
bndeodoknikflpl	TRUE
bnfaafmelfaabab	TRUE
cgkdkkkcalmhfig	TRUE
cglcooaobfijmfp	TRUE
dbhlnlogadnmjcn	TRUE
dbjflhgobbefcof	TRUE
dljjdkkkedajkep	TRUE
dlkjadhahbadclh	TRUE
efmflchdofaljej	TRUE
efnefkclmkchgfo	TRUE
eogjlflnobhoici	TRUE
eohblhigejpplld	TRUE
fichpledlcabkfc	TRUE
fidabdkpjkiiigb	TRUE
gchdeibpbgigiip	TRUE
gcheajnhkjaflml	TRUE
gnkfolcblebjohl	TRUE
gnklegokighnjmn	TRUE
himodbneaibnnba	TRUE
hinbpbjamgfddch	TRUE
iegjklfkpnllfkf	TRUE
ieicnijeiianggf	TRUE
ipcaijcboahighh	TRUE
ipcglcodlbjecbm	TRUE
jknhcgacamobhhd	TRUE
jkninljbekakgcl	TRUE
keefejfibcnomhj	TRUE
kefnnooagakcbjg	TRUE
knigmeiaelicgmc	TRUE
knjcfjkkaejdhob	TRUE
lhmfhmimbbkeefb	TRUE
lhngaddnajlgogm	TRUE
mcegohhaaiikjgg	TRUE
mcfllhoiapnljjj	TRUE
mmheinpidehpjcg	TRUE
mmiegfhfpafaabl	TRUE
ngfchnclodpakec	TRUE
nggbiglkddljlhl	TRUE
oalcpgipcdalfhf	TRUE
oalejlpkkjmdmbb	TRUE
okigkglhbabgbem	TRUE
okmlonhaciadkif	TRUE
pfdohcpfgklmlii	TRUE
pfebhmcnneobchk	TRUE
aaakpgeclhdecla	FALSE
aaamjgdecldjmma	FALSE
ajponfmgohnpaaa	FALSE
ajpplmebakacgdb	FALSE
beeoccekeeagbab	FALSE
befnemcjgebabab	FALSE
bnmbohmmdljabab	FALSE
bnmbpccdegiabab	FALSE
chkibgppakfpaaa	FALSE
chlabnfobimobab	FALSE
dbglncbhmhdabab	FALSE
dbhhgiggbfgaaaa	FALSE
dlbedfpghilabab	FALSE
dlbidapaldipdaa	FALSE
eegmpefofhjabab	FALSE
eehmbngkmaamkaa	FALSE
emphemklalnamaa	FALSE
enanpoljgoeoaaa	FALSE
fgnfhbcmhgjaaaa	FALSE
fgomjphnnlnabab	FALSE
gcbcflgdlbbabab	FALSE
gcbkkcgmppgaaaa	FALSE
gnkkonhjfmmaaaa	FALSE
gnliaaicpjpckaa	FALSE
hilogccopooabab	FALSE
himmpjahggfdbab	FALSE
icnjcblgpgiabab	FALSE
icoianjokoachaa	FALSE
inbekbgmikbabab	FALSE
inbnhkabobgdiab	FALSE
jifbmhgnnmgaaaa	FALSE
jifmcoanjggamaa	FALSE
kdogdfljnmbaaaa	FALSE
kdoplnfhpnnabab	FALSE
knojgjihbphaaaa	FALSE
knonpefhbciaaaa	FALSE
lilkjmdkifafaaa	FALSE
limdfpcjnokaaaa	FALSE
mcnklgfidgfabab	FALSE
mcoajdfjahkkgaa	FALSE
mmollhmcdlnabab	FALSE
mmplcghpljnaaaa	FALSE
nhokfimjjklabab	FALSE
nhooddpcnmiabab	FALSE
obohgmpcgniabab	FALSE
oboiiehgmjeaaaa	FALSE
omhnmoogchiabab	FALSE
omhokjnfgfjabab	FALSE
pgljdjddjibabab	FALSE
pglnaialjldjgaa	FALSE
aaakpgeclhdecmkh	TRUE
aaamdecldjmmnbmi	TRUE
ajpbcfhccooppeme	TRUE
ajpnpmjfdifpcpjj	TRUE
bekpdffcmncoknkj	TRUE
beldndjgjgecaihg	TRUE
bodbpnbafhjdekle	TRUE
boejigbkkioajhoi	TRUE
chlpnjcdnabbnhed	TRUE
chmdnbnfipfbenhi	TRUE
dbfidbgopgoncplp	TRUE
dbggbaafaikiobpe	TRUE
dldlgdpghlefdema	TRUE
dleaaofofklenjjh	TRUE
eejjhlfkiendgnah	TRUE
eeklendnnpcenmja	TRUE
enffbabfkkmhmhno	TRUE
engadanjlbegecfh	TRUE
fhadnaghaacpibab	TRUE
fhbelmodecjddjah	TRUE
gcdangmjcihfcdlb	TRUE
gcenkpnpjaldangg	TRUE
gobfejoafomodlaj	TRUE
gocabngdkjpppikg	TRUE
hilgmcggocjldhac	TRUE
himakfnioameejab	TRUE
idilhgcgfnbgjkaa	TRUE
idipjlkgcfbpjond	TRUE
ingdolmnheedncdn	TRUE
inhimlaikilaikcd	TRUE
jhonopajpdkigjoa	TRUE
jiagmnnlipnefmmc	TRUE
kcpfjcbglgcnjaif	TRUE
kcpicncbbkfpnjoa	TRUE
knhoonjbncleomjb	TRUE
kniohncohodednid	TRUE
lhpfjmomdhgfjfkb	TRUE
liacpampphfgiaie	TRUE
mcfgamfihegnbbcp	TRUE
mcgcdhapgakpemba	TRUE
mnmfambiachhlife	TRUE
mnmjijdoenljbnji	TRUE
nicpkfabnjfegpkl	TRUE
niepfiamebhmelgp	TRUE
ocgpkejneahmpphl	TRUE
ocidfnnaligfdojn	TRUE
olpfdohpbhmeggkm	TRUE
olpiiaoihonldkaa	TRUE
pgedgnidjbneikdc	TRUE
pgfppmkihkbbcifa	TRUE
aabccdbbojmfcmab	FALSE
aacbbibjndfimbab	FALSE
akfgljbnknhonmab	FALSE
akfhnlblpcgnejab	FALSE
benlaldhmhanniaa	FALSE
beohnmffmgfpaaaa	FALSE
boopjkiabpmihdab	FALSE
bophgcofemgiabab	FALSE
cjebohmnogkgabab	FALSE
cjedikmlomhoaaaa	FALSE
ddebdeaoooamocaa	FALSE
ddeipolaaiioiafa	FALSE
dodabjfhhkeoldab	FALSE
dodnhkdililjaaaa	FALSE
einifcfigaabdhab	FALSE
einjeajnhldjgaaa	FALSE
fdjmfeoliclcaaaa	FALSE
fdjockpndbofabab	FALSE
fnmgcocecopnaaaa	FALSE
fnmkphgoaocbpcab	FALSE
ghkpmeojajghibab	FALSE
ghlchhmgfplkabab	FALSE
hbemofphbfcfabab	FALSE
hbffmkjacdfmkbab	FALSE
hlcljnffkongabab	FALSE
hldlljfbphjpaaaa	FALSE
ifalddhmoddofaaa	FALSE
ifalhiojpjmddbab	FALSE
iokcbniabphnpnab	FALSE
iokefekcadidmbab	FALSE
jjddfhadmbinhjab	FALSE
jjdokheajjlljbab	FALSE
kdbifhdfkljjaaaa	FALSE
kdcaijbmaenalgcb	FALSE
knkokcnkngebaaaa	FALSE
knlaibddmnhganlb	FALSE
liafaofgdaaljdgb	FALSE
libnjfiiibbmaaaa	FALSE
mckkgnajcnfajeaa	FALSE
mcknfhbebjkiaaaa	FALSE
mnflmdmcjikfaaaa	FALSE
mnhliljdaglpbjab	FALSE
nhfgngmjceaagaoa	FALSE
nhgflfndagjkdbab	FALSE
obgbfgmgachjcbab	FALSE
obgbnahkeghjobab	FALSE
ombfcpbnihgagaaa	FALSE
omcfjcghagndiaaa	FALSE
pgeifmjcjmakiaaa	FALSE
pgeneeedifcbaaaa	FALSE
aabobbnampclkllje	TRUE
aacbppebcaencbgna	TRUE
akfkakbnibebocdik	TRUE
akianmdjolaohdljh	TRUE
bfcbajdppnkjicklj	TRUE
bfcofdlkjdiklkphe	TRUE
bpapggdajmkhpodlf	TRUE
bpbkagdgffacmhbik	TRUE
cjhpjklllfbdmkedc	TRUE
cjjplbkhijejjjojn	TRUE
decbfhjjcfolcfnjc	TRUE
deceillhnfcdidhaj	TRUE
dnmgdjmjecfjmiodb	TRUE
dnmhnbopdglpgfmla	TRUE
eihpdnndfdkfogloc	TRUE
eiieakecfoobaibaa	TRUE
fcgcgacdkmhmlooie	TRUE
fcggnccbhcdflkami	TRUE
fmodgojclnegokbmk	TRUE
fmpakhnacgcpapicf	TRUE
ggngocdjnfflonigc	TRUE
ggnhhcmgcmcehdmfh	TRUE
habhafeboifgllcaa	TRUE
habldfhnkgnpggkjc	TRUE
hkhcnfjbipfbfmkob	TRUE
hkhdbgfjbmiekpnog	TRUE
iefbmmabjgegnnmjj	TRUE
iefjhibipndjfbgli	TRUE
ioablohapjekgaklh	TRUE
ioachpbfpflegnbkc	TRUE
jhklgaklfkcpiofdi	TRUE
jhknlhipigolahlpd	TRUE
kdadpddnanopedeie	TRUE
kdakidgfcjlfbicko	TRUE
kofehhnmblifinfkb	TRUE
kofjofaljcfcjooah	TRUE
ljecgaeojnfagppml	TRUE
ljhggemnkjplkaklo	TRUE
mdgcjllglnijmlnfd	TRUE
mdilblinmkgchfgpk	TRUE
mlockckbmcfkeghpp	TRUE
mlocofmnibjjbpnca	TRUE
nfiidcfnjbdkcebof	TRUE
nfkahcalmopelakmc	TRUE
nphobeambaejhphnp	TRUE
npibikhodpckefdaa	TRUE
okbfciooeeikckmkd	TRUE
okbhdnhfdaebgpafa	TRUE
pfembiehakdpinelh	TRUE
pfgpnbhmhjihkolaf	TRUE
aabobbnampclkllja	FALSE
aacbppebcaencbhoh	FALSE
akkgcheneklomgbab	FALSE
akljpdpgbbejhpoab	FALSE
bedjpdoeiifbagaaa	FALSE
bednjkmmljjhoaaaa	FALSE
bnpbonclplhndaaaa	FALSE
bnpkjgieondjeaaaa	FALSE
cjmhhillamjnbakcb	FALSE
cjmjagfmkoodbcfab	FALSE
dfacegcofnbgjddab	FALSE
dfahngecnhiopakaa	FALSE
dohhadichggmdbagb	FALSE
dohhoeednoeffaaaa	FALSE
eiifgfnghiclmabab	FALSE
eiipfjeaecohcmbab	FALSE
fcgckkekflpinaaaa	FALSE
fcjajbkfaolkbfeje	FALSE
fmoojbibhcdneabab	FALSE
fmpjjokdapcddnbab	FALSE
gfnakoonoihiadmaa	FALSE
gfnimaaphlcpnkkaa	FALSE
hacldgkldnaomleaa	FALSE
hacljmfehhibbgeab	FALSE
hklcaihbdcbgpefab	FALSE
hkmelongnddeoaaaa	FALSE
ieelhehlddekbaaaa	FALSE
ieemlekhnjakecbab	FALSE
ioaidpmceacceliaa	FALSE
iobihgfffedkjaaaa	FALSE
jinimahigmngfcaaa	FALSE
jinngjnjmdhjiabab	FALSE
kdbdabbeiplnleiab	FALSE
kdbjaomkkfknodbab	FALSE
knjgibhkgncpdabab	FALSE
knjpdjcnjapnjfaaa	FALSE
lifbemkojgocoaaaa	FALSE
lifkkpnpolhggabab	FALSE
mdaoeelcgplkdbdab	FALSE
mdbajdamhkgiocana	FALSE
mmbcnomlcokajmaaa	FALSE
mmbjimhlachpiacaa	FALSE
nfllbfefcbaahmlaa	FALSE
nfmcdeemcjlelabab	FALSE
npfebmjfamlglebab	FALSE
npgljkafbmpgmdiab	FALSE
okcjgdhkmmhdnabab	FALSE
okcmdlofpohgjabab	FALSE
pfibkmabciiimeoab	FALSE
pfifmnefceobkabab	FALSE
aabbhmdfonejnmjnba	TRUE
aabiohnfgngojjhgpk	TRUE
aklmnhcnhnfciadadi	TRUE
aklpdoalfmgjaafbab	TRUE
bgcbdafnaabpimamcb	TRUE
bgflpjknjkfcnkpkee	TRUE
cakfiljijkacjbpbhj	TRUE
cakhacddkcldfahknf	TRUE
cjdblncbodfiobcbfh	TRUE
cjedldklkiangoheep	TRUE
ddlaecmhiiniooddhp	TRUE
ddllinmkgedflidimj	TRUE
dnjkhidpjgdlalglei	TRUE
dnjmdldgmooaldiakj	TRUE
eibhikachhdhbocked	TRUE
eibhmllphalnchflkj	TRUE
fckgecchkglmfjeglo	TRUE
fclipgdngiiancjaji	TRUE
fnifldkdoldgpfgnop	TRUE
fnikbdchgcmjifonoe	TRUE
ggnaoonbfilcegpmmm	TRUE
ggnijfmjodgahlgdia	TRUE
hbiaiblofomaphdidd	TRUE
hbimibeeejkdgelljp	TRUE
hlinfbdijhgmfahpme	TRUE
hljcmhdmhccoflknlm	TRUE
ielpkinaapbafmcppg	TRUE
iembdnidmjcppbmlke	TRUE
ioocjdidaokboihebg	TRUE
iopialjgfamhomhjjd	TRUE
jihofpmmimdbpbbnad	TRUE
jiikbebhhnihdncfhg	TRUE
kdcffngmkcmjfmkonn	TRUE
kdcklnpbmjedomigci	TRUE
knhcjbnkghlfkhcndg	TRUE
knhjalamffociknimo	TRUE
lhklgnploopomomopg	TRUE
lhmcmnkhlhhpdgcpbj	TRUE
mcdkgdegpedngadbec	TRUE
mcdpidmipmejdaniai	TRUE
mnekhlghpmdclnmndb	TRUE
mnfdgihahjmnbgllbl	TRUE
nhgempmbdbcnbokbgn	TRUE
nhglipakkhoffkgenc	TRUE
obkgapkaieakjnmgbh	TRUE
obkmpoeejnbbjbcchd	TRUE
olefampjfmkcgfadil	TRUE
olekgikjcblloehiga	TRUE
pfoiikdamaadnambab	TRUE
pfoknikdlohilecdbc	TRUE
aaakfecpjfjignllna	FALSE
aadpmfnbpgcaaocano	FALSE
ajnodkbehgjaebjpbg	FALSE
ajnpliompnlnhchbab	FALSE
beelpfimnphhheabab	FALSE
beepbplfdhbalphaaa	FALSE
bocgmfoakglkehkaaa	FALSE
boclaehlliknjjhbab	FALSE
cilppjfjjbkibbaaaa	FALSE
cinjpiegaihkjinaaa	FALSE
ddmdjicpapflmjbeab	FALSE
ddnpejafhfmifkjbab	FALSE
docccephflepihabab	FALSE
dohkhhagkelmmpjaaa	FALSE
ekadeggbfnoidhjoab	FALSE
ekaemlnlnmdjgelbab	FALSE
fepjmhfainimfpfaaa	FALSE
ffadlicdpjelpoaeaa	FALSE
fohdihfmhmgcbdaaaa	FALSE
fohdkiahmfijkfeaaa	FALSE
gicgohkboandfmfaaa	FALSE
gidknccdocjeblaaaa	FALSE
hbhlmjmngccaeamjaa	FALSE
hbiblpdjbdjpadkbab	FALSE
hkpcphpobaiihmcaaa	FALSE
hkpiioohdjikfhaaaa	FALSE
iejaagggnpeffcbbab	FALSE
iemkdpjnkbpbdgaaaa	FALSE
ipehfghepicbepaaaa	FALSE
ipepomondenopapaaa	FALSE
jjiiglplidelfhaaaa	FALSE
jjmapaapnfbmmeklai	FALSE
keboiagiddfcelhaaa	FALSE
kechgfninhinamibab	FALSE
kpcidachekhcfjnbab	FALSE
kpcipkghkkknpfaaaa	FALSE
ljeceeflgajphfbcab	FALSE
ljepaekkjgedkobjab	FALSE
mdigcflioeiijcaaaa	FALSE
mdiiiafhiiheleibab	FALSE
mnlkcbanigohkefaaa	FALSE
mnmjobphngiekoabab	FALSE
niijkcihcdinlnaaaa	FALSE
nijfknaanefofpddaa	FALSE
ocenefhagjkelhmaaa	FALSE
oceolgdfcmofidaaaa	FALSE
omaimppelnocaagmla	FALSE
omcepllnahmglflbab	FALSE
phdjdmggcalakfmlaa	FALSE
phdjmmlddjnomiabab	FALSE
aaadhpneddhigndpolo	TRUE
aaahlijadofoieigbab	TRUE
aknjonpkndpmgmljgae	TRUE
akohidpmfffbggjeonl	TRUE
beonbkedcaoficgkicb	TRUE
beopafcnjejboagejie	TRUE
bpboianbnhocghodkji	TRUE
bpdjcjenkkcdjkfcfjj	TRUE
ckcgppehefbbmkoaibp	TRUE
ckeaejcdkgpblpokjbb	TRUE
degfnfagaknfdhegbln	TRUE
dehabfnmedjnbbnjdli	TRUE
dnhgaddmoddbfbgdlme	TRUE
dnhiifbipmfbllfgdip	TRUE
ehkbeiggmapdkjfeokj	TRUE
ehkcieihplegneloigb	TRUE
fbaenceajljnhelkjap	TRUE
fbaifidodmpppemnjfj	TRUE
fkofgcokgocflnooefo	TRUE
fkohmhaiofjoepalpka	TRUE
gfkllgmaokekfccdjhd	TRUE
gfmgkicocikbgpeolfd	TRUE
hahfjlllpoolemeohao	TRUE
hahhlamblicgigocccp	TRUE
hkgekhhnfghaccdkpma	TRUE
hkghicegggmklalfcol	TRUE
idhfebjakfpikbbhgba	TRUE
idhncpoegcfobpjabhd	TRUE
injnifmonkicfiondml	TRUE
inkcljoapeffnbcknih	TRUE
jhocebbikjlnphmcndo	TRUE
jhohijdmggilkkoklim	TRUE
kcceidbmidcdigknngd	TRUE
kcddnihojefmppcgbak	TRUE
kmbfecmpfglcegcipcm	TRUE
kmblmbaaolapbmbndin	TRUE
lggeaiglgcdkidgcbma	TRUE
lghjcehghfkgcppjcgk	TRUE
mbbhbdjofpogcbmkina	TRUE
mbclekbiecppfggikni	TRUE
mlkficfibhjmllfecmj	TRUE
mlkhhpakioiokomiajh	TRUE
nhaejjofopnfpjklibe	TRUE
nhafnkfbmbofimnkojg	TRUE
obljliikmcenobcglgp	TRUE
obnkmgnanjehbeemikm	TRUE
omadhlghanaplebnnee	TRUE
ombfehhkbnacppfbclp	TRUE
pgbonechefnnlamikpi	TRUE
pgcgcbhojfmpgjecpcn	TRUE
aaadhpneddhigndpnka	FALSE
aaahnlijadofoieighl	FALSE
aknkeaigfabjfgajmpe	FALSE
akpablaeocjkjlnpmbp	FALSE
bfahggnlbcbloaacgeb	FALSE
bfcjoojfenjapfcblab	FALSE
bpldlhedcjcbcobabab	FALSE
bplhkjnmdfemnlbabab	FALSE
cjapdabolpfpkggnmaa	FALSE
cjcpddbeffeblpadbab	FALSE
defjkpfghffdnjiabab	FALSE
degbakfnmilianfepaa	FALSE
dnhaochmabkmgcmdiab	FALSE
dnhocgcgnklaiacnhaa	FALSE
ehfkmkbglclajgbegab	FALSE
ehfodbjcbcefoccaaaa	FALSE
fblcaojoekglhibnbab	FALSE
fbldbnfpjchgekcaaaa	FALSE
flfkdmdnjeikpkaoaaa	FALSE
flfkebikkclfmmapbab	FALSE
gflbpihaaaljkejnbfa	FALSE
gfncocmeflmhpnnaaaa	FALSE
hacckpgkheolojlnaaa	FALSE
hadjmejpchngfpfcbab	FALSE
hjgpcgcefhoboijabab	FALSE
hjiocjgmpoligocabab	FALSE
idgbpnnjhbemeelaaaa	FALSE
idjlcelmjoolgemaaaa	FALSE
inblkbgnimigeibaaaa	FALSE
indldpplgbngfpjabab	FALSE
jhemobllcnbakdfeaaa	FALSE
jhgbgcahmnnanmbnlaa	FALSE
kccgbbaemhkmdopbbab	FALSE
kcemcdckacbjhbeekab	FALSE
kmpepmlgobalfemanaa	FALSE
kmppnhhlcccggakpaaa	FALSE
lgokkbdjajddgpacpaa	FALSE
lhanjfbgidfaecockdb	FALSE
mbekdeheoeacjlhfbab	FALSE
mbfbekmfecbplfbabab	FALSE
mlchlkblajfieclpaaa	FALSE
mldepdobhimiiioabab	FALSE
ngibgcehmjbkjciaaaa	FALSE
ngikjckoknnbigcabab	FALSE
objhcbkiokcodebabab	FALSE
obkphgannicbcckelab	FALSE
omlhnkebbgehabnelab	FALSE
omlkjdnbmlpbnnnaaaa	FALSE
pfhlhclobcldmmpaaaa	FALSE
pfikndakhnepacamdca	FALSE
