aaaekbocdp	TRUE
aaahbmpglk	TRUE
ainkalpnfa	TRUE
ainnklnkch	TRUE
bdchnhdjjf	TRUE
bdcmeeicpk	TRUE
bnhghdmnhc	TRUE
bnjlojiofl	TRUE
chmhdjcnpd	TRUE
chmihmdank	TRUE
dcihlolaga	TRUE
dcioabkgil	TRUE
dlhmcnmijj	TRUE
dlhnpjkkhc	TRUE
efeacknhpg	TRUE
efegpjbmaa	TRUE
facigfggla	TRUE
facnndmpkj	TRUE
fkkjclehgj	TRUE
fkkmkhpimf	TRUE
geiglaibng	TRUE
gejmbgfpml	TRUE
gomnofplhe	TRUE
gonepmcaaj	TRUE
hjfdhpjnbh	TRUE
hjfomfolme	TRUE
icjmlaagia	TRUE
ickhmmpaoc	TRUE
imjdnialja	TRUE
imjglpofdj	TRUE
jhfhbaoogp	TRUE
jhfjndegip	TRUE
kbibghdfkg	TRUE
kbifdonhho	TRUE
kmbjcfhehg	TRUE
kmbjpohbgh	TRUE
lgpmfmlnfe	TRUE
lhdbdaadan	TRUE
mdfhcahkmb	TRUE
mdialcbdol	TRUE
moaiafpmjo	TRUE
mocehammif	TRUE
niinibelkb	TRUE
niipmdfepo	TRUE
ocjmgdpkpe	TRUE
ocjmlpjmcp	TRUE
onbnpgihpl	TRUE
onccnekmma	TRUE
pgejcamklg	TRUE
pgflbjmjla	TRUE
aaaekboabc	FALSE
aaahcdpabc	FALSE
ainpfmfabc	FALSE
aiobelfabc	FALSE
bddbdmpabc	FALSE
bddkmccabc	FALSE
bngkgobabc	FALSE
bnhlgjoabc	FALSE
cibhpceabc	FALSE
cibiojgabc	FALSE
dcjmibkabc	FALSE
dcjmndmabc	FALSE
dlkpkkmabc	FALSE
dlmkghmabc	FALSE
efflcohabc	FALSE
effmeglabc	FALSE
faaobieabc	FALSE
facbeojabc	FALSE
fkkenjfabc	FALSE
fkleiehabc	FALSE
geacclcabc	FALSE
gedhcmcabc	FALSE
gojfdpabcd	FALSE
gojnlmkabc	FALSE
hinnbbkabc	FALSE
hiofiamabc	FALSE
ichjohdabc	FALSE
icjajniabc	FALSE
inccjknabc	FALSE
indcdkmabc	FALSE
jhdhbgmabc	FALSE
jhdheglabc	FALSE
kbjgcgoabc	FALSE
kblaibmabc	FALSE
kmdfegfabc	FALSE
kmelgfnabc	FALSE
lhcpecoabc	FALSE
lhejbciabc	FALSE
mdgligabce	FALSE
mdgmndlabc	FALSE
mnpghmabck	FALSE
mnpibnmabc	FALSE
nichjflabc	FALSE
niegfjcabc	FALSE
odejmjpabc	FALSE
odfeaeeabc	FALSE
onigfkabcd	FALSE
onihaidabc	FALSE
pgjhfpcabc	FALSE
pgkggbcabc	FALSE
aaamaknlklg	TRUE
aaaokpmfhfc	TRUE
ajacoggckkl	TRUE
ajbgnkeloee	TRUE
bbpcmjchjlb	TRUE
bbpdnkenhha	TRUE
bmcehmhlmch	TRUE
bmcllcmcige	TRUE
cgngcpbfmfc	TRUE
cgocglnefpj	TRUE
daipgaamibj	TRUE
dajlelpafhi	TRUE
dmgmdfpdplb	TRUE
dmhenipdjnp	TRUE
egfemdbcgaf	TRUE
eggcnkkmncm	TRUE
facnpmbeabd	TRUE
fafgmjcbcoe	TRUE
fkhggkdpchj	TRUE
fkicaajmcol	TRUE
geihooaclid	TRUE
geijeelhkab	TRUE
gpfdobllfha	TRUE
gpfeflkgjap	TRUE
hkhnilddonn	TRUE
hkicpgfjdob	TRUE
iecihbimncn	TRUE
iedaneajhge	TRUE
inpfkfeooco	TRUE
ioaidkheodg	TRUE
jhhdnnejkjp	TRUE
jhlkjlelccc	TRUE
kamcckpadoj	TRUE
kankbhpjeng	TRUE
klnjldphkkh	TRUE
kloofndcimd	TRUE
lgjggppiblh	TRUE
lgjgjdcmgip	TRUE
mbjdcoinkkh	TRUE
mbjldgmknkf	TRUE
mlhemiagpgg	TRUE
mlhliejfkbf	TRUE
nfofkmmfllb	TRUE
nfojcaoigcb	TRUE
oackoeopejm	TRUE
oaebfbgcfie	TRUE
okphehllpll	TRUE
okpkgfbmeng	TRUE
pfglibkeomd	TRUE
pfhjlpkcnca	TRUE
aaamaknlabc	FALSE
aaaoklgkabc	FALSE
ajafidboabc	FALSE
ajbihclmabc	FALSE
bcgcfomabcj	FALSE
bchlfmmdabc	FALSE
bljmaaodabc	FALSE
bljphbaeabc	FALSE
chfgjpbjabc	FALSE
chgcejaoabc	FALSE
dalknjdhabc	FALSE
damfbbpeabc	FALSE
dmejjmdlabc	FALSE
dmenbolbabc	FALSE
egmkofmbabc	FALSE
egmmahooabc	FALSE
fabhmdgaabc	FALSE
facclhboabc	FALSE
fkhbclnbabc	FALSE
fkhgpjhcabc	FALSE
gemmfmlnabc	FALSE
genbemhiabc	FALSE
gpgcolfcabc	FALSE
gpgeiflnabc	FALSE
hjlnlghmabc	FALSE
hjohehaiabc	FALSE
iefdlkpoabc	FALSE
iefhlijgabc	FALSE
ineclbciabc	FALSE
inepgnkbabc	FALSE
jhccpjdnabc	FALSE
jhdehfmnabc	FALSE
kannmohkabc	FALSE
kaomjojpabc	FALSE
klfclcnnabc	FALSE
klfeidaoabc	FALSE
lgbbkjnfabc	FALSE
lgblcackabc	FALSE
mbdadgpgabc	FALSE
mbdicmbnabc	FALSE
mlcpmplabce	FALSE
mldpekggabc	FALSE
ngjhmblaabc	FALSE
ngkcepckabc	FALSE
oaddblhcabc	FALSE
oafjdiliabc	FALSE
olccbbofabc	FALSE
olcgciebabc	FALSE
pfoiacejabc	FALSE
pgapdfbfabc	FALSE
aaamaknlklgk	TRUE
aaaopmfhfcnc	TRUE
ajagpjldnlmc	TRUE
ajainccehido	TRUE
bcdbabcacabc	TRUE
bcddlheapndg	TRUE
bmcoaiamoggc	TRUE
bmfiekeppkll	TRUE
cggfjdkpkdem	TRUE
cggiapicpekm	TRUE
daoiplepkjca	TRUE
dbakcefdaapg	TRUE
dmddimencdmo	TRUE
dmdjlhhfjnan	TRUE
egllhehjnmmb	TRUE
eglodfhgiphg	TRUE
faehoaggpfkj	TRUE
faemomeijlea	TRUE
fklciikcaifn	TRUE
fkobppbddggh	TRUE
genmhfnhdjkh	TRUE
geonmkkhjjgg	TRUE
gpcdhjjpinbp	TRUE
gpdggpafmkei	TRUE
hjlajccadjpo	TRUE
hjlemkhkfced	TRUE
iegobimpbelj	TRUE
ieipegkniidi	TRUE
inidjaiadeia	TRUE
injmmllihadb	TRUE
jhihajjcbagd	TRUE
jhioomahldbf	TRUE
kakofbgcajga	TRUE
kaljnnplekbi	TRUE
klgklnhlgkpf	TRUE
klhbmaeiamcb	TRUE
lhjabdinonpl	TRUE
lhkidfnabapo	TRUE
mbjajmpahifa	TRUE
mbjipbljljhm	TRUE
mlhbblfolojo	TRUE
mljgdbacifek	TRUE
nfnpgcaikkii	TRUE
nfpfcjacgien	TRUE
oaimgahomlgm	TRUE
oajbaefiffhe	TRUE
oldeohgpkoah	TRUE
oldnaphfcjkh	TRUE
pfffnnpkldml	TRUE
pfffogalmcmd	TRUE
aaacmbeacabc	FALSE
aaafoipfoabc	FALSE
ajjgoejhnabc	FALSE
ajkedclacabc	FALSE
bfepfpclmabc	FALSE
bffpdlbjlabc	FALSE
bpbaafggmabc	FALSE
bpbnljhjbabc	FALSE
ckcmohceoabc	FALSE
ckgoekkmnabc	FALSE
deoklmcddabc	FALSE
dfaeiehpdabc	FALSE
eafhkbjinabc	FALSE
eagckjfmgabc	FALSE
ekinfacodabc	FALSE
ekjaddkndabc	FALSE
feicagdboabc	FALSE
fejpecdgeabc	FALSE
fogakgmboabc	FALSE
foghjcennabc	FALSE
gipcgembiabc	FALSE
gipkijmieabc	FALSE
hcfbilmemabc	FALSE
hcfjmbdalabc	FALSE
hmfjgnlnnabc	FALSE
hmgbgajolabc	FALSE
igeljbdlpabc	FALSE
iggblmimnabc	FALSE
jbmcmammbabc	FALSE
jbmobklneabc	FALSE
jkobkmblfabc	FALSE
jkomgagagabc	FALSE
keeamflgbabc	FALSE
keebkocljabc	FALSE
koamnobfeabc	FALSE
kobepdnmfabc	FALSE
lijdhmgapabc	FALSE
lijdiplhjabc	FALSE
mdgcahnieabc	FALSE
mdggnkafhabc	FALSE
mnhonkndaabc	FALSE
mniaanlpkabc	FALSE
nhaniknheabc	FALSE
nhapnbbleabc	FALSE
oanblloljabc	FALSE
obccpkbkaabc	FALSE
oldpickbaabc	FALSE
oleplhholabc	FALSE
pfkmocbfnabc	FALSE
pfkplnaanabc	FALSE
aaacmbeacoipf	TRUE
aaafobcbkcald	TRUE
ajmnmjhhalaja	TRUE
ajnmoiffbfcce	TRUE
bepjcdlmlabbb	TRUE
bfabkopbopeai	TRUE
boogdecdafgon	TRUE
bookbhnkjncnb	TRUE
cjjgfcgghcjai	TRUE
cjlbpdphbenbp	TRUE
dfdenlolekonb	TRUE
dfgdbadahkdki	TRUE
eadoofbihhopa	TRUE
eaegkejiamjcf	TRUE
ekaofgjpppjpn	TRUE
ekbdgdbefncfi	TRUE
fecficolmophc	TRUE
feehfojlamahc	TRUE
focdlfalfipdg	TRUE
fodlmfmpmjgng	TRUE
ghnpfkenjfdmi	TRUE
ghpdkoiiaonpn	TRUE
hcongeoeedfcf	TRUE
hdafhhlhejoae	TRUE
hmjhlhgppeach	TRUE
hmkmnofiamlan	TRUE
igkdlkohfpbdd	TRUE
igknokidapgjc	TRUE
jbnibmceilikm	TRUE
jbnncaeggjmbp	TRUE
jklgkcaogpcbm	TRUE
jklpibmgfghjp	TRUE
kebolaknanaph	TRUE
kedaelomfkdjc	TRUE
koabifghbnnjd	TRUE
koaelgebbklef	TRUE
ligpdlahlfefo	TRUE
liiejafbpnkek	TRUE
mcinfgdlpofdl	TRUE
mcipjlkbdhdab	TRUE
mncdjdcfpakpi	TRUE
mndflmjbpnkag	TRUE
ngkagbikmabmp	TRUE
ngkdofbjhifnm	TRUE
oapaoapoekfdp	TRUE
oapbhcohbiane	TRUE
olejkobmcomdk	TRUE
olekibhiabhdd	TRUE
pfogcaijabjal	TRUE
pfplpmjjlibnm	TRUE
aaadephdmlabc	FALSE
aabamilmnnabc	FALSE
ajmpefocdgabc	FALSE
ajnfjmhknaabc	FALSE
bdidbpnjoaabc	FALSE
bdiemcmiflabc	FALSE
bmhnalllkiabc	FALSE
bmidhefjjnabc	FALSE
cfnhahnhgdabc	FALSE
cfogfcgneaabc	FALSE
dahendppjeabc	FALSE
dahgpnmlmpabc	FALSE
dlcleiingpabc	FALSE
dledifnpopabc	FALSE
eehooifdmgabc	FALSE
eeiogeemnbabc	FALSE
eoanojdnplabc	FALSE
eocbpbgjanabc	FALSE
fillfmcbddabc	FALSE
filppioimnabc	FALSE
gcidhajlghabc	FALSE
gcigacjmjlabc	FALSE
gnljgblfajabc	FALSE
gnlkfnhncmabc	FALSE
higbpmeblfabc	FALSE
higgdgemapabc	FALSE
idobjfccmdabc	FALSE
idocjgkijnabc	FALSE
imlohbgkccabc	FALSE
imlokidndiabc	FALSE
jglechllgpabc	FALSE
jglgmpbhhkabc	FALSE
kanfiaemcbabc	FALSE
kapmndggfdabc	FALSE
kllgmaglilabc	FALSE
klmjleegdeabc	FALSE
lfkdbpcbnfabc	FALSE
lfmfkiknkpabc	FALSE
lpmmmlinjlabc	FALSE
lppifaoehhabc	FALSE
mkefdbnfigabc	FALSE
mkgnoiobdnabc	FALSE
ngacmhkkpcabc	FALSE
ngbkbninplabc	FALSE
oaaojgaclhabc	FALSE
oacfcpcohgabc	FALSE
olegaajjffabc	FALSE
olfhhekhbcabc	FALSE
pfdbfpdkakabc	FALSE
pffhhiigjbabc	FALSE
aaadephdmlmami	TRUE
aablnnkhiibhpd	TRUE
ajpbkbecoaonbk	TRUE
ajpiekfjaogadh	TRUE
bdeeibmghaknop	TRUE
bdgpcijaldapdi	TRUE
bmgoldnlflfima	TRUE
bmhjkjcpcfakma	TRUE
chabegegcbgaoa	TRUE
chalccnaneeokl	TRUE
dakhggncfollma	TRUE
dakomoedglakeo	TRUE
dlfnlolpdlpohm	TRUE
dlfppfjlecflop	TRUE
eeikmmljoddgdh	TRUE
eejeeagajlghac	TRUE
enihdpcekbjedh	TRUE
enjcpimlacnnoa	TRUE
fihdkgkbodnplf	TRUE
fiijdgnoaebhcb	TRUE
gcimiljkboikee	TRUE
gckkcaemkgojel	TRUE
gnjpldpcaiheii	TRUE
gnklidckelkbeo	TRUE
hhmhmpmlohgiig	TRUE
hhmpijmlpbiali	TRUE
idbopoopdplmng	TRUE
idcdiabjmjigkm	TRUE
inalknnccnamoa	TRUE
inapfjplphegag	TRUE
jibfggocknodck	TRUE
jibfpckjeagdgi	TRUE
kalbooifjmenmb	TRUE
kalgpjeapfamgk	TRUE
kljnodoggipifa	TRUE
klkfgmfgmghhbl	TRUE
lfokdchgkiabhn	TRUE
lfoopdfdonmhgf	TRUE
lpnbhcgkaaphhk	TRUE
lpnoinelggopcd	TRUE
mkkdalmfgbkpof	TRUE
mkklicfikjkpdp	TRUE
nemonfehfpndbj	TRUE
neobjflabimgbo	TRUE
oabkclpbaikimi	TRUE
oacbfoloilbgao	TRUE
oldpkjofcdakoj	TRUE
oleglmpjjmjnhp	TRUE
pemnkhodnjjlic	TRUE
penlagcknkijmh	TRUE
aaagfdcjghgabc	FALSE
aabafoomhjmabc	FALSE
ajfbgkfbnhfabc	FALSE
ajfccaibndiabc	FALSE
bdodpgmckjmabc	FALSE
bdopdjpbnnaabc	FALSE
bnekcdkjkejabc	FALSE
bngiikfldknabc	FALSE
cjcccidijdeabc	FALSE
cjcfiideeflabc	FALSE
ddbbnjkhbjfabc	FALSE
ddbdfolggcnabc	FALSE
dmedpmklaleabc	FALSE
dmekgpaljbabcm	FALSE
egbihpedeifabc	FALSE
egbjjfolnniabc	FALSE
fagjnegocobabc	FALSE
fagpmlnphjeabc	FALSE
flalmgbegglabc	FALSE
flanmfjajbhabc	FALSE
gekglpgkmpjabc	FALSE
gekjkjacnobabc	FALSE
gnnblfbeafoabc	FALSE
gnnbmajgodkabc	FALSE
hgoddnldjnfabc	FALSE
hhbehmapnbfabc	FALSE
ialaojpambeabc	FALSE
ialmbokjfoeabc	FALSE
imagoflhphhabc	FALSE
imfbjaflhelabc	FALSE
jhcpfmapeecabc	FALSE
jhdfbmjoiceabc	FALSE
kcdefgppacaabc	FALSE
kcdnnehkfnabcl	FALSE
kmnlfbnamimabc	FALSE
kmnmbbibenaabc	FALSE
lidmafhooapabc	FALSE
lifjcgmgdmlabc	FALSE
mcnndefnkkdabc	FALSE
mcobffodnniabc	FALSE
mmppfajepipabc	FALSE
mnagidgogdaabc	FALSE
nifaoekmknbabc	FALSE
nifohljaeilabc	FALSE
ocdlpacigajabc	FALSE
ochejegcodpabc	FALSE
omhfljncgdeabc	FALSE
omhpabnphcgabc	FALSE
pfljnligoenabc	FALSE
pfloaeocfcgabc	FALSE
aaagfdcjghggafo	TRUE
aabmhjmnkldobfb	TRUE
ajehjpjpjehddnp	TRUE
ajejmefidoccnpa	TRUE
bdlniahnoaaegkb	TRUE
bdmjnoheoalolmk	TRUE
boajojjbppjpkai	TRUE
bobhbphobajcllh	TRUE
cipgbpkjjcmnbfp	TRUE
ciplheibikhchla	TRUE
ddjhodondfichbf	TRUE
ddjjbagonfgaieb	TRUE
dmgcbfemhceffpe	TRUE
dmgeimnipppjdeh	TRUE
efjlnocbpddfbgk	TRUE
efjpodcoahgfcji	TRUE
fahnfpmdlpdjpch	TRUE
faidckabgdahgjp	TRUE
fkidncdefljphjg	TRUE
fkihelbhopiaalh	TRUE
gdmcjdobclimneh	TRUE
gdmnmiokbbebaed	TRUE
gncoejnaghppgii	TRUE
gndjpeadelgpedo	TRUE
hhlobggfcmapfok	TRUE
hhnnlbjpdljgfce	TRUE
iahfnfanmomeemg	TRUE
iajjaokjklhcgmj	TRUE
illmgnciglagdgc	TRUE
ilmbmilkjbnbkaf	TRUE
jgoebnhkjcjngeh	TRUE
jgooljpolijibmi	TRUE
kcelieihjfnmknd	TRUE
kcfhajcbfafbgen	TRUE
kndjchjikdheogf	TRUE
knfmmfidfidgdka	TRUE
liiomkhoohgeekh	TRUE
liknfpefelangbn	TRUE
mddgbdebdpceioa	TRUE
mddonganbbpddmb	TRUE
mncjikgdadkbflg	TRUE
mndelnkemfcilng	TRUE
nhiamlnhmnekfnn	TRUE
nhioehbiniimbea	TRUE
ocjdendoldgaegg	TRUE
ocjijknimbalpgn	TRUE
omkbccnngjioegi	TRUE
omkelghkipjedhi	TRUE
pfoapllnmjkmmaf	TRUE
pfpgilhfhmgkhpp	TRUE
aaaaalfakkcbabc	FALSE
aaageemleliiabc	FALSE
akjgcinfbocpabc	FALSE
akkaegaliadfabc	FALSE
benogpegknnnabc	FALSE
bepbleooahilabc	FALSE
cacpabpcllbjabc	FALSE
caeenlfmngjpabc	FALSE
cjbielfnbpkaabc	FALSE
cjbljohjfiafabc	FALSE
ddcchngipncoabc	FALSE
ddcidnlkifbcabc	FALSE
dmehogchnjfkabc	FALSE
dmeibaapdohgabc	FALSE
ehgebmgdiepmabc	FALSE
ehgmjcnheoajabc	FALSE
fbhnijmepidlabc	FALSE
fbipdgmhbdmfabc	FALSE
flkhgginoefiabc	FALSE
flkllhdenjmlabc	FALSE
ggmeojfkcbgmabc	FALSE
ggnifbcklnkdabc	FALSE
hakiakblehaeabc	FALSE
halcjckdefehabc	FALSE
hkhffdbchjegabc	FALSE
hkijgchhgoggabc	FALSE
iedghlnhdffoabc	FALSE
iegdbmdejolcabc	FALSE
ipbihciomaojabc	FALSE
ipbodpddbekmabc	FALSE
jiojhgdclbkeabc	FALSE
jiojllckbpkmabc	FALSE
kdablnmnaeeoabc	FALSE
kdbhhopmeophabc	FALSE
kncenmigchabcif	FALSE
kndjeaopmnijabc	FALSE
lhnlbjfeinikabc	FALSE
lhohkgdahiclabc	FALSE
mcmenhjaihffabc	FALSE
mcnhnplkocafabc	FALSE
mneppjkkmhmfabc	FALSE
mnflkckdopfbabc	FALSE
ngjpgeeedahkabc	FALSE
ngkilflgmndaabc	FALSE
obajcbidbpbjabc	FALSE
obcckajnfipnabc	FALSE
oliejepamjeaabc	FALSE
olihagbjpdjoabc	FALSE
pfbimalagjneabc	FALSE
pfbkikdhcfncabc	FALSE
aaafjkbjjloocgpo	TRUE
aaaokcofemahgcjm	TRUE
ajamoflfpendgcch	TRUE
ajcbdicfclconomb	TRUE
bcleaggdeoahpkha	TRUE
bclhkhjjdgfleagk	TRUE
bnjmgaojiofplnga	TRUE
bnkldmidmmbkbgep	TRUE
chgkligdgcfhopeo	TRUE
chgobopcdadkiphk	TRUE
dbdomdjgjjkgpepp	TRUE
dbeemgglbhafigeh	TRUE
dlhfplcgbindhbgc	TRUE
dlibhifekhmanefd	TRUE
effjlgckkohkgili	TRUE
eficefjjbkifojpb	TRUE
fanjimlmonkllagp	TRUE
fanodhcaehgapjoc	TRUE
fmjidfojbbhmfpid	TRUE
fmjnknnamieldcjn	TRUE
gflndjdhhlbjjgdp	TRUE
gfmaaedkmneodlce	TRUE
gpmjcfbkpiihjpgk	TRUE
gpmpleehfppgnaba	TRUE
hkacngidekpknelg	TRUE
hkcgccmlgfidjlne	TRUE
ifbppcbellabmbpa	TRUE
ifdedkfajmdadbld	TRUE
ipgiidfmemjjkdfg	TRUE
iphcncpehjjianda	TRUE
jkcamifemopcmomg	TRUE
jkcccficceolojeh	TRUE
kdefmpmajlkfcllg	TRUE
kdehmbalkbmblinj	TRUE
kmncncinociaclha	TRUE
kmpmpflaedfcmoma	TRUE
lhihhghojcnoilip	TRUE
lhjfkmkjkakilmki	TRUE
mbcfjheomofbodlo	TRUE
mbdnekhcgbgedeoo	TRUE
mlnaiihlaoppghon	TRUE
mlnbhdjbhbjaocge	TRUE
ngpckgpbfiiflbml	TRUE
ngpkajhlcgglncoc	TRUE
obfkomglijjaljpo	TRUE
obhpgjjeggocgoph	TRUE
olkjlephakcpeccd	TRUE
olkmlpdjphjnppkl	TRUE
pfkgpjnmlboafpkg	TRUE
pflfhoggdpelmapp	TRUE
aaafjkbjjloocabc	FALSE
aaaogpokcofemabc	FALSE
ajaaiejccjdiabcm	FALSE
ajaefpndefedeabc	FALSE
bdclcffkgndljabc	FALSE
bdeeeinnnocjmabc	FALSE
bnefokiaacijnabc	FALSE
bnejeblhglaibabc	FALSE
chkcogkhnecekabc	FALSE
chknnkikaoiikabc	FALSE
dbnikdieknljnabc	FALSE
dbobdpgkmjpbmabc	FALSE
dllookdhcjilkabc	FALSE
dlohhmplomiplabc	FALSE
eeomhkhfplcbjabc	FALSE
eepaejbagbebjabc	FALSE
faoaennhilolhabc	FALSE
faonocedfedopabc	FALSE
fmfgonblclinlabc	FALSE
fmfleejnjlloaabc	FALSE
gfjlnknlfdkifabc	FALSE
gfjmmffemaejkabc	FALSE
gpkblmfmboephabc	FALSE
gpkdkpgcaehhdabc	FALSE
hkooiceljbaejabc	FALSE
hkpeggblmpjgpabc	FALSE
ifbmaeoonlonkabc	FALSE
ifcaidldgmdgnabc	FALSE
ipenkogmkgjelabc	FALSE
ipgmfkdlgdhhcabc	FALSE
jjndpjadppdacabc	FALSE
jjneodppakknjabc	FALSE
kdfhignljdhkjabc	FALSE
kdgcpjefjmjbcabc	FALSE
kmmpcgbmlbbaiabc	FALSE
kmnpmpgfgnpddabc	FALSE
lgbbdmceaimojabc	FALSE
lgbdndjgnmfmbabc	FALSE
mbchbaggeilhdabc	FALSE
mbenbcdpilcijabc	FALSE
mlbhbknfbdadfabc	FALSE
mldapdmjgkaghabc	FALSE
ngcignjccgbaoabc	FALSE
nggeooncncinoabc	FALSE
obbihfkbdodphabc	FALSE
obcaaghdieehaabc	FALSE
okoeebkibnfebabc	FALSE
okoeopkfkajhmabc	FALSE
pemobcpijlikhabc	FALSE
pencklncchlglabc	FALSE
aabionkmbgkeojinn	TRUE
aacojkkmekdalcfdm	TRUE
akbjdopofdhjdalak	TRUE
akcdgbgmbibalahpi	TRUE
behagbkdchbfhbgde	TRUE
behcdhehnafkdlkjk	TRUE
bpomiodjlcpmbkifo	TRUE
bponbopdmjdegocfl	TRUE
cjglfjemalbpbaaam	TRUE
cjhhnppmhdcakohka	TRUE
deehpmmlabakjkbdb	TRUE
deifmfkkjappioikp	TRUE
dokafjgpjoahjckll	TRUE
dokbmhnmollipfnfj	TRUE
ejepklcomdafbocfg	TRUE
ejfkdlbmkahhopfgl	TRUE
fdkddanhamiehnmib	TRUE
fdlhmppmkiolekmaj	TRUE
fnchcfjhfepmoioek	TRUE
fndohilclldbggmea	TRUE
ggpnjjeopmepplphf	TRUE
ghajoflmgclcblncg	TRUE
hakleddnjbdfddlhj	TRUE
halbbnlpnkfcdcjbl	TRUE
hlffpohfopllfakgm	TRUE
hlghkdgimelfglpli	TRUE
ighdiigdkbiioojic	TRUE
igibgcnagddhbpjam	TRUE
jaendlnfljfhhedgo	TRUE
jafcigcgcgnikiohc	TRUE
jkfhpimjppogjkgln	TRUE
jkgdcnpbmpjbdjgpa	TRUE
kdipfainbjenegegg	TRUE
kdjfefnhaegekhgkj	TRUE
kodndgmdkapflknhg	TRUE
kogpileecmoedcijn	TRUE
lkbaodceldlnohpaa	TRUE
lkbbfdjjcfodmhhhc	TRUE
mdjpenncjmkmpmhld	TRUE
mdkcekbngbolmcfje	TRUE
mpapdknalmdbjhmak	TRUE
mpbckphhcpfkelaoc	TRUE
njeoffmfkkkelebom	TRUE
njfepkeccoomfafbd	TRUE
odakdoejbldfflanp	TRUE
odbailebonhnfnjin	TRUE
ondomjbljlbdbkikc	TRUE
ondppkfadbcodkhhc	TRUE
phbekifggdeckofga	TRUE
phbknikbcbombkgcc	TRUE
aabeiobailphcmabc	FALSE
aabgpobdlbijeabcp	FALSE
akaekfciligbebabc	FALSE
akaimniegedknkabc	FALSE
bflgchdjndmkmeabc	FALSE
bfmgfngkfclmiaabc	FALSE
cabpfdcpphdcclabc	FALSE
cadmhnidfmlplfabc	FALSE
cjoijkhnafcnmbabc	FALSE
cjoipbmajmdemdabc	FALSE
ddhigpljdpmalbabc	FALSE
ddhknpgdecajlpabc	FALSE
dnglecdbkjmlheabc	FALSE
dngndbjgmgjjjgabc	FALSE
ehiaeenofipeohabc	FALSE
ehifpkiikpfidkabc	FALSE
fcohonjlaklgpfabc	FALSE
fcooiababnlpanabc	FALSE
fnmnpkmmginghjabc	FALSE
fnmoneabknmmjnabc	FALSE
gibhgocmloacleabc	FALSE
giclkhedkbjakhabc	FALSE
hchddpglbflbbfabc	FALSE
hcikdkcaepgeldabc	FALSE
hmfeobjaomhcohabc	FALSE
hmfpmnjgkfdapgabc	FALSE
igogmiafmnfcmlabc	FALSE
igpjkejgnampojabc	FALSE
iplcnljdbimakkabc	FALSE
iplggkbmdiheffabc	FALSE
jjleenhnbkmdmoabc	FALSE
jjmhgbjaafjielabc	FALSE
kdkpdbelibbhcdabc	FALSE
kdlkmcnpjgmigkabc	FALSE
kpfcdffgdfemohabc	FALSE
kpffmeglfneaagabc	FALSE
lkbcbhdeohgmdlabc	FALSE
lkbhamhklchhliabc	FALSE
mdllcmkhhbghmoabc	FALSE
mdndkimhbmcmacabc	FALSE
mmonfdimnaanecabc	FALSE
mmopadbpkcggjlabc	FALSE
ngbmfklkpgcemlabc	FALSE
ngdddlhblkloflabc	FALSE
obiaegbhgfibmeabc	FALSE
obipimmeoojdpgabc	FALSE
okoojcmlcaildmabc	FALSE
olagggohglgddeabc	FALSE
pfghdjokfdbfecabc	FALSE
pfhenmacgigcjeabc	FALSE
aabeiobailphcmpobd	TRUE
aabglbijealpmkncjo	TRUE
akegpklmjcejonjolj	TRUE
akennfdabbidmofgna	TRUE
behahfjjgcbdegnmbm	TRUE
behfahiojnimomdphm	TRUE
caedfnaafnlfiahhbl	TRUE
caejfpkjgjaflalijd	TRUE
ckajjnbajkmbjmaaie	TRUE
ckceaemhifdmjojkbd	TRUE
debeecbgicjndpbhef	TRUE
debejppijifcbpchhk	TRUE
dmclodbpmkghjipfbb	TRUE
dmcppebfnicajfapkd	TRUE
ehogbkkkimgfjmlepb	TRUE
ehphgkbhlapgbaaggn	TRUE
fdblonamcpiecoikea	TRUE
fdddlhpbpgekpbcibg	TRUE
fneneandpomnifcecm	TRUE
fneoopgnkppkjcmoej	TRUE
ghpiikgccgpkacplcg	TRUE
giafngmnjihnlckfba	TRUE
hcbcfeihdokdfhenph	TRUE
hcbecefkieokcoonae	TRUE
hmdcgoabcokcdbjabc	TRUE
hmdgidpchfjhhdpacf	TRUE
igaliehkeecdpmlkin	TRUE
igapamafkdpgfbccpn	TRUE
ipmgdcchfodgdbfkkc	TRUE
ipnoigipmaghaeoihk	TRUE
jkbfoodegehegaefkc	TRUE
jkcbdfknbelefogjdk	TRUE
kekmacoamkhjgnhgal	TRUE
kelfnciohmihcbfkin	TRUE
kpccegmblhahdnfjkl	TRUE
kpccmehhfbeeebdmhn	TRUE
ljocacagdadlibdkeb	TRUE
ljojgdflilphjddlbi	TRUE
mdfbickpgafdhbpopm	TRUE
mdhplnbcdafgflbnmb	TRUE
mnandibdhiifhmohna	TRUE
mnbekgmpklokpgadjl	TRUE
ngljdipkhlkchfadkm	TRUE
ngoofippocppaphgal	TRUE
obipiikgnacjnfcklf	TRUE
obkhlnbpnpmollljkk	TRUE
oljppmpjpnejkehjel	TRUE
olkfhphakjggadcdoi	TRUE
pfnomejdiepbokaeml	TRUE
pfoaommicckenbfnfn	TRUE
aaaadbeplgkpmloabc	FALSE
aaachhcheemjbmkabc	FALSE
akhebdipdofppejabc	FALSE
akhmmfgchpemimmabc	FALSE
bdmbhleioeijdebabc	FALSE
bdnbajphklmiljlabc	FALSE
bmjeodldniagllpabc	FALSE
bmlcbogbbpgmhjhabc	FALSE
cfiapidhooeifdbabc	FALSE
cfjegbfchablgdpabc	FALSE
cpmhacldhiedkbeabc	FALSE
cpofbjpoeokeimkabc	FALSE
dkkehgpemkklimjabc	FALSE
dkkemabejhjboboabc	FALSE
eejpnhbmdkbjkefabc	FALSE
eekgbpbnkljalcjabc	FALSE
eojbhglgfbjffghabc	FALSE
eojhcmegmblaenpabc	FALSE
fjdagjcodohdohfabc	FALSE
fjdbmnffoalgpflabc	FALSE
gdoolohafpoipjiabc	FALSE
gdpjdhkepedanboabc	FALSE
gnfpoclefbjcangabc	FALSE
gngfbjgehcbfckpabc	FALSE
hhfecnloabefhfjabc	FALSE
hhghmpkggogbddbabc	FALSE
icondfilaaekalmabc	FALSE
icpbceapnadhnhpabc	FALSE
imffpoiomfaonepabc	FALSE
imfhfkffpjpdipiabc	FALSE
jgafbjnhloleinkabc	FALSE
jgcefbheheflbbkabc	FALSE
kalfdipbpbhobodabc	FALSE
kalhlhlibdhofofabc	FALSE
kkpoplpjjegfcmeabc	FALSE
kkpplbekdbiaacbabc	FALSE
lfgeobeknglgehiabc	FALSE
lfhabiljfammjmabcc	FALSE
lpodolcmnolpaegabc	FALSE
lpoepbnjablggofabc	FALSE
mkieogmeehnjimjabc	FALSE
mkiifckkmhljppeabc	FALSE
neekmopihhijmajabc	FALSE
nefegefdgdchbjbabc	FALSE
npppajhjjadfdejabc	FALSE
oaanlkejagdohggabc	FALSE
olgkpmohfgnjnfmabc	FALSE
olgohckbdjdgmpfabc	FALSE
pflommihcjkidbcabc	FALSE
pfmdngphoifennkabc	FALSE
aacneigkjpkcbpplfdg	TRUE
aadddlddaomfnadhlgc	TRUE
alahpinbnichkoahflp	TRUE
albhghjooldinhbbakb	TRUE
beiocalbbmldclihgfj	TRUE
bekkhcipaflgamffoje	TRUE
bpaeoomgbpmhflldcko	TRUE
bpaonbbbjideokbamip	TRUE
ckehpndmkdjeeijmkfe	TRUE
ckeiakajkfmaafphgge	TRUE
dekfiefakbcbpokanhh	TRUE
dekkfilggaggdiookef	TRUE
dolhlphgeoeehdombki	TRUE
domhncafllmedhfpoma	TRUE
eiabbiedlebndcaeooe	TRUE
eibmpjknfpjiinnlplg	TRUE
fapmmoaafklonpnmncl	TRUE
fapnhlpbeofbfdlhkpi	TRUE
flmhgchlhhomamfchoe	TRUE
flokhjgapopkomdfdpd	TRUE
ggpkipbffndackbjpao	TRUE
ggpnofmhcjagmbggada	TRUE
hapcipihdeabnifanbh	TRUE
hbabmblbfoegjbppnnf	TRUE
hljkdcabhlafmicopll	TRUE
hljpmokmkfbbgdemeoc	TRUE
igdnopigjmhfkkmkhcj	TRUE
igekdfjplnmlabamhdo	TRUE
jandmjmagklaidlnjfh	TRUE
janncnmbmobpmmccngh	TRUE
jlgjjikenmdhhodgbfi	TRUE
jlhkplobmiklclbhmcg	TRUE
kfbgcgedomenjffaobk	TRUE
kfcdaogjeddamdngnfh	TRUE
koooigeelfjcfalodfp	TRUE
kopjehfifcefdhljabp	TRUE
likpgdgbjdghdpopgim	TRUE
lildcolilohabfdekhj	TRUE
mddbedaneenhbljjkli	TRUE
mdecgldpamcolikpcgm	TRUE
mmppjahghajbjddpkln	TRUE
mnaaedapmaoeaibanll	TRUE
nigkoffkpbnjebmebmh	TRUE
nihhkfflojjfiekljlj	TRUE
ocoplhknihcjffoicmf	TRUE
ocpcdckgmopipkejcnj	TRUE
omkaneblieeigplaboi	TRUE
omnmooeefilamhimoed	TRUE
pfmlifipdabnakofinl	TRUE
pfomkjjflceappgfdbg	TRUE
aaadbmdlhdnndninabc	FALSE
aaamldbjncimhfbmabc	FALSE
akmlhimjmbenhkdbabc	FALSE
aknibdkjglnabpjcabc	FALSE
bfbmboacdagkbafpabc	FALSE
bfcablafabgpiomaabc	FALSE
bpdbkidgjffidiefabc	FALSE
bpdjhhdkigohhkckabc	FALSE
cjbijhkkdonnfjobabc	FALSE
cjcgmabkilefkfndabc	FALSE
dcencjpnjlangnfcabc	FALSE
dcfflebjcodkihabcnj	FALSE
dncaffaodgakghhkabc	FALSE
dncfkdgmnjgcldblabc	FALSE
egejmbjcoljbnlhkabc	FALSE
egfapglabpoeaiklabc	FALSE
fageojbjhdlmgfadabc	FALSE
fakchamheelielfjabc	FALSE
fkkkeagpahhllfjgabc	FALSE
fkknanokeflmocaabcp	FALSE
gfaocebicihphbcfabc	FALSE
gfccpejncnoobjglabc	FALSE
gpnbjhfdnmaadpnoabc	FALSE
gpnhppohcggoakokabc	FALSE
hkfemhacnndgodibabc	FALSE
hkgggpoagmmmhjhiabc	FALSE
ifcglalnnhndelhoabc	FALSE
ifckjpkfnohnhachabc	FALSE
jafcgcedhchndkmkabc	FALSE
jafhbkkcofofahdcabc	FALSE
jkmabmjkomkgcpgpabc	FALSE
jkmiihoiaibmhalabca	FALSE
kgaacnclhkablmcgabc	FALSE
kgacpghihmgijgpcabc	FALSE
kpilckccfhefnolbabc	FALSE
kpimfklplpondgoiabc	FALSE
ljcfdmmnanpkbkhhabc	FALSE
ljcfhhljflfnlkgjabc	FALSE
mcpgbaacmiodmegdabc	FALSE
mdaapmenmgojgoogabc	FALSE
mogcnlgmlcjbgkglabc	FALSE
mogopgoddoonjeddabc	FALSE
nhhjgfnfldiaklapabc	FALSE
nhickolidfoapaodabc	FALSE
objkbiddohkeaoikabc	FALSE
obkgmeeehebnakkaabc	FALSE
oliddnjffmelgmegabc	FALSE
oliekfagpaffmffjabc	FALSE
pfnngdmncgamnjbaabc	FALSE
pfolibdbjgbnaldlabc	FALSE
