aaacmjhemh	TRUE
aabnklfhao	TRUE
akjipfgefi	TRUE
akmcmbnnfb	TRUE
bdojofdlgh	TRUE
beandjkamp	TRUE
boljcalolp	TRUE
bomoonedcl	TRUE
chpdpbbnlb	TRUE
ciakcpojel	TRUE
dcbhpekpfa	TRUE
dccfeopmea	TRUE
dmgkkhedmj	TRUE
dmgocoffnj	TRUE
egckffnnbi	TRUE
egcnibegfh	TRUE
fanknlioad	TRUE
faocpkogoc	TRUE
fkcipjebib	TRUE
fkcjfifnca	TRUE
gelcglndpa	TRUE
gelmmpoihn	TRUE
gomjhohicd	TRUE
goohapmcop	TRUE
hjefblbmkh	TRUE
hjeikaoekc	TRUE
ifoaoelcoa	TRUE
igaghfcjfe	TRUE
jabcabcabc	TRUE
jabilfeklj	TRUE
jjhonmlndg	TRUE
jjikemfpln	TRUE
keinapflll	TRUE
keippipfll	TRUE
koiemobifp	TRUE
koijjhoele	TRUE
ljbeaabeid	TRUE
ljccacijnk	TRUE
meaimhhdjp	TRUE
meakkfigoi	TRUE
modcmkcgdc	TRUE
moefcfmhip	TRUE
nhppinilig	TRUE
niaiebbbfa	TRUE
obmjelachi	TRUE
obnpbkbfme	TRUE
onkhngmcmk	TRUE
onkjolnmgi	TRUE
pgmcceailj	TRUE
pgmofmbjae	TRUE
aaagaglabc	FALSE
aaaglopabc	FALSE
ajpgoibabc	FALSE
akacdbgabc	FALSE
befigibabc	FALSE
begaacaabc	FALSE
bpngbipabc	FALSE
bpnijppabc	FALSE
ckbpgbhabc	FALSE
ckcbfjpabc	FALSE
ddjgginabc	FALSE
ddjkajoabc	FALSE
doplhekabc	FALSE
dpabmlbabc	FALSE
eiajejoabc	FALSE
eibfpmkabc	FALSE
fcjmmofabc	FALSE
fcklbjgabc	FALSE
fnkmmdpabc	FALSE
fnkplmmabc	FALSE
gjibgnjabc	FALSE
gjjocgaabc	FALSE
hdigdeeabc	FALSE
hdjmimpabc	FALSE
hoejhafabc	FALSE
hoeopdcabc	FALSE
ihlokeiabc	FALSE
ihngapnabc	FALSE
jchegoaabc	FALSE
jcidephabc	FALSE
jljmafjabc	FALSE
jlkbnhcabc	FALSE
kfifkdkabc	FALSE
kfiliegabc	FALSE
kpmjkbeabc	FALSE
kpmmcfiabc	FALSE
lkcijaeabc	FALSE
lkeggbjabc	FALSE
mdkmbgjabc	FALSE
mdknmboabc	FALSE
mockcmoabc	FALSE
moddodhabc	FALSE
niejbgcabc	FALSE
niffggfabc	FALSE
ocdmhfbabc	FALSE
ocekhoeabc	FALSE
omfljohabc	FALSE
omgfenkabc	FALSE
pgfolfmabc	FALSE
pggeoghabc	FALSE
aaagaglopjm	TRUE
aaagljjmklo	TRUE
ajpelekdopb	TRUE
akaidfpkjpi	TRUE
begcmgjgbno	TRUE
begmocoljai	TRUE
bpjlopmaikf	TRUE
bpjpbneojjj	TRUE
cjegihkjpgc	TRUE
cjepkfmninl	TRUE
deaeompcbej	TRUE
debpdnhcfgc	TRUE
dpaagokallp	TRUE
dpaaknkjhdc	TRUE
ejffaippgak	TRUE
ejgbllfncgk	TRUE
fcigabkbfdb	TRUE
fcimplfaljc	TRUE
foafdakbakf	TRUE
foanpjbcdci	TRUE
gikajoeeoai	TRUE
gilglokbkif	TRUE
hefdgehdhjg	TRUE
hefillnmcgj	TRUE
hnoefobhbij	TRUE
hnohikbphap	TRUE
iifoccaimbl	TRUE
iifogacmcom	TRUE
jcgfiehbkph	TRUE
jcidiedelpn	TRUE
jlpiepfcoch	TRUE
jmancijhdjo	TRUE
kfkmmpmfbic	TRUE
kfmbcpnejeo	TRUE
kpkebfkohfk	TRUE
kpmjlelnpdh	TRUE
ljfebbcghec	TRUE
ljfillicmed	TRUE
mehdmpokodn	TRUE
meiafmboiof	TRUE
moeegjbonbp	TRUE
moffoglmkmb	TRUE
nilmjjfmmcn	TRUE
nilnljhpddc	TRUE
odadedghffn	TRUE
odapkkghjbb	TRUE
omdblhlebdl	TRUE
omgljfbjima	TRUE
pgpmibbmifl	TRUE
phalgdhglgl	TRUE
aaagagloabc	FALSE
aaaglpjmabc	FALSE
ajpkphhcabc	FALSE
akbdaodgabc	FALSE
bfdiipdoabc	FALSE
bfefpjhgabc	FALSE
bpnhcmomabc	FALSE
bpnimgkeabc	FALSE
ckcpiamkabc	FALSE
ckejgnpabcc	FALSE
deaaeddhabc	FALSE
deaibpppabc	FALSE
dpbhmhoiabc	FALSE
dpblcbfeabc	FALSE
eieadlihabc	FALSE
eiegkmciabc	FALSE
fcmbmlofabc	FALSE
fcnofjggabc	FALSE
fodgldlbabc	FALSE
fodlfpglabc	FALSE
giphkbcmabc	FALSE
gjbfknbcabc	FALSE
hdmnpgcmabc	FALSE
hdmoohhkabc	FALSE
hnjgcdjcabc	FALSE
hnkloegabcp	FALSE
ihopclccabc	FALSE
ihpcjndiabc	FALSE
jcffpoldabc	FALSE
jcgclcjaabc	FALSE
jljjcjdlabc	FALSE
jljkldelabc	FALSE
kfhkanjcabc	FALSE
kfhmdpenabc	FALSE
kplblaacabc	FALSE
kpmljcjnabc	FALSE
ljjnkddkabc	FALSE
ljkankpfabc	FALSE
mdnkngffabc	FALSE
mdnnnlckabc	FALSE
moecmaeaabc	FALSE
mofdnlneabc	FALSE
njhpgeadabc	FALSE
njicocglabc	FALSE
ocleigpcabc	FALSE
ocljjodcabc	FALSE
omibkahabco	FALSE
omidhigaabc	FALSE
pggfmgcfabc	FALSE
pgigdnkabck	FALSE
aacbikghicod	TRUE
aacccenfifpm	TRUE
alcfjeahiajl	TRUE
alcjacoinlhm	TRUE
beoglhcmdjni	TRUE
bfahbaafmanm	TRUE
bpdljgamfgil	TRUE
bpebelpcjjho	TRUE
cijdflbpiban	TRUE
cikephckieie	TRUE
dcnjdhghnogp	TRUE
dcnmendjpeja	TRUE
dmjpfekiebdk	TRUE
dmlgibfdlopj	TRUE
ehdaiadajign	TRUE
ehdpojkbmipi	TRUE
fbihmlmbioae	TRUE
fbiikdgjfbjo	TRUE
flelgppodjda	TRUE
flfahbpopijj	TRUE
gemlobcbkifh	TRUE
geocgmmcgnpo	TRUE
gpiackfmlnkk	TRUE
gpifgkbdikae	TRUE
hjhfglgpflnl	TRUE
hjifcdkigica	TRUE
idocbokpmdef	TRUE
idodogfopekd	TRUE
inpijadkmchg	TRUE
iobllbiglbdg	TRUE
jiehablnldhf	TRUE
jieknpmmlpje	TRUE
kcphhnmkabll	TRUE
kcpjccgkpaei	TRUE
kmajbgaeaabi	TRUE
kmbjoekkckhi	TRUE
lgdpjfmjaoid	TRUE
lgekdpihnlij	TRUE
mbjbchabhlll	TRUE
mbkcmdjlpdim	TRUE
mlhakhljpgmc	TRUE
mlhbcflbolia	TRUE
nfnfkkfkkeeb	TRUE
nfoioghocmkc	TRUE
npjldcjjjadh	TRUE
npjmgnnmejbb	TRUE
okffhlcnfoch	TRUE
okfglolkokao	TRUE
pfmkknlflhff	TRUE
pfnhfcfjnmnd	TRUE
aacbikghiabc	FALSE
aacccodceabc	FALSE
aleecfbjkabc	FALSE
alfffdgpmabc	FALSE
bgaiiihogabc	FALSE
bgdeamlcjabc	FALSE
bpkbeiaemabc	FALSE
bplbcnhllabc	FALSE
cjgaomjdlabc	FALSE
cjglkabnmabc	FALSE
dcibbmjdlabc	FALSE
dcichfkgiabc	FALSE
dnanlncmhabc	FALSE
dnbnbdepeabc	FALSE
egfchnheeabc	FALSE
eggeoildiabc	FALSE
fbnpdkigiabc	FALSE
fbpbfdlopabc	FALSE
flglebpfiabc	FALSE
flhjblgjmabc	FALSE
genffaeaoabc	FALSE
genijhcnoabc	FALSE
gpchbnogjabc	FALSE
gpgembhegabc	FALSE
hkbpojdjmabc	FALSE
hkbppclohabc	FALSE
idadbdabeabc	FALSE
idafbmmdaabc	FALSE
ioahnefpeabc	FALSE
ioamglkekabc	FALSE
jimoaeeooabc	FALSE
jinnjladhabc	FALSE
kchanipjaabc	FALSE
kchpmnoggabc	FALSE
kmbgfdkckabc	FALSE
kmblanjiaabc	FALSE
lgeakfgieabc	FALSE
lghdgpbgjabc	FALSE
mbgjfcenmabc	FALSE
mbhjhjjihabc	FALSE
mlnfgpkalabc	FALSE
mloeijadnabc	FALSE
ngacopnoaabc	FALSE
ngajalkadabc	FALSE
npmgmmgacabc	FALSE
npngjedpkabc	FALSE
okbdnjilaabc	FALSE
okbeacoimabc	FALSE
peojnkfcpabc	FALSE
peokagmcoabc	FALSE
aacjighijiofe	TRUE
aaekfgckophna	TRUE
akagokheclegc	TRUE
akailbekjooja	TRUE
bepbnojfkdcjk	TRUE
bfakmkjmemolp	TRUE
bpglekeckmjij	TRUE
bphihnpobhcll	TRUE
clcikgpjpcdmp	TRUE
clfdonbnbfhle	TRUE
dfddjamfffhhj	TRUE
dffclpcejjnhc	TRUE
dpkejpindhhgd	TRUE
dpkgkbmhmpnej	TRUE
ejmkhmjjdjnpi	TRUE
ejnibahekgcej	TRUE
fckpndniodbdm	TRUE
fcledijbpfppi	TRUE
fmldbgcnlcmih	TRUE
fmlemhbjnplhj	TRUE
ghjlnddlibmjp	TRUE
ghjmpkcaijenc	TRUE
haliempbmgoad	TRUE
hamaoebeefhdm	TRUE
hkacbkljpocmo	TRUE
hkadjimgfflel	TRUE
idfflkeghkeah	TRUE
idgjjbfopgcgg	TRUE
inkilbgibpmaf	TRUE
inkjgkgflknck	TRUE
jhnognneondcc	TRUE
jhobmkcheohed	TRUE
kciaialkndlao	TRUE
kcjcafimagiea	TRUE
knghhaahiobfd	TRUE
knhojfmjmcgpd	TRUE
lhkdhmccjleie	TRUE
lhkgkfbagnkco	TRUE
mciagdhlkdnkk	TRUE
mcimafcpgninb	TRUE
mndjcklnflpae	TRUE
mnehbpekmbmko	TRUE
nhcejjgljlijk	TRUE
nhdbaddenmbei	TRUE
nppgemllhbaip	TRUE
oaadbkimjpbmi	TRUE
ojmiofnflloic	TRUE
ojnbkeenjojpb	TRUE
pfeopbimdfadf	TRUE
pfjokdfbemjdo	TRUE
aacjighijiabc	FALSE
aaeofekfgcabc	FALSE
akcencaniiabc	FALSE
akcklkgogbabc	FALSE
bedjnndlkcabc	FALSE
beeicejdmjabc	FALSE
bpidimielgabc	FALSE
bpjdipepmhabc	FALSE
clceiaallaabc	FALSE
cldhmljbkhabc	FALSE
dfodjngcnbabc	FALSE
dfplacagefabc	FALSE
dphjbmhfpoabc	FALSE
dpidppgnmfabc	FALSE
eiednddnmmabc	FALSE
eiejipmdphabc	FALSE
fcimkhkfhbabc	FALSE
fcleonbmedabc	FALSE
fmiigfmkmgabc	FALSE
fmkijagdapabc	FALSE
ggaplimodabcg	FALSE
ggbeliieehabc	FALSE
hbfeklgcjbabc	FALSE
hbfnpgnmlkabc	FALSE
hkhbkmjglhabc	FALSE
hkhcdjnghjabc	FALSE
idihcebgacabc	FALSE
idjfbbodmpabc	FALSE
injjjdnmbdabc	FALSE
injnghgfdfabc	FALSE
jhehfngbdmabc	FALSE
jhfjbcdlmdabc	FALSE
kcdakhcnafabc	FALSE
kcfdbmdmeiabc	FALSE
knimgiiicnabc	FALSE
knjajcpjhfabc	FALSE
liidocdbnhabc	FALSE
liiecmhkljabc	FALSE
mcjpgfneglabc	FALSE
mclbegmonkabc	FALSE
mmaepdchfhabc	FALSE
mmbinjnfciabc	FALSE
ngakpjilknabc	FALSE
ngbneeldhdabc	FALSE
nppioofpnbabc	FALSE
oabfdbinkkabc	FALSE
okdcnceinpabc	FALSE
okdhbfccnpabc	FALSE
pedhbokcbiabc	FALSE
peejcphlooabc	FALSE
aaclhepekahgek	TRUE
aaekdfghnopocb	TRUE
akhpdanodbanci	TRUE
akilabecimkpmj	TRUE
begcmfjcofgljn	TRUE
begcojkckmogkd	TRUE
bohkaffkbeeabo	TRUE
boibhonpcpcnmk	TRUE
claiknffgpceie	TRUE
clbkncgiehigec	TRUE
dfihlomanibbdk	TRUE
dfimgjihcanaij	TRUE
dpilchkffdgoel	TRUE
dpjohdecggjjch	TRUE
ejjgichooapipl	TRUE
ejmnejpnilhmho	TRUE
ffkagbiicbnjca	TRUE
fflbagiobmgogn	TRUE
fpohancoddngbi	TRUE
fppchnbpfldafk	TRUE
gkcmigjdanapla	TRUE
gkdbhkdgbgppch	TRUE
hdlkdlfiknmija	TRUE
hdlnnnmmookmlp	TRUE
hoaopbgedphjhl	TRUE
hobhohlmkcjnka	TRUE
ihnlhhgdhofegn	TRUE
ihnmjkfaggjhoh	TRUE
jcimpplmpmjigo	TRUE
jcjegkegnpgceb	TRUE
jmcginhlmakocj	TRUE
jmcifhdkbnlkcn	TRUE
kgikoidpgecihh	TRUE
kgionpodhpolnc	TRUE
lajkhcgngiohap	TRUE
lakaongcbpganb	TRUE
lkbbpfhjicajkm	TRUE
lkbnnoomicoefk	TRUE
mdfecanlfdpgfd	TRUE
mdgobbbnocipim	TRUE
mnoekomgjnpnkg	TRUE
mnoeokkcoifphc	TRUE
njadcegodeopne	TRUE
njagjnlkhmohdc	TRUE
ochkgonophgebi	TRUE
ochldhhngkoijg	TRUE
oljlcendpjeege	TRUE
olkikljcepcloa	TRUE
pfjpgigkanamgf	TRUE
pfkfnabmpdlefc	TRUE
aaclhepekahabc	FALSE
aaeeklkdfghabc	FALSE
akhbnhfcgioabc	FALSE
akihilepdnjabc	FALSE
begepndlefgabc	FALSE
beihhoinfcgabc	FALSE
bodjdinlekhabc	FALSE
bofgpcekhffabc	FALSE
cjolphdoamdabc	FALSE
cjopgiliifjabc	FALSE
dfmbecnopmkabc	FALSE
dfmhennkhkoabc	FALSE
dpfbconffieabc	FALSE
dpfjhgaielpabc	FALSE
ekleaemgkakabc	FALSE
eklfgcclfjoabc	FALSE
fgbefiiikmoabc	FALSE
fgbhllnohedabc	FALSE
fppnlhadnpiabc	FALSE
fpppadocoidabc	FALSE
gjphmgjbdhbabc	FALSE
gkbdameaagoabc	FALSE
hdfglgkaidkabc	FALSE
hdipeanjmpfabc	FALSE
hocjmdpmfcnabc	FALSE
hocplaocfdiabc	FALSE
iippbmblpgiabc	FALSE
ijaeifkkflgabc	FALSE
jcfecklbcgoabc	FALSE
jcfikcpddakabc	FALSE
jmbnbkgdcllabc	FALSE
jmbnliahhofabc	FALSE
kglpkpgbfikabc	FALSE
kgmfplginobabc	FALSE
lafejdjndhoabc	FALSE
laflokghaekabc	FALSE
lkbeeibhfndabc	FALSE
lkbmnpmhngoabc	FALSE
meglpcfkaljabc	FALSE
mehajhjmkgjabc	FALSE
moahfjpgidoabc	FALSE
mobmndlhhicabc	FALSE
nhnjdjmpdmoabc	FALSE
nhomngngnnjabc	FALSE
ockaogmgidnabc	FALSE
ocldegmlfpnabc	FALSE
olpbfjejijabcd	FALSE
olpkemmelkiabc	FALSE
pfhlnblkmbfabc	FALSE
pfkecbpiabkabc	FALSE
aaadkonpkmocdap	TRUE
aaakkcmifpdacno	TRUE
ajmlfppkbjkpcpi	TRUE
ajnhcjhphjbdjmp	TRUE
begeokfmkdjhmln	TRUE
beginfmohajnofj	TRUE
bnblfdhbjpcpnae	TRUE
bndahiefbehhjee	TRUE
cjalajdemjmleah	TRUE
cjbfogdnaidjhjg	TRUE
dcnnhjboliemflf	TRUE
dcopfdmbbiogegb	TRUE
dmjkhkcdmjbbmpk	TRUE
dmkakgjaaipbfgl	TRUE
ehbkijlegkbifgm	TRUE
ehcdnjiihoilofb	TRUE
fchiiiojmildoka	TRUE
fciejkibbckjffm	TRUE
fmedibkecfaffbj	TRUE
fmekpmndimlklkb	TRUE
ggmcmgakkbejihi	TRUE
ghafaepeolkmapp	TRUE
hbckiniihgblfdo	TRUE
hbejoojndiejkpi	TRUE
hklbhbkemnpemjb	TRUE
hkmaclbfdhmephk	TRUE
iffpmgcjcmahfnl	TRUE
ifgelndopmecaod	TRUE
ipanhbdlokgjoeb	TRUE
ipbbcdebgklbjme	TRUE
jinabhnjnfglilp	TRUE
jinccedfmceakbf	TRUE
kcmnbdiaboaegpj	TRUE
kcmppdfhnebjbnp	TRUE
kncbbijicakclfc	TRUE
kncjneoinfpjkkg	TRUE
lgoelhkklhjbdhi	TRUE
lgpjlfoofaeodcl	TRUE
mboeobcbpabeipl	TRUE
mbofhgfgcnlgamh	TRUE
mmpalpakpnfkdph	TRUE
mnahkgdcilnindh	TRUE
nhjbhakldcihgph	TRUE
nhkmaligpjpofkd	TRUE
obamkofajdalgfb	TRUE
obbgilpodhonefh	TRUE
olldgoapledanjb	TRUE
olnifabdhibahlk	TRUE
pflghpbjfhgbocd	TRUE
pflnlnlelfdjbcl	TRUE
aadfdljialbaabc	FALSE
aagplppablodabc	FALSE
albbllkacbkoabc	FALSE
alclcoiplenhabc	FALSE
bfkdcdphhknoabc	FALSE
bfkdnelchbnabcp	FALSE
cahcbeonmlfbabc	FALSE
caipgiicffjlabc	FALSE
cjmgbhoapnieabc	FALSE
cjmhhlodhfogabc	FALSE
decblhjddjadabc	FALSE
decflfbooangabc	FALSE
dombclbgcnjbabc	FALSE
domdallgjhlgabc	FALSE
ekihnjghnfmkabc	FALSE
ekjjcdgneigbabc	FALSE
feonlaleclpeabc	FALSE
fffgodecahkcabc	FALSE
gaeekejpfljlabc	FALSE
gahjjbanhadbabc	FALSE
gkenmohanohoabc	FALSE
gkeokkcoilkiabc	FALSE
helfbjiidngiabc	FALSE
heljlclpdajlabc	FALSE
hodfdlpafbdoabc	FALSE
hodhbkfdchocabc	FALSE
igmpijbmgnofabc	FALSE
igmpokoapgleabc	FALSE
jagpcpfggmkcabc	FALSE
jahidfdmhehjabc	FALSE
jliiieflpaghabc	FALSE
jljgeaapcpcmabc	FALSE
kgmmhchfgnmeabc	FALSE
kgmnmdjdoimlabc	FALSE
lamokefbacgaabc	FALSE
lbafiemlhcmkabc	FALSE
lkjcpkgmmcapabc	FALSE
lkjgaeaimnomabc	FALSE
megabodjgmdbabc	FALSE
megaggbfbnfcabc	FALSE
mnnlocpbpjcgabc	FALSE
mnpikjigpkdoabc	FALSE
nheoppdpnaplabc	FALSE
nhfofnmclaeeabc	FALSE
obfkplggolgiabc	FALSE
obhdmbdcdpababc	FALSE
olidjmkhmbdnabc	FALSE
oligopkepkmjabc	FALSE
pfjlkaalbnkgabc	FALSE
pfknnggaohcpabc	FALSE
aadfdljialbagplp	TRUE
aagpablodjoonndg	TRUE
alahncpeilhpmjad	TRUE
alblmfnnnidmpehh	TRUE
bfolmhnjckcieoel	TRUE
bfpgmnfaodifbmfp	TRUE
caiceeheiamilmka	TRUE
caigpfafhngmepjf	TRUE
ckfelncflanllkab	TRUE
ckfenmapcckknclj	TRUE
dekniijagbbgejch	TRUE
denaomlhhlchilhe	TRUE
dpcfaniejibeaphg	TRUE
dpcgmdomblphdgdk	TRUE
ekjedfgfkmkbdiib	TRUE
ekkalehfecoehige	TRUE
ffeenihifgicdknm	TRUE
ffemjooemlnkfihf	TRUE
gadimlncchiidepa	TRUE
gaedijmkhdeekppj	TRUE
gkjkcomfnehnogfo	TRUE
gkjkjlbcbnldilha	TRUE
hefoghabjalkccgo	TRUE
hehcnjnccjhfindg	TRUE
hnlpocjigmimgkne	TRUE
hnoadiinldfniodh	TRUE
ihfcpfopjcjgdlel	TRUE
ihfllgldodiamkjo	TRUE
jaknacllfncamghc	TRUE
jalhljdpdojdfpgl	TRUE
jlkghenladgbgckg	TRUE
jllkfalloelhanaj	TRUE
kgcnnkmmghbdkmji	TRUE
kgcogabkldokbgad	TRUE
langmhhapoajipni	TRUE
laohbapiepbijllc	TRUE
ljjepjkijphcbcbj	TRUE
ljkoiibmkfmjamip	TRUE
mdkdhpmkhaclpdkg	TRUE
mdkhmfhkmefgmfgj	TRUE
mnfdacjmpamicffj	TRUE
mnihafjcjjgcpdlc	TRUE
nhokcagdngnppglb	TRUE
nhpdjcncnjmfnmjp	TRUE
obdonhdbaglofjdn	TRUE
obehpkhigfddfbbk	TRUE
olhicjehodemimll	TRUE
oliibaaahebnbblk	TRUE
pgjjgkglnlfmokpd	TRUE
pgjkephbfcehjoam	TRUE
aaahkofkmboedabc	FALSE
aaalbbknllebkabc	FALSE
akeechcodcfejabc	FALSE
akeeecklmjhigabc	FALSE
bepnmmikicanfabc	FALSE
beppnfpbaiiljabc	FALSE
caoloendgldmhabc	FALSE
caoodmcnjgnkjabc	FALSE
ckpnhhfehkfmmabc	FALSE
clblcgemmcbenabc	FALSE
dejoegcjlnmghabc	FALSE
dekaippefbpamabc	FALSE
dohpmfecpoglhabc	FALSE
doidcmhkmkibmabc	FALSE
eileecgkgnfcbabc	FALSE
eilndimgbmnejabc	FALSE
fcmofcnahiafhabc	FALSE
fcndleccophkpabc	FALSE
fmlcnfjninjdoabc	FALSE
fmmokfbmioppkabc	FALSE
ggonleimkediiabc	FALSE
ggopnjbobdcddabc	FALSE
hbfpdhpkgnkkjabc	FALSE
hbgekgijgllejabc	FALSE
hlgpmbphbmchfabc	FALSE
hlihecnbfijjcabc	FALSE
ifekemokenhbjabc	FALSE
ifemffhjakaeoabc	FALSE
ioefghkigdiceabc	FALSE
iofedidhjgafeabc	FALSE
jinhfgihblpomabc	FALSE
jiojnginoapklabc	FALSE
kdcaabijmjcjhabc	FALSE
kdcdlpefjmfegabc	FALSE
kmnemjhhpjpababc	FALSE
kmpailhhlieomabc	FALSE
lfokgendpopocabc	FALSE
lfpfiinaedafnabc	FALSE
lpjhakliegcpnabc	FALSE
lpkkekaophpkkabc	FALSE
mkjgoaclihbolabc	FALSE
mkjlfplpeihliabc	FALSE
nfiibblghdoipabc	FALSE
nfjkhjcpcnfpdabc	FALSE
npinincbdfangabc	FALSE
npkmbioocbpmaabc	FALSE
ojonlfhnjgcaoabc	FALSE
ojooeejfapflcabc	FALSE
pepodmikebnlcabc	FALSE
pfadhmlflgpfmabc	FALSE
aaahkofkmboedkbbk	TRUE
aaalllebkpafmgiop	TRUE
akgoombheohngdnpa	TRUE
akicphghgncjiigkl	TRUE
beihhgokefgekgcgb	TRUE
beioemdmnednfihmf	TRUE
cbamhdkfhmckfoeoi	TRUE
cbbibfadoohkiodkp	TRUE
cllpoahlppjlkgnoi	TRUE
clmbajemhlniccfho	TRUE
dfdkncijiddcpahhj	TRUE
dfelfkfdmlcggjmci	TRUE
dolebljfkfepfiadp	TRUE
dolilooihiepgnlmi	TRUE
eiklfokjfopgabdbp	TRUE
eikofhobhjmcakeaf	TRUE
fdaeihfcbloenflgo	TRUE
fdagbmihacighoekk	TRUE
fmoghajeaoaejhfcb	TRUE
fmpjkhcnginlnmeen	TRUE
ghhjkdoaaggjaiocf	TRUE
ghhlcnpnojekffdhl	TRUE
hbgchgpikijhnninc	TRUE
hbiemhgfnfgjbapca	TRUE
hllgmcgldopnejmlc	TRUE
hllolglccpjpacibi	TRUE
ieeadlldjjfgcpkig	TRUE
ieecibllbhafnmnno	TRUE
iodmfccgboagikdmm	TRUE
iodobeimhpficffhe	TRUE
jjcdfobmmbjklgagn	TRUE
jjcelinkonpljodkh	TRUE
kdajokhpjkomkpafg	TRUE
kdcinmfbcicfibeac	TRUE
kmhamcmnmgcgaagef	TRUE
kmhcmieebleciddjb	TRUE
lfhoncaefehbeagnf	TRUE
lfillfeedgidocokb	TRUE
lpaibacaamfaggpem	TRUE
lpbgnnkfjlggflkaj	TRUE
mkmljmmmalkkdipgi	TRUE
mkmocceomembcmmfk	TRUE
nfbnmdfeihbbhceim	TRUE
nfccehbffnefgpcgl	TRUE
npjncmibmicoaodfg	TRUE
npjollnpgfkphhifg	TRUE
okfnhlmpbnfgnkhfn	TRUE
okgckhbjkhjpoiihm	TRUE
pflaicljnbfjaaelk	TRUE
pflobmknnjnbahlim	TRUE
aaaphdchcjpobabck	FALSE
aacabnhjnchclmabc	FALSE
akdliahljmcodpabc	FALSE
akelgpkmbbnhafabc	FALSE
beccofaicpklmfabc	FALSE
becicofkibhpjgabc	FALSE
bphkhgahehbhgnabc	FALSE
bphledkdjaplijabc	FALSE
ckeahgdjnkgbapabc	FALSE
ckfcebhjnaoekpabc	FALSE
decegbgibilgdgabc	FALSE
deckalhlmjedjgabc	FALSE
dndobdcnheggjeabc	FALSE
dnefljaiemplapabc	FALSE
ehokkbanjonadjabc	FALSE
ehooifaeannnjkabc	FALSE
fblbcccmkcnahmabc	FALSE
fblldldeihabmmabc	FALSE
fkkgmjnkbbjpgoabc	FALSE
fklikbelopomljabc	FALSE
ggbelljikoikhpabc	FALSE
ggdcgaepioihpjabc	FALSE
hagoenhmppffoaabc	FALSE
hagpgkmfagigpcabc	FALSE
hlfjkafakeaibeabc	FALSE
hlgnakkhbbndnoabc	FALSE
iflnikefgecggcabc	FALSE
ifmeclllmhpmimabc	FALSE
jaflaolimjefkpabc	FALSE
jaieodlnfdedgmabc	FALSE
jmapjbphopacaiabc	FALSE
jmbibhnhjindidabc	FALSE
kgciljmhioajiaabc	FALSE
kgegepabiafkjiabc	FALSE
kplkhmpmcgfdggabc	FALSE
kpmhdncbjnjpfgabc	FALSE
lkhdkjhjhkfmplabc	FALSE
lkijekkflhonebabc	FALSE
mfhgopfdpgnkdjabc	FALSE
mfhnjfafdphccfabc	FALSE
mogeflkehgmniiabc	FALSE
mogjhlhblccbbgabc	FALSE
nhkapofkaflnffabc	FALSE
nhlmgaedhonlkcabc	FALSE
ocdpgpnnkeofcbabc	FALSE
ocfheabmadgdnlabc	FALSE
omdbmmameieaogabc	FALSE
omdhlipmhhfaeaabc	FALSE
pfmjicinmedklabcg	FALSE
pfnkmdcidegggoabc	FALSE
aabdhhcpgddfgmfloh	TRUE
aaddgfmncljcmenakd	TRUE
ajpjobpcbfikddfhoh	TRUE
akaffnpodpgfjpclih	TRUE
bfacjhoiepjjlcibgk	TRUE
bfagbfbleefaekedcd	TRUE
bpheckojaechhnkjln	TRUE
bphmcddljpdmmflpnj	TRUE
cjgbpfcdkodfchdafc	TRUE
cjhklfiappokbpamcl	TRUE
dccfeifmnpiganbfed	TRUE
dccgfndepdejimincn	TRUE
dlggiejfclfkelpjmm	TRUE
dljjjpgfpmknnmlllf	TRUE
eggebfibejcgikmccl	TRUE
eghjfdkpbdbibgacjm	TRUE
epekllpglddajiicno	TRUE
epihgiogogpcblnagj	TRUE
fiphioaoeelofmaigf	TRUE
fjadlgpoikhbfkmhgh	TRUE
gcnhjopgijnidongnh	TRUE
gcofkifabkfdfgpapp	TRUE
gniohopofcklcconkb	TRUE
gnkpnjhkhklhdpgadc	TRUE
hiagggbifjjaeomdfg	TRUE
hiamljjdilimeldomk	TRUE
icmejpdlolonaiielj	TRUE
icmhmiiggbekmeelfn	TRUE
inkkdpbehckdajobnj	TRUE
inlbiocodblmoifpim	TRUE
jigonbjoldkpkgaobi	TRUE
jihppknhaecbanpeod	TRUE
kcofebiojbhfiemklc	TRUE
kdbgokedobhdakekmf	TRUE
knnpnjfiipcfnkhdml	TRUE
knododbooohhchmbng	TRUE
lichimgbdhmhncaopj	TRUE
liciohchdhglfaijll	TRUE
mbgmefjmfmhkmlodgg	TRUE
mbgpcpgppgklpflmbh	TRUE
mmaeelafbioknhmilp	TRUE
mmaijhbkeillojainp	TRUE
ngjpbcdmjadfabnkad	TRUE
ngkcfpffiaapfpllpi	TRUE
obeacikoijcccehjil	TRUE
obefjlfmbbadpghcpa	TRUE
olpjbfhcacjcljnece	TRUE
omagljpbalhopdjblk	TRUE
pfdibjopjmdkcgncmf	TRUE
pfdjcmjfocjbdeanch	TRUE
aaabgejbfagfamgabc	FALSE
aaaikdjmcjbkabpabc	FALSE
ajdfinhpbbepedeabc	FALSE
ajeapdiippbjecbabc	FALSE
bcndmllepdofjbgabc	FALSE
bcneifhfjailmjcabc	FALSE
bmjighhmioockblabc	FALSE
bmjipmdmjjccfplabc	FALSE
cgdaomkdgcfnjpnabc	FALSE
cgdbcgkgkemkgghabc	FALSE
dabmknbfmpclklkabc	FALSE
dabnbbimlfdfpnmabc	FALSE
dlendcgpjglgbbgabc	FALSE
dlfmnbcppdhadecabc	FALSE
efdldbpcdigpdbcabc	FALSE
efeaihboceippkfabc	FALSE
eojckfnlmadenbeabc	FALSE
eokidoooelboifpabc	FALSE
fkecdiaagbcigkjabc	FALSE
fkhgcmkdcjofoihabc	FALSE
gfabnfbcdfnlfpbabc	FALSE
gfabpimfjdbjknbabc	FALSE
goomcljhegmcpgnabc	FALSE
gopgaphfkoiagffabc	FALSE
himbpkhnkcbbcljabc	FALSE
hinaelnfhlhjiimabc	FALSE
iclojklmbcjghpjabc	FALSE
icmkecleoegelmiabc	FALSE
ioaadelnljonncfabc	FALSE
ioaecigmajbhalfabc	FALSE
jjaodofgjbdbamlabc	FALSE
jjblafgbofnmmbiabc	FALSE
kdengnijadeaapoabc	FALSE
kdfjjleooahmaoaabc	FALSE
koanbfdkfpgpdaoabc	FALSE
kobjlmiaghmijeiabc	FALSE
lidaebjnebcnaffabc	FALSE
lieafkilimaoaclabc	FALSE
mcdfebmijdadbadabc	FALSE
mcehmebkncgkcakabc	FALSE
mnccinnmcppphchabc	FALSE
mncfcjcmimieilfabc	FALSE
nhbcmlacechlllkabc	FALSE
nhbhncnknalhjaoabc	FALSE
obgibgeimoegmopabc	FALSE
obikdbeibpohigaabc	FALSE
olfcehgemfafijmabc	FALSE
olfhaidbooapimbabc	FALSE
pgalmepbddhfegiabc	FALSE
pgckojflbapmkjhabc	FALSE
aaaadekpbajndojbaph	TRUE
aaaejfocmbaolpibihm	TRUE
ajifbpelncpiigepola	TRUE
ajijlahjdkihjncagep	TRUE
bdeabcanegpheabcabc	TRUE
bdgmeakdenophjddnbp	TRUE
bnocfjeogheajgamike	TRUE
bnoiifdehcbbbbjmoin	TRUE
cjjmjhkgpdoapleghod	TRUE
cjkmojfenlolaineico	TRUE
ddhealkcbfhokfnnmfa	TRUE
ddhjclkmanenckfhngd	TRUE
dnglloikbhggopkflbg	TRUE
dnhlfblhdodifhgchjh	TRUE
efoiloineckmhpifdcp	TRUE
egabooijlijdbnppham	TRUE
fajbnlaaaildjfkklap	TRUE
fajcapgdbccehnbcpah	TRUE
fkpdhhhdjpccgfhmdmc	TRUE
fkpkmeejibkeegiblbc	TRUE
gfjgdciegdiooeopjdm	TRUE
gfkgolainmdghkeikhg	TRUE
gpmfhagdebogchihlcf	TRUE
gpnonedknhkddaikcjm	TRUE
hkhojbhndhdcbkjngcm	TRUE
hkkbgnmghjpinibjbbb	TRUE
iedbnmcjfpoekfmikbf	TRUE
iedcjjennadfgmfkdan	TRUE
ionmpmelpafdlmipkbo	TRUE
ioobifcbndecfkbmphf	TRUE
jjjenldbfbkeagblmla	TRUE
jjlnagpaonocnjbgpep	TRUE
kebhkmhbicncadkmaoi	TRUE
kebjjkccgdmkbegfacj	TRUE
kpcolppchhgildadcej	TRUE
kpcpggbdjpablcnpobc	TRUE
liligigjpfmolbcohhf	TRUE
lilipjjlakfbocchhgh	TRUE
mdcpbpahfffifcgoffo	TRUE
mddflmdenkfcgmkaocd	TRUE
mocollblhbpfnnoofgj	TRUE
modicdkfmkicgdgkpgg	TRUE
nigphfdpobidppemkdl	TRUE
nihapbobbelkilinijd	TRUE
obpfhdicdcjofpgpcji	TRUE
obphaagohokdfdbfbih	TRUE
oloinokjcnlpjdhcmgg	TRUE
olpepglfjgaifkjomdk	TRUE
pfoniganiogdoeejbng	TRUE
pfooefminfbpheijkcj	TRUE
aaaadekpbajndojbabc	FALSE
aaaeaphjfocmbaolabc	FALSE
ajkcafgneogdjfgabcp	FALSE
ajkmbebgimpomemmabc	FALSE
beakgcldingcechkabc	FALSE
bealifefikidcajeabc	FALSE
bnhondjpgfcopgkeabc	FALSE
bnjopdoljppmpflpabc	FALSE
cicihiindimlafepabc	FALSE
cieggdppeaploggjabc	FALSE
ddkngaedaalphcbfabc	FALSE
ddndoeheenndppcgabc	FALSE
dndejhmnlenejalkabc	FALSE
dnebhokfnnmfaclkabc	FALSE
efopfbedkbaancldabc	FALSE
efpbofbmeimlicgoabc	FALSE
faneikfcnhjmbkmlabc	FALSE
faodlfilklpihkbcabc	FALSE
flbpeeoocbmiihnpabc	FALSE
flcbicebdbppbbhaabc	FALSE
gfeimbjfpnhefakgabc	FALSE
gfenjhmhaglccdjbabc	FALSE
gpofdeolcldeekpfabc	FALSE
gppdcajjdlbadokdabc	FALSE
hkbdgjckaldiljhhabc	FALSE
hkclppadhdfjhoaeabc	FALSE
ifcjjhlmlmdlhagdabc	FALSE
ifckebogchihlcfoabc	FALSE
ioommigpadiinfbdabc	FALSE
iopbnnlifpbgmbopabc	FALSE
jjobiihjpjingdefabc	FALSE
jjofnbjlkdmichababc	FALSE
kdkccpcigemobhdhabc	FALSE
kdkocokoaehfleoiabc	FALSE
kpagjjbcjlephipcabc	FALSE
kpbjiidiflmdidadabc	FALSE
ljeohjpighfmapdoabc	FALSE
ljfihkmpoppgpojgabc	FALSE
mddbgecjajbmgipjabc	FALSE
mddpblnabfnnemjhabc	FALSE
mnopifbhbpkdmajlabc	FALSE
mnplohikjhcejfdoabc	FALSE
ngoeaelbnlgkknajabc	FALSE
ngoiodplbgkkhcmfabc	FALSE
oclgngocabeelanaabc	FALSE
oclkhoiibmmlhbjdabc	FALSE
omcefinnpnpdhpfgabc	FALSE
omcggfkdfofabpmeabc	FALSE
pfeadpmpgcbfpdcpabc	FALSE
pfemmehdfcgbobbeabc	FALSE
