aaahcpgbai	TRUE
aaaihbneaf	TRUE
ajpialffnn	TRUE
akahbflkjm	TRUE
becloaepnp	TRUE
behjljoghh	TRUE
boaibnonla	TRUE
boaplpbbga	TRUE
cgnoehkoeg	TRUE
cgpdhclahc	TRUE
dahdacohdf	TRUE
daifgnhfam	TRUE
dkpdmneiel	TRUE
dlaeahphak	TRUE
efopmdgobj	TRUE
efpdhncndi	TRUE
fadjbeekii	TRUE
fadjkjdcmd	TRUE
fkbcfghodl	TRUE
fkbecpaflf	TRUE
gdocdfihaa	TRUE
gdonamegei	TRUE
gnjobdhgec	TRUE
gnkanoijfn	TRUE
hikgdabhip	TRUE
hilgldooch	TRUE
iedkifpind	TRUE
ieekejdohl	TRUE
ioaoappecf	TRUE
iobhdmolok	TRUE
jhohjhjmkj	TRUE
jidcahallf	TRUE
kbabfdidgl	TRUE
kbaiklgmff	TRUE
kkjfjbgkdl	TRUE
kkkfdelbph	TRUE
lfelldehge	TRUE
lfenokpgpo	TRUE
lpjoemnpjp	TRUE
lpmbpckkga	TRUE
mjondlcedh	TRUE
mjpegagfoj	TRUE
nebiiekmmm	TRUE
neblioadnh	TRUE
npggcgcphj	TRUE
npgpkfnfmb	TRUE
okejadflok	TRUE
okeoaadodp	TRUE
pfcdldjmbk	TRUE
pfgjifmdmn	TRUE
aaahcpgabc	FALSE
aaaibaiabc	FALSE
ajolbajabc	FALSE
akbfcocabc	FALSE
befbdafabc	FALSE
befcjpmabc	FALSE
bnjhnklabc	FALSE
bnkceomabc	FALSE
chnoefdabc	FALSE
choalnoabc	FALSE
dahkggmabc	FALSE
daiobjmabc	FALSE
dlcmhmlabc	FALSE
dldgodgabc	FALSE
eejdaihabc	FALSE
eejjcodabc	FALSE
fadhknjabc	FALSE
fadjeoiabc	FALSE
fjmhblmabc	FALSE
fjpajpgabc	FALSE
gebkfbkabc	FALSE
geddfgiabc	FALSE
gnphlakabc	FALSE
goajdnpabc	FALSE
hjcagolabc	FALSE
hjchfdjabc	FALSE
idiecjhabc	FALSE
idihjohabc	FALSE
inkgjgfabc	FALSE
inmagfoabc	FALSE
jhkmdfgabc	FALSE
jhldbheabc	FALSE
kaogdanabc	FALSE
kaokeilabc	FALSE
klkokidabc	FALSE
kllfhicabc	FALSE
lfkjmfjabc	FALSE
lfleiiiabc	FALSE
lpjbehlabc	FALSE
lpjdfchabc	FALSE
mjkgmcnabc	FALSE
mjnbnfhabc	FALSE
nelhecmabc	FALSE
nellciiabc	FALSE
npfogehabc	FALSE
npgpoobabc	FALSE
oklggkgabc	FALSE
oknblffabc	FALSE
pfjiijkabc	FALSE
pfkahbkabc	FALSE
aaahcpgbaih	TRUE
aaaibneafce	TRUE
ajpecnjmmmj	TRUE
akagehjofdj	TRUE
begiamhodon	TRUE
beglomjdcmo	TRUE
boebjgdmlga	TRUE
boeeliemnak	TRUE
chomfdcampf	TRUE
chpfikjdnmi	TRUE
daheejcmelm	TRUE
dahlnhamjko	TRUE
dliehdddill	TRUE
dljjkoncinb	TRUE
efekjecdefc	TRUE
efelhjkhpcm	TRUE
fabfodlcpaf	TRUE
fabhlfmemmg	TRUE
fjjlbabiiki	TRUE
fjkhajgbfik	TRUE
gehepcncijd	TRUE
gehfoheaflc	TRUE
gnoloalmgnf	TRUE
gnpoakngleg	TRUE
hihohpmmhaj	TRUE
hiidlabephf	TRUE
idnkhaliinc	TRUE
idnodmaffgc	TRUE
iogogillckg	TRUE
iohkimcjfao	TRUE
jhmpnjaknlp	TRUE
jhngagokfld	TRUE
kbhoaipnifh	TRUE
kbjcblobndk	TRUE
klnmemoaipj	TRUE
klokklnacha	TRUE
lfiapjmnipc	TRUE
lfimdeicclb	TRUE
lpebabindca	TRUE
lpfgogiiekm	TRUE
mkibjcdkefh	TRUE
mkjnbhncgba	TRUE
nganjjaghdo	TRUE
ngapnaieobd	TRUE
npfkmhjjpie	TRUE
npgiblhojha	TRUE
okjonedjlbh	TRUE
okkjjanaeco	TRUE
pfkejpaeibo	TRUE
pflcakipaog	TRUE
aaakbnljabc	FALSE
aaaniabbabc	FALSE
ajeajgecabc	FALSE
ajenjelnabc	FALSE
bddpfdeoabc	FALSE
bdeddfllabc	FALSE
bnfldpkiabc	FALSE
bngbcofeabc	FALSE
cfmkhcacabc	FALSE
cfmkkpnkabc	FALSE
dajcncnjabc	FALSE
dakbbpfaabc	FALSE
dlbfeiaabcb	FALSE
dlbglpmmabc	FALSE
egiifmbiabc	FALSE
egjdpdkfabc	FALSE
fbhgnaedabc	FALSE
fbihddmabcn	FALSE
flibdeokabc	FALSE
flioifkhabc	FALSE
gfpcbfpbabc	FALSE
gfphmkcjabc	FALSE
hahcjhcgabc	FALSE
hahigablabc	FALSE
hknhcimabcm	FALSE
hkpjmgnjabc	FALSE
iegohalcabc	FALSE
iehipmakabc	FALSE
iofplbalabc	FALSE
iogpfainabc	FALSE
jhkkdbnlabc	FALSE
jhklifdbabc	FALSE
kcmajecnabc	FALSE
kcocafnbabc	FALSE
kmhagcdpabc	FALSE
kmhhkhcnabc	FALSE
lghmedmdabc	FALSE
lgibbanlabc	FALSE
mbencmanabc	FALSE
mbfpgfncabc	FALSE
mlogknicabc	FALSE
mlojffbdabc	FALSE
ngkdmejkabc	FALSE
nglmecigabc	FALSE
oadodcdcabc	FALSE
oaffpopgabc	FALSE
oknenjddabc	FALSE
okoefnfjabc	FALSE
pedldlkkabc	FALSE
peejfminabc	FALSE
aaakbnljiabb	TRUE
aaaneoimbegn	TRUE
ajgkcidnkneh	TRUE
ajjfbbmmjjpp	TRUE
bdalpncjfljd	TRUE
bdbcjifpmddo	TRUE
bmngladbgoig	TRUE
bmnhngpnimic	TRUE
cgajpanknjih	TRUE
cgcfghlpjmon	TRUE
dagodbhmhkon	TRUE
dahidimbkmad	TRUE
dlkjnnepchac	TRUE
dlljdjcefnbh	TRUE
efphpghgjleg	TRUE
egablgkpclce	TRUE
fbbgnggbendn	TRUE
fbcdjoompmnf	TRUE
fkpllhhoacpb	TRUE
flakgehejilo	TRUE
gfmhifdjbggm	TRUE
gfojfinjejje	TRUE
hakbifmhinbn	TRUE
hakfancojlbm	TRUE
hkdkjkihlmhk	TRUE
hkdpniaeillg	TRUE
idniinckjehg	TRUE
idnjojdifbff	TRUE
inojdglophnl	TRUE
ioaokokdoked	TRUE
jhohilndiihg	TRUE
jhonpfmdadnj	TRUE
kcfnadfnbjgj	TRUE
kcgecibnbjlj	TRUE
kmoidgegiebj	TRUE
kmopogfmkfhh	TRUE
lhjlpkbeieea	TRUE
lhjnjfioljha	TRUE
mbefakcjflcn	TRUE
mbeonfjpegal	TRUE
mmfajahjkjhc	TRUE
mmfapeidjmai	TRUE
nghdbipcompd	TRUE
nghlpanaigbd	TRUE
oadkodcbbimg	TRUE
oaegkchdejlh	TRUE
okdmnjpjkodd	TRUE
okdnfonceemh	TRUE
pfdfikbomdil	TRUE
pfdfooegjnbd	TRUE
aaaahjoibabc	FALSE
aaadhebglabc	FALSE
akfmgcjnaabc	FALSE
akghpafbnabc	FALSE
bfhjpmgibabc	FALSE
bfikijaedabc	FALSE
bpcfbbpogabc	FALSE
bpclgkjccabc	FALSE
cjbjcdcdlabc	FALSE
cjcamfhbjabc	FALSE
ddhjdcjdhabc	FALSE
ddhmbfjhgabc	FALSE
dnddljjoiabc	FALSE
dndneoohbabc	FALSE
ehcdmpmnpabc	FALSE
ehcfgmkilabc	FALSE
fahfaoijiabc	FALSE
fahhpkpmfabc	FALSE
flepidmcnabc	FALSE
flepmafanabc	FALSE
gfmfghnenabc	FALSE
gfmjnhoohabc	FALSE
gomclpnllabc	FALSE
gomdepmhcabc	FALSE
hilkhhmaoabc	FALSE
himpcpgmmabc	FALSE
ibhconfdaabc	FALSE
ibhiidpcabco	FALSE
imaeeblgmabc	FALSE
imahbfidhabc	FALSE
jgpdfhlgjabc	FALSE
jgpijfdekabc	FALSE
kbgbfkhkhabc	FALSE
kbhgpplgpabc	FALSE
kkofiabpjabc	FALSE
kkoinbplbabc	FALSE
lfiiobghbabc	FALSE
lfjckdchhabc	FALSE
lppdinllkabc	FALSE
lppdoeoegabc	FALSE
mkopbgcpdabc	FALSE
mkpcbodndabc	FALSE
ngiigbpinabc	FALSE
ngkahjalaabc	FALSE
obkfpbkfcabc	FALSE
obkponbdbabc	FALSE
okopndgljabc	FALSE
okpihkcocabc	FALSE
pfkklifhaabc	FALSE
pflbglaikabc	FALSE
aaaahjoibhebg	TRUE
aaadleonigaek	TRUE
akfelkjhaokfe	TRUE
akhhkimbkpohk	TRUE
bepckhnehnafj	TRUE
bepekeaiohici	TRUE
bpcnajcgheokk	TRUE
bpdgdffihldbb	TRUE
ciocgmliglfdh	TRUE
cipjjndfamgka	TRUE
dcjfinpojghbb	TRUE
dcjonanheopbi	TRUE
dnelninojlikh	TRUE
dnfcappocdodc	TRUE
ehefifbdhlinp	TRUE
ehejeccfiggaj	TRUE
fahbbkncfgabg	TRUE
fahhpbahgcpbj	TRUE
flhdlcmoipjlb	TRUE
flhinomhffino	TRUE
genolimoidmcc	TRUE
geoclhijmkfmj	TRUE
gogohhfpkfdbe	TRUE
gohhakcdcdaop	TRUE
hhkmiekbmegff	TRUE
hhlbphhlcfkbo	TRUE
ibnolhphhcbdo	TRUE
ibnpbpilnmmlj	TRUE
imjbplhhefhoa	TRUE
imkfagjgblejc	TRUE
jhigpdkhapkbp	TRUE
jhjlnhamijbik	TRUE
kbeplpfmeejio	TRUE
kbgemoodnkflf	TRUE
klfamilapofnj	TRUE
klgjdhccfjmig	TRUE
lgdaddhjnendo	TRUE
lgdjpfkhnfmdn	TRUE
lpogbdafklkhh	TRUE
lppboiebfmmif	TRUE
mlbfmhpklbpel	TRUE
mlehgdapbbepi	TRUE
ngiefdogkmlen	TRUE
ngjoebnfmomda	TRUE
obfkdpgidkfcb	TRUE
obgeilbphlpco	TRUE
omegjnfehkpda	TRUE
omelgnmcdojgj	TRUE
pflmipnapihac	TRUE
pflndapldiofh	TRUE
aaafbkpmfeabc	FALSE
aaalkkeidgabc	FALSE
ajfginfhmiabc	FALSE
ajfpndapdiabc	FALSE
bdemkhgealabc	FALSE
bdepikaljlabc	FALSE
bobcnijlmabcn	FALSE
bobgipclleabc	FALSE
chklgdjidhabc	FALSE
chmehahfegabc	FALSE
dbhippdmhmabc	FALSE
dbhkpcjhfeabc	FALSE
dmdfdnnfiiabc	FALSE
dmeechmnjjabc	FALSE
egbhkgjecdabc	FALSE
egbjngmhbdabc	FALSE
fapfabkjepabc	FALSE
fbbpbpigceabc	FALSE
fkgikpepbiabc	FALSE
fkhacdcmakabc	FALSE
gehgajbpjeabc	FALSE
geiimibeegabc	FALSE
golejjeldbabc	FALSE
gonkpndmooabc	FALSE
himmkcbgceabc	FALSE
hinfdadcicabc	FALSE
icknlpbeblabc	FALSE
iclcinjmjeabc	FALSE
imhgcdbellabc	FALSE
imikfhkldlabc	FALSE
jheheadiadabc	FALSE
jhehpglpmjabc	FALSE
kbifipobncabc	FALSE
kbiojpfaeiabc	FALSE
kljflbdoomabc	FALSE
klkahllkfnabc	FALSE
lfakinlgedabc	FALSE
lfanpbpiflabc	FALSE
logmipnfhnabc	FALSE
lohcmcibigabc	FALSE
mjodmmlmcoabc	FALSE
mkbmfjmboeabc	FALSE
nfegpilkbbabc	FALSE
nfggbdalopabc	FALSE
npimdfongfabc	FALSE
nplijlgnjnabc	FALSE
okdkekpcaiabc	FALSE
okgeiokghkabc	FALSE
pflcfbmdpaabc	FALSE
pfnbbhfidlabc	FALSE
aaafbkpmfekkei	TRUE
aaaldgpnmpneoo	TRUE
ajfepgimeejhjj	TRUE
ajgchjlaeahecn	TRUE
bebcnnolhfcdpg	TRUE
becpccokhiiofg	TRUE
boaachaddnghgf	TRUE
bobhcbecbglpon	TRUE
cigobmdlpmpohl	TRUE
cihifmmpghoahp	TRUE
dcilmhdkbkpnkb	TRUE
dcjcacaldkdelp	TRUE
dmhgfklmdmecnl	TRUE
dmhjooacngmhil	TRUE
egcocplkamlkib	TRUE
egconlijbednpm	TRUE
fanmiehhbikaon	TRUE
fbadhclpmjoial	TRUE
fkcmcejkkpgkim	TRUE
fkefedkmlfemch	TRUE
gdlebhohlbffbb	TRUE
gdmeejbboidbdf	TRUE
gnpnnhlcngpbkk	TRUE
goackpclomlhbn	TRUE
hhnpddlbgifbfn	TRUE
hhoelgkmaknafk	TRUE
ibmblnkkkaioan	TRUE
ibmhaiencnhbkg	TRUE
inaklpbmlnplbb	TRUE
inbgflkdnkdjjb	TRUE
jhnekibmblljih	TRUE
jhockfoncaecao	TRUE
kbfakpkkpabaie	TRUE
kbfbfamfkmkaam	TRUE
klmkdmpmjdipmk	TRUE
klnbknjkeeacfj	TRUE
lfdbjbiiimniad	TRUE
lfeaehieeioibp	TRUE
loohmhehemjihj	TRUE
loomlhjmjiloam	TRUE
mkhhlebchicooa	TRUE
mkhljokladgfjh	TRUE
nfcoclfbniigbm	TRUE
nfdckhoipmnbnn	TRUE
npaleobafophom	TRUE
npbannkdgonbhj	TRUE
ojjnlipojdhocl	TRUE
ojmhlchepgpacb	TRUE
pfgaenbeplkbke	TRUE
pfggmnamkgeomo	TRUE
aaaimgfmfckabc	FALSE
aacdedloefnabc	FALSE
algcaffjiilabc	FALSE
alifoemgclfabc	FALSE
bfkhnonlkkpabc	FALSE
bfkphpcfjmkabc	FALSE
calfjhhialgabc	FALSE
caljdfemilpabc	FALSE
cjoigidapokabc	FALSE
ckajpfjggdfabc	FALSE
ddjigaaanfhabc	FALSE
ddjjgmkgjinabc	FALSE
dnmalnfgiacabc	FALSE
dnndnakkagkabc	FALSE
eibblfkcfnhabc	FALSE
eibnikbacglabc	FALSE
fckodbkmhihabc	FALSE
fclbkalndcmabc	FALSE
fmanfmgfoihabc	FALSE
fmejojdgfahabc	FALSE
ghemflcpcpoabc	FALSE
gheofpibmgcabc	FALSE
hbooecciogcabc	FALSE
hbpbagejllkabc	FALSE
hnhaifendkaabc	FALSE
hnhdakkkknfabc	FALSE
ihajgkedcciabc	FALSE
ihbckbknfglabc	FALSE
jbgkflhpppdabc	FALSE
jbhgadeclaoabc	FALSE
jlilpeiaaafabc	FALSE
jljefhclphoabc	FALSE
kedghbcdeghabc	FALSE
kefhgaficbmabc	FALSE
koomhgameekabc	FALSE
kopancfegehabc	FALSE
lihfdhbnahbabc	FALSE
lihodfomkalabc	FALSE
mcleopbkopoabc	FALSE
mcmgbffilliabc	FALSE
mnijeojfcfiabc	FALSE
mnjidpmpljmabc	FALSE
nijcinjlhpmabc	FALSE
nijhbppbnkjabc	FALSE
ocgcbdiflogabc	FALSE
ocgofmakoloabc	FALSE
onkjicdhhjcabc	FALSE
onlmbiamhojabc	FALSE
phbkailbjklabc	FALSE
phbpmmdkjgnabc	FALSE
aaaimgfmfckdoed	TRUE
aaclefnkeijaobl	TRUE
alhgofekgekfkoh	TRUE
alhnbgdogefcfpd	TRUE
bglakcancogfnfa	TRUE
bgllncckenadolb	TRUE
caifbjoageiijle	TRUE
caiibhnengacopj	TRUE
cjpkcaebbpdffpk	TRUE
cjpmpffalnggckp	TRUE
dcogajkhlnnkcln	TRUE
dcomomlajgdcbgg	TRUE
dmpcmbmealpjcjp	TRUE
dmplehabgdpkhfc	TRUE
ehnahmjmlheingp	TRUE
ehnmlkcachfaegb	TRUE
fcinlnpbghhpghc	TRUE
fcjhponknkpcgph	TRUE
fmdaplikmljgkfk	TRUE
fmdihbpdnbdnagj	TRUE
ggimabfdjpfjaib	TRUE
ggjbagedendnecf	TRUE
hbiaejnffbkfkeg	TRUE
hbiimicbadojnmf	TRUE
hmmcaopjeeghjjn	TRUE
hmmebflbllklmjf	TRUE
iiakbmjocijfaoe	TRUE
iiamolddcficbnl	TRUE
jbgghphhbjjiabn	TRUE
jbihhankaengaoa	TRUE
jladlejelbjjbjj	TRUE
jlaedefelfdkclh	TRUE
kfhcimpnjmdiiga	TRUE
kfjapikjfoaeoga	TRUE
kpdodlapmbpabgj	TRUE
kpdpbkomdnhcbea	TRUE
lijfhdnenmdfadg	TRUE
likhpfigefpkfdl	TRUE
mccfbecoljfbhho	TRUE
mccmgnhjjpkodoh	TRUE
mnfokgdlddhlhhb	TRUE
mngejlenchmndjg	TRUE
nicdkacagninmgd	TRUE
niceecdhhmcphhj	TRUE
ocgabogkbbnmnng	TRUE
ocgifjeceoofgio	TRUE
onmnafnnieefoie	TRUE
onmpkpafjjllgma	TRUE
pgmdpebbgfmffbk	TRUE
pgmohiebhbokbal	TRUE
aabeeinghpjmabc	FALSE
aabhogihjelkabc	FALSE
aklpjnkfoogaabc	FALSE
akmgmapnkimkabc	FALSE
bfbdnmilpnjgabc	FALSE
bfcbkmagmnhnabc	FALSE
bogcnineiomjabc	FALSE
bohjgfchhdbcabc	FALSE
chopccobdpbiabc	FALSE
ciafielcljnbabc	FALSE
dcdplfbddbliabc	FALSE
dcedlglglpkbabc	FALSE
dmfcgfknohciabc	FALSE
dmgfbllihekkabc	FALSE
egkoacbiccebabc	FALSE
egkogjdaikgcabc	FALSE
fbjphpjkfgkbabc	FALSE
fbkgebklaigiabc	FALSE
fmadfkjmjelcabc	FALSE
fmaocokfmmeiabc	FALSE
ggicinnilmoeabc	FALSE
ggifmmaabbloabc	FALSE
haeocgpfhhhoabc	FALSE
hafbjoinpooeabc	FALSE
hkpikmkjgbelabc	FALSE
hlanllcmenmkabc	FALSE
ifcfajkmlejiabc	FALSE
ifcommelockhabc	FALSE
ipaajidodhcdabc	FALSE
ipablfmillbaabc	FALSE
jikcfnjpncggabc	FALSE
jingcjbdnmahabc	FALSE
kdbdfmnibllcabc	FALSE
kdeegpiieedmabc	FALSE
knhfhcoknklnabc	FALSE
knhhdgfgmfioabc	FALSE
liaikaplgiiiabc	FALSE
libepafiknclabc	FALSE
mchfambionmbabc	FALSE
mchficeabkababc	FALSE
mljmggljcndkabc	FALSE
mlklolfojaamabc	FALSE
nhbbkheokdbhabc	FALSE
nhbcnnhpcjjfabc	FALSE
ocagibbgkpiiabc	FALSE
ocajedcnndffabc	FALSE
ombekfpkfnnbabc	FALSE
ombipimepmepabc	FALSE
pfoaejmmfpmlabc	FALSE
pfoedmmifekaabc	FALSE
aacdhahffohnbbhp	TRUE
aadbknnbifinojlo	TRUE
ajkjhcglkcmkfbop	TRUE
ajkkpneglgfaiggb	TRUE
bdoelakdfpcjhkkf	TRUE
bdomabmpmmofocmb	TRUE
bojeegfefjkipnod	TRUE
bojjgkbhgpfdepbl	TRUE
cipnpogjapimdghi	TRUE
cjanlmfmjecmighl	TRUE
dcgfcdidmledfgdg	TRUE
dcgjncmelenjagli	TRUE
dmlfoakmgkdibpdg	TRUE
dmloodnbogpamnhn	TRUE
efiifpjjoaddcfoa	TRUE
efilfdeohlmggfkh	TRUE
fbioghaphhbckach	TRUE
fbkbaiagbkbdlllj	TRUE
flnckclpihjndpgk	TRUE
flpagikggjegfjbm	TRUE
ggejgogoempjalge	TRUE
ggfdbglabnmaionm	TRUE
haacohfghaojibol	TRUE
haahfkcejnndfjmi	TRUE
hjdelhikoghhndja	TRUE
hjebbnbpbaambmhp	TRUE
idoempelaghnfllf	TRUE
idomhflogclgimmd	TRUE
ipdjlkcchlgipgfj	TRUE
iphonoilnjleeoll	TRUE
jikhphkdfinmjeik	TRUE
jikhpmcioljkbeoh	TRUE
kehcjkaghgkoamng	TRUE
kehnjbemkgibjonf	TRUE
kpamaneokohghjgc	TRUE
kpcblkekfpefjkhf	TRUE
ljaoialgimkapfdl	TRUE
ljcgohdcgpbfgpfi	TRUE
mejppgkemmkepfda	TRUE
mekfmphplalckppf	TRUE
moknjbmjcpdaddpf	TRUE
monncohmeobnjacp	TRUE
nibojjjbchnalnno	TRUE
nicbdcgjcakmfbci	TRUE
obkemegmhdbikpag	TRUE
obkilcihnghcogmn	TRUE
oldlcdfnglpgmdpe	TRUE
oleohhmhhjffpdjn	TRUE
pfjggaemckcljfle	TRUE
pfjnnkgpaaoembep	TRUE
aacdhahffohnbabc	FALSE
aadbpbiknnbifabc	FALSE
ajlnglfceobhcabc	FALSE
ajmdfchmlncokabc	FALSE
bennakohpbbhbabc	FALSE
bennicjmdnikiabc	FALSE
boifhhodipbjlabc	FALSE
boimbkcpnefcmabc	FALSE
cjdallbamlmmiabc	FALSE
cjdjnnpigafbgabc	FALSE
ddbohjcbgdmijabc	FALSE
ddbpleblihpgcabc	FALSE
dmoloeaofpoldabc	FALSE
dmpaghmddjojhabc	FALSE
ehkbnomiegpnaabc	FALSE
ehmmdhpmejhofabc	FALSE
fbalmhbcldcaoabc	FALSE
fbfcpcbegihehabc	FALSE
fkkgfcdbkmbllabc	FALSE
fkpedlibjmlfjabc	FALSE
gfmlchicopalpabc	FALSE
gfoeccniaadboabc	FALSE
haanbbcgkbhnkabc	FALSE
habjpnlcbhdaiabc	FALSE
hjajckooidfheabc	FALSE
hjckhangpighlabc	FALSE
idhicboenonioabc	FALSE
idiaemlekimodabc	FALSE
ipggndapnemlcabc	FALSE
ipgjafeiobmfkabc	FALSE
jjmlbbbnpheddabc	FALSE
jjpjoaoneoapiabc	FALSE
kehgifkdghgndabc	FALSE
kehkclkjajjpkabc	FALSE
kpfjmiknfkbphabc	FALSE
kpgmpbdfibejmabc	FALSE
ljpklpmhmppfkabc	FALSE
lkbcofmdefeiiabc	FALSE
mefdkaejdmoaiabc	FALSE
mefljfmjllpaiabc	FALSE
mogcnkfbbofcoabc	FALSE
moldafhnabgikabc	FALSE
nifeoefgoelbhabc	FALSE
nigcgjhhcgefhabc	FALSE
obhhkmngnoonlabc	FALSE
obiinjcndpghgabc	FALSE
olcbagolipkheabc	FALSE
olcedjiemhohkabc	FALSE
pfihbphjjeedeabc	FALSE
pfjccldefphpabcc	FALSE
aababhoioggpjnfnn	TRUE
aablbbndadggajdgg	TRUE
akofadgggjknepkji	TRUE
akohelafcbihcelmb	TRUE
bfbekaambjaadcikf	TRUE
bfefmehmdojlgadan	TRUE
boliijohjgdgnpoan	TRUE
bomckiachdmejfcgl	TRUE
cjochhhobkddmmbjn	TRUE
cjoiempcaliojimpg	TRUE
ddmacfopeodokpabj	TRUE
ddmnfjpdhfjchohih	TRUE
dneofhdeakmcmkeoj	TRUE
dngdmjmejblackmcl	TRUE
ehhaljdjkkjjkjigk	TRUE
ehikndchenipkjjnc	TRUE
fbipgnpifmjlgckdo	TRUE
fbkhpmcigekioiocm	TRUE
flncjlpcekiacnknc	TRUE
floakejpfgplbgkpf	TRUE
gggdhplpmcoeikbaf	TRUE
gggfahnpcklfblnin	TRUE
haefcngcbpmmlggkp	TRUE
haekedikekkkaeahf	TRUE
hkocnljfmhehakelm	TRUE
hkpaklhgncjhkgcmk	TRUE
ifbdbkigonkcccoio	TRUE
ifbehgoljjoadccal	TRUE
iognfifanikikngkh	TRUE
iogodiomcpccapjma	TRUE
jjgnlbegnibelgcjj	TRUE
jjgpchajhbbohhofo	TRUE
kfagdbeniooblkjoa	TRUE
kfbdjlfmlecgmnfll	TRUE
kpffmbalfpaembnng	TRUE
kpfidogicdjhagikj	TRUE
lkbbgedgoljnjidch	TRUE
lkbfgibkhfdffnkkf	TRUE
meogpglbcfaaogdhf	TRUE
mfamppmjiaojgokgl	TRUE
mojleioomapbbdgmo	TRUE
mokciikfocdgjgpkm	TRUE
njhpiigephfapabgf	TRUE
njjpffhopiakcgfgo	TRUE
odkdpbjlnodbohdih	TRUE
odkigeinnpkgnlkho	TRUE
oneghpfkcjopgdljb	TRUE
onfcplhbldfeggeca	TRUE
pgpcmknipjmjbjoid	TRUE
pgplaeappgnhlnkgn	TRUE
aaadbihppfmmagabc	FALSE
aaakahaelbffneabc	FALSE
alifeigkbeflfabci	FALSE
alioiniejlfaelabc	FALSE
bfcnjnfpniilodabc	FALSE
bfddeghfknjngpabc	FALSE
bphcjafidaobjjabc	FALSE
bphgiiapomflpkabc	FALSE
cjnaalkhblnlakabc	FALSE
cjnncaoohcefmdabc	FALSE
ddnkpchjmkghpiabc	FALSE
ddoipdiepcokmeabc	FALSE
dogkjbceobljfcabc	FALSE
doidmoojahbddoabc	FALSE
ejlggbfgnachllabc	FALSE
ejlkanlgicpjboabc	FALSE
fclldkldclooikabc	FALSE
fclnhhepancbkkabc	FALSE
fmlfdefflcddieabc	FALSE
fmnjnkikkglfocabc	FALSE
ggmphcbfohaajaabc	FALSE
ggoekdkckojnheabc	FALSE
hbgcghhijolkkbabc	FALSE
hbgfpiagidcibjabc	FALSE
hleijccklnccfeabc	FALSE
hlfgejiedfpoglabc	FALSE
iepenjpbnkjkbnabc	FALSE
iephgjjcpeahfiabc	FALSE
ipljamkliineodabc	FALSE
iplmfeljkjmbejabc	FALSE
jkbfknaemgbfodabc	FALSE
jkbompjlkhffacabc	FALSE
kcpnadfgghbjnfabc	FALSE
kdaninfiemmbabcip	FALSE
kmjkjgaegniiimabc	FALSE
kmlnhjfobchdhkabc	FALSE
lgmijiclnjanncabc	FALSE
lgmjfpfdhhgahpabc	FALSE
mahjenkjkalfmnabc	FALSE
maidkblkimokbfabc	FALSE
mjofdomoeefaobabc	FALSE
mjpccglehiiegbabc	FALSE
ngdhjbblcfmopfabc	FALSE
ngehaplgfbdnfnabc	FALSE
obpojdjbmgpaffabc	FALSE
ocaebkmniabknaabc	FALSE
omddklhnaldablabc	FALSE
omdjiepckegojoabc	FALSE
pgbbekbfihpjlnabc	FALSE
pgbciimdaplokpabc	FALSE
aabaiekbmajdgggmak	TRUE
aafkhagglkgjhnnjhc	TRUE
alceaomapkiadaohfl	TRUE
alceoigidpiaibkpld	TRUE
beniedkbfgfchkebjc	TRUE
benpmgefmoblefmeib	TRUE
bpkcehcbcgpenokoai	TRUE
bpmfodmkcklodpcmfd	TRUE
cinceigkfhmighbopb	TRUE
cinfnokfeploganion	TRUE
dckekmjmmkcpgchlim	TRUE
dckgafolmifcgcmmnc	TRUE
dnjehdcdjdpaldbjfp	TRUE
dnjhkflapanpjfbcne	TRUE
ehlidbdhnngdfakmmn	TRUE
ehmfidfeepebabggho	TRUE
fbhlmileifofmhfhaa	TRUE
fbhoghboojblmfncmc	TRUE
fklhhmegckdkekafdk	TRUE
fklijpcjjnacjkekjk	TRUE
gflpmeipaniilkgfon	TRUE
gfnbcfkgmkkidpdpjg	TRUE
haadkkhjghaeobcgcm	TRUE
habjongcjmlhemmjkf	TRUE
hlbmbmiiniohfdejgj	TRUE
hlcmnnkgppfdpidcch	TRUE
ifamkoocdidlkplhnm	TRUE
ifanfdohfhjekbdndl	TRUE
ipgaiejibfjpjphkgf	TRUE
ipgdalicmplkcihbhg	TRUE
jjhdhjemcfhdnfcbgj	TRUE
jjhomhdhpibaohbfkg	TRUE
kenghfobknebkbafki	TRUE
kenocgeamgnaphidhg	TRUE
kpekecnaimjacmkjfg	TRUE
kpfclbfhilhnoionjc	TRUE
ljcmgjbepfadfkeejg	TRUE
ljeeeooipglepnhebg	TRUE
meniamkillfdnonldm	TRUE
meoghomdfbhdcldnjo	TRUE
mobpbbcjjjgnlpdedl	TRUE
mochcklfeoijpbaojk	TRUE
niibgnbpdaoobdakpp	TRUE
niicagbbpicapkceke	TRUE
oclkoaimpgookaipjh	TRUE
ocnegkamheboiinokp	TRUE
omgodckgjjnojfhcda	TRUE
omjjmgdfgcgdjhaohc	TRUE
pgebdoilllencjmkho	TRUE
pgejheajnnlghmhimb	TRUE
aaabeifhglibijpabc	FALSE
aaajfhepddkkondabc	FALSE
ajgaknhldahnbajabc	FALSE
ajklkafekaihilbabc	FALSE
bdcbmpihhhlkbafabc	FALSE
bddjlfdjgilinjjabc	FALSE
bnknmhopapodfhiabc	FALSE
bnlahccamiaejhgabc	FALSE
cikjehdfmeohefbabc	FALSE
cileakkifimfodiabc	FALSE
ddnlhafencpcahmabc	FALSE
decgenhnppgdknlabc	FALSE
dogkgkeilagfbjaabc	FALSE
doipjgkoeomfgglabc	FALSE
eikjlcacdmeafhdabc	FALSE
eikjnclgbpdoibeabc	FALSE
fchcdahacfmllppabc	FALSE
fchjemkidpnmobeabc	FALSE
fneoldpfgoddcndabc	FALSE
fnfpiimpnhefingabc	FALSE
ghiclpodkkdjgpbabc	FALSE
ghjajbmipcamemcabc	FALSE
hampaemiccojmbiabc	FALSE
hankfkgplebebjfabc	FALSE
hlbodoehppapmmjabc	FALSE
hlcbgoaclffpmceabc	FALSE
ieofcdaponolhlfabc	FALSE
ifccdllpoleahgaabc	FALSE
ipcmjcbjjbnohkcabc	FALSE
ipdjneeiomjhajlabc	FALSE
jkhgkfhblakeoibabc	FALSE
jkiioklkjjdmbobabc	FALSE
kfiohgaoiebnibmabc	FALSE
kfjmbhcmmhdppddabc	FALSE
lafoibnonjochbbabc	FALSE
lahanfdmpengdplabc	FALSE
ljghjagddocikloabc	FALSE
ljhkcnajkekdaohabc	FALSE
mdinbleaomddadkabc	FALSE
mdjojlcdnlhkcbabcl	FALSE
mnhkhgpfbnpmlbpabc	FALSE
mnikpmmhcmheljbabc	FALSE
nhmmdgcemabkcplabc	FALSE
nhnfphkaihbkmgdabc	FALSE
obcpilcekcnbmllabc	FALSE
obeabplnbkfignlabc	FALSE
okpnfodagklebjlabc	FALSE
okpnogmocdmpnafabc	FALSE
pfefkijpklheocfabc	FALSE
pfgbbpebfcbnopiabc	FALSE
aaabfifhglibijpfhep	TRUE
aaajddkkondeoihfngb	TRUE
ajfmahcblgpedmnfpgl	TRUE
ajfnlinljamhkngknfc	TRUE
bcmejjigaopmiklolme	TRUE
bcoljechdnnciobmbdd	TRUE
bnjgfmejogdgkgfcecg	TRUE
bnkogldlmdimnnndibo	TRUE
cjbkeinmodbelefmake	TRUE
cjblkmadofhiamjhhfi	TRUE
dedkljbdamafpmkfmpj	TRUE
deehahfcelppgohhpeo	TRUE
dojaimaeegomgmmenbl	TRUE
dokafgklkojjmogfidp	TRUE
eikjgijcofnmncbepmd	TRUE
eiljpcibjdfgnklgpoo	TRUE
fcgbdjoplinhcaehjah	TRUE
fcibidfbeeiebjeegdd	TRUE
fmfmcaoeahbjdpjkngh	TRUE
fmgofmkjbgjmgiaolck	TRUE
gggckgdejfkkmcfdipm	TRUE
gggmfjbghdohffdpddj	TRUE
hbgbaoenfdimgdgfnoa	TRUE
hbhnkddjbigjllliimn	TRUE
hljfoclpakbmpkjcfhn	TRUE
hljkoblepaldbahglib	TRUE
ifdndejhbcnmogmdmkm	TRUE
ifdninpialmikeokepb	TRUE
iphakhjbhndakiejfff	TRUE
iphifnalhpcphhealho	TRUE
jliombpcchnejohfihm	TRUE
jljodchbgmomdjhfipb	TRUE
kgabdccdmdnhcnlopaj	TRUE
kgaedocgnphlidfknih	TRUE
laekocodmigjfjgdkmb	TRUE
laflfckcmgnjbgjfadf	TRUE
lkankaklmknbabnnnfo	TRUE
lkbdagklebjlgmocdmp	TRUE
medepecbmdoeldccfgh	TRUE
medlionbgmeajnknigm	TRUE
mndfcanodnpmclhdlmm	TRUE
mneeihflelodnajfnei	TRUE
ngjlmeakbfjeglcndgc	TRUE
ngjlodafdccgmepoeei	TRUE
obcnhajpkgboakklgbp	TRUE
obcomlcjfngkhmpkfkn	TRUE
oknhlpcpalfeejmnkgi	TRUE
okninoeahfmmaiclojl	TRUE
pgemcbpkphkdebgkeip	TRUE
pgfigpefjmeacocpjfp	TRUE
aabfghmbogpgndloabc	FALSE
aacaaejepgfegognabc	FALSE
akgnaebbdnemlgedabc	FALSE
akhepnphgjjjjoikabc	FALSE
bdplilkkpbggphemabc	FALSE
bebadofldoanjkedabc	FALSE
bonjoepbkfcgfnnmabc	FALSE
boobniifbceflomfabc	FALSE
cjikckbhejbbmfaoabc	FALSE
cjjpdbaeffmodnimabc	FALSE
deidgbdcpkfimppkabc	FALSE
dekjofjoajdkbfokabc	FALSE
dpilnajbdcfnflefabc	FALSE
dpjbomlmombfcclgabc	FALSE
ekahifpchllocliabcl	FALSE
ekbnbdogkehdegeabco	FALSE
fcmblmponpfkpmkjabc	FALSE
fcodpbmmalcgnfgnabc	FALSE
fmnhoflpgcgmlpioabc	FALSE
fmobibelkingemgiabc	FALSE
ggnkjachjcngiohhabc	FALSE
ggoipinklpioiejhabc	FALSE
halcnokkbllahjheabc	FALSE
hamcanijgcnemjnoabc	FALSE
hkmolcolobgbdigfabc	FALSE
hknkfkmhpohpddmoabc	FALSE
ifcnjbgfmlmdjbfcabc	FALSE
ifconenechkpdenlabc	FALSE
ioockghbjcjggoliabc	FALSE
ipaldipcdlagidhmabc	FALSE
jjeojclgapkahfnmabc	FALSE
jjfndhgfaampleocabc	FALSE
kedplmcdenjiecchabc	FALSE
keficllapgekhkgnabc	FALSE
knpjikhgeceagdmbabc	FALSE
knplkmchjijaoebbabc	FALSE
lhojaekfkakfpokfabc	FALSE
liaidfdfdjdjnoggabc	FALSE
mcikfkcadhcmpnanabc	FALSE
mcjclmgmknccopaiabc	FALSE
mmpmokiiokfpnjcjabc	FALSE
mnacdoofjhmlpefeabc	FALSE
nhghehnobgoddphmabc	FALSE
nhgjkdmbbapmgpbhabc	FALSE
obkjfgcpongmdaniabc	FALSE
oblinkjhmlneliaabcd	FALSE
olmijndccgcakomdabc	FALSE
olmnhpgmcafcbhemabc	FALSE
pfiajbacjkdplmilabc	FALSE
pfiooalkdbdcmknbabc	FALSE
