aacpdpifak	TRUE
aafnhkoabk	TRUE
akafcfpabg	TRUE
akbjjklgko	TRUE
bfiecgjdjh	TRUE
bfkgoejdbj	TRUE
bpjenpnmkc	TRUE
bpjhfifopc	TRUE
cjkkchlnin	TRUE
cjkopmoddb	TRUE
dddiiboilm	TRUE
dddnopdlop	TRUE
dpibnhbmoc	TRUE
dpinhpbojl	TRUE
eijkkjjlfi	TRUE
eiknnffdcp	TRUE
fcdcecinfo	TRUE
fcdhgeohcj	TRUE
fmkbekcppa	TRUE
fmkdamdbbh	TRUE
gfnjcambnk	TRUE
gfnnlepoha	TRUE
haondhljip	TRUE
hapbpimcoe	TRUE
hlceeceljk	TRUE
hldacgalpd	TRUE
ihdpplfhba	TRUE
iheaannpko	TRUE
ippnlllahl	TRUE
jaajlnhgdo	TRUE
jjofecpbdf	TRUE
jjoimclcmd	TRUE
kenhjoimep	TRUE
kenphhkaam	TRUE
koboipmpch	TRUE
kochbelhfp	TRUE
licchjcilf	TRUE
licjenoabj	TRUE
mconcbebpi	TRUE
mdadjabmil	TRUE
mmelmpndkd	TRUE
mmfagloecj	TRUE
ngglpdkkpj	TRUE
ngheceflhd	TRUE
ocdihccaob	TRUE
ocfmmgkpfh	TRUE
ollkldpfli	TRUE
olmdilmkkk	TRUE
pgegaaadkk	TRUE
pgfnhejhfm	TRUE
aacpdpabcd	FALSE
aaffakabcd	FALSE
akamllabcd	FALSE
akbcegabcd	FALSE
beepkfabcd	FALSE
befjklabcd	FALSE
bpddhaabcd	FALSE
bpdmbbabcd	FALSE
cjmnccabcd	FALSE
cjndjhabcd	FALSE
ddmmekabcd	FALSE
ddnfmlabcd	FALSE
dpchoiabcd	FALSE
dpeehbabcd	FALSE
eiilgoabcd	FALSE
eijhelabcd	FALSE
fbnaceabcd	FALSE
fbnamiabcd	FALSE
fllopkabcd	FALSE
flnebmabcd	FALSE
ghcbekabcd	FALSE
ghcjdmabcd	FALSE
hbmoegabcd	FALSE
hbmpedabcd	FALSE
hllckfabcd	FALSE
hllodoabcd	FALSE
ifeanlabcd	FALSE
ifelceabcd	FALSE
ippfodabcd	FALSE
jaadaoabcd	FALSE
jkahjfabcd	FALSE
jkajbbabcd	FALSE
kdpianabcd	FALSE
kdppbiabcd	FALSE
kokggaabcd	FALSE
kolmhjabcd	FALSE
liobbfabcd	FALSE
lipaekabcd	FALSE
mcnonabcdn	FALSE
mcofefabcd	FALSE
mmmhmoabcd	FALSE
mmmmhlabcd	FALSE
nhfmomabcd	FALSE
nhfognabcd	FALSE
ocpjalabcd	FALSE
odbddpabcd	FALSE
omhlaiabcd	FALSE
omiiaiabcd	FALSE
pfgpkpabcd	FALSE
pfhgomabcd	FALSE
aaahegikbac	TRUE
aaahijohfin	TRUE
akmeghnkgkb	TRUE
akobakkbhga	TRUE
bflaekpllkn	TRUE
bfmekghgpjb	TRUE
bplfejdalmd	TRUE
bpnggfmldoc	TRUE
cjibpahooho	TRUE
cjjeellefji	TRUE
dcdopjcokko	TRUE
dcfakcnonmi	TRUE
dmajcbjbmig	TRUE
dmbegmbhegd	TRUE
egdbmomgggm	TRUE
egdgjnpgdof	TRUE
fagapjikocg	TRUE
fahmfefndmk	TRUE
flbkkempfnl	TRUE
flcehoapgld	TRUE
gfhpnbflenk	TRUE
gfimaefjfhg	TRUE
gnpnkjponhi	TRUE
gobkajmjnod	TRUE
hicjkdceinb	TRUE
hicmgjknmgb	TRUE
idbgcheegpk	TRUE
idcdopmajge	TRUE
inldfllieom	TRUE
inldgfmofda	TRUE
jimecnebbag	TRUE
jimhhhadlee	TRUE
kdgediggfda	TRUE
kdindbalimc	TRUE
koeinmidoed	TRUE
kofbgnjnagm	TRUE
lipdghkknal	TRUE
liphdmjggih	TRUE
mckbpnhpdbh	TRUE
mcnceakhdoi	TRUE
mmogfmlfgbj	TRUE
mmoocihejge	TRUE
ngpcieknndd	TRUE
nhaonaecoci	TRUE
obacjnkpamf	TRUE
obbaoclfbpn	TRUE
ollipbmdlml	TRUE
ollljchpjhd	TRUE
pfpcmhflpnc	TRUE
pgbdhakohae	TRUE
aaahegiabcd	FALSE
aaahikbabcd	FALSE
akljppmabcd	FALSE
akllklkabcd	FALSE
benljiiabcd	FALSE
bepdlebabcd	FALSE
bpkdpkfabcd	FALSE
bplicnjabcd	FALSE
cjkkjjlabcd	FALSE
cjlmdcaabcd	FALSE
dcgdpnpabcd	FALSE
dchggdeabcd	FALSE
dmfphmiabcd	FALSE
dmhbbfpabcd	FALSE
efmnjcjabcd	FALSE
efoifgeabcd	FALSE
fafgmplabcd	FALSE
faflmfgabcd	FALSE
flbjhcfabcd	FALSE
fldclofabcd	FALSE
gempiclabcd	FALSE
geninipabcd	FALSE
gojegalabcd	FALSE
gojlkphabcd	FALSE
higenaeabcd	FALSE
higghjpabcd	FALSE
icjnlimabcd	FALSE
ickkbkoabcd	FALSE
inldckfabcd	FALSE
inlimamabcd	FALSE
jikacheabcd	FALSE
jikdanhabcd	FALSE
kcplpdlabcd	FALSE
kdaeaedabcd	FALSE
kodjnlkabcd	FALSE
koejilnabcd	FALSE
lhifjkiabcd	FALSE
lhifmeoabcd	FALSE
mcjbkcnabcd	FALSE
mcjeamiabcd	FALSE
mlmenjgabcd	FALSE
mlmhjhjabcd	FALSE
nghinmdabcd	FALSE
ngidfplabcd	FALSE
oaoobnhabcd	FALSE
oapabhdabcd	FALSE
olkepeoabcd	FALSE
olndgneabcd	FALSE
pfllcdnabcd	FALSE
pfnjhcdabcd	FALSE
aaahegikbacj	TRUE
aaahiohfindm	TRUE
akloelgflcfo	TRUE
akmdklckjeff	TRUE
belmghbadlmc	TRUE
bencoamcdaop	TRUE
bpeonnpeppgn	TRUE
bpidahnpcghm	TRUE
cjjbklmfcepm	TRUE
cjjgbncmenkp	TRUE
dclhaoelipah	TRUE
dcmjfmigjekb	TRUE
dmafpakjchgk	TRUE
dmbbklkecndo	TRUE
egfgfpnlfhoo	TRUE
egghglmdljih	TRUE
failjpmcmpmd	TRUE
falkdfoaddkl	TRUE
fkiiedehhfln	TRUE
fkiplncoeggi	TRUE
gelfhnkhceje	TRUE
gembadnndoci	TRUE
gnpipmloahgp	TRUE
gnppimbpocdo	TRUE
hicbcnbmbche	TRUE
hiefcimhnbbg	TRUE
icklijpfaajl	TRUE
icmnlcboplld	TRUE
ioaadcnpbadn	TRUE
iobokocjfmhc	TRUE
jijilnjgmkji	TRUE
jikegoknhjhb	TRUE
kcpfccbebifg	TRUE
kcpggafnjdpl	TRUE
knonohilekch	TRUE
knophadkhgfl	TRUE
liiplelhplad	TRUE
lildanaeponm	TRUE
mcfolkonnmea	TRUE
mchaekmheama	TRUE
mmdnpoccgpag	TRUE
mmechmpochkd	TRUE
nfonhabanhmo	TRUE
nfpkdncnojek	TRUE
oamiinceigjo	TRUE
oanchedphoea	TRUE
olabnmnlnmao	TRUE
olanaldaiphb	TRUE
pfjholjhidjk	TRUE
pflmhiijlnhm	TRUE
aaaaalelabcd	FALSE
aabbjichabcd	FALSE
akojfjplabcd	FALSE
akomafbbabcd	FALSE
bfgbogjhabcd	FALSE
bfhehkifabcd	FALSE
cbigjhnabcdc	FALSE
cbimeoenabcd	FALSE
clddgjgbabcd	FALSE
cldnggaoabcd	FALSE
dfdgpblpabcd	FALSE
dfdnagmgabcd	FALSE
dpcdbdjaabcd	FALSE
dpcecgbiabcd	FALSE
eifmkiehabcd	FALSE
eigapfmbabcd	FALSE
fbanbpceabcd	FALSE
fbanodffabcd	FALSE
flhgknpjabcd	FALSE
flhhplmlabcd	FALSE
gfjomhohabcd	FALSE
gflcpnchabcd	FALSE
hablibgjabcd	FALSE
habliefkabcd	FALSE
hlakcepbabcd	FALSE
hlanjhhfabcd	FALSE
idkkjcenabcd	FALSE
idmhjdbaabcd	FALSE
ioigolcoabcd	FALSE
ioihifdabcdo	FALSE
jjblickjabcd	FALSE
jjccmpamabcd	FALSE
kdhbpepiabcd	FALSE
kdlhmjpeabcd	FALSE
knjccibbabcd	FALSE
knjdblblabcd	FALSE
lhamcdkhabcd	FALSE
lhaofigeabcd	FALSE
mclandhlabcd	FALSE
mcnjdeinabcd	FALSE
mniagckjabcd	FALSE
mninhfpnabcd	FALSE
nhmcgbhhabcd	FALSE
nhmehaglabcd	FALSE
ochcoolaabcd	FALSE
ochjcijlabcd	FALSE
omkhdgpdabcd	FALSE
omkiboalabcd	FALSE
pgjfibbfabcd	FALSE
pgjnhmefabcd	FALSE
aaaaalelbjjic	TRUE
aabhiflgmoccn	TRUE
akpbaefdnkbnp	TRUE
akpjehjobppbd	TRUE
bflfpdcgcpkfe	TRUE
bfmhhnafnhpnd	TRUE
cbcdahoghdgeh	TRUE
cbfnmmlenjgac	TRUE
cliokobhoiiei	TRUE
cljcongjpdbin	TRUE
dfenapkngkknd	TRUE
dffeelnafffed	TRUE
dpghbncfclklc	TRUE
dpgoobepeckec	TRUE
ehledlooclcnn	TRUE
ehlnlkphpblfi	TRUE
fbambknggpdjh	TRUE
fbcapjbnggfih	TRUE
flnbmjapelalm	TRUE
flocccofnaibk	TRUE
gfjmbbblblipe	TRUE
gfkgadjpjoeam	TRUE
haeafmkanjdni	TRUE
haejngdlbgknh	TRUE
hjpeboaneibac	TRUE
hkamoeapkiecp	TRUE
idfagfgmiojke	TRUE
idgefhhhmdafn	TRUE
ioneekpdhnppn	TRUE
ioogilkcpbiik	TRUE
jjggoaikdgapp	TRUE
jjgpipgdiegim	TRUE
kdjmcipcncnmg	TRUE
kdkcjpmoalgga	TRUE
kmpjacfiedboa	TRUE
knagkgfoeoljf	TRUE
lhcagfdmacpcf	TRUE
lhcdnhhligkfj	TRUE
mcpcebkicibaj	TRUE
mcpjliahboeea	TRUE
mnhamkbegioop	TRUE
mnicblfnchphh	TRUE
nijkdnemlanmh	TRUE
nijmcgckgjhnf	TRUE
ocegkbopfdfko	TRUE
ocgfenjjjmphd	TRUE
omnlnajjeddci	TRUE
omoacnfdpompa	TRUE
pheegkhdkijjf	TRUE
phgiflaebmike	TRUE
aabmabldcabcd	FALSE
aacjhkaagabcd	FALSE
amelflokfabcd	FALSE
amfacifnmabcd	FALSE
bgbajflcnabcd	FALSE
bgbcglgnaabcd	FALSE
campmaphjabcd	FALSE
canijhndkabcd	FALSE
clbigapfeabcd	FALSE
clcekeldjabcd	FALSE
dfegdiankabcd	FALSE
dfekbbfljabcd	FALSE
dpocnphpabcdn	FALSE
eaampnddlabcd	FALSE
ejkojblddabcd	FALSE
ejmdfhcofabcd	FALSE
fclgbkglgabcd	FALSE
fclkiadakabcd	FALSE
fmgghocpdabcd	FALSE
fmgpnedclabcd	FALSE
gfngmfmnhabcd	FALSE
gfoegnfldabcd	FALSE
gpochjdpeabcd	FALSE
gppjdkoliabcd	FALSE
hldhdelmlabcd	FALSE
hlffgaehkabcd	FALSE
ifbgngfekabcd	FALSE
ifchpdeecabcd	FALSE
iomhpbbnpabcd	FALSE
iommneifoabcd	FALSE
jionejfjlabcd	FALSE
jipdbfcdgabcd	FALSE
kbjcindkmabcd	FALSE
kbkjkafcjabcd	FALSE
kmhldemjiabcd	FALSE
kmiagjcdpabcd	FALSE
lgedlfgcbabcd	FALSE
lgepgpbalabcd	FALSE
mccfjkgfgabcd	FALSE
mcdbbbdepabcd	FALSE
mlllccjefabcd	FALSE
mlmklfgmlabcd	FALSE
nfoffjkihabcd	FALSE
nfolmfhipabcd	FALSE
oadalndkiabcd	FALSE
oaeagofipabcd	FALSE
olebjobdmabcd	FALSE
olefbdenoabcd	FALSE
pepppnpppabcd	FALSE
pfblnlokgabcd	FALSE
aabmabldcjhkaa	TRUE
aacgopedlgailf	TRUE
amdhcbjkfdfgca	TRUE
amdojndfheehob	TRUE
bghppokaphbahh	TRUE
bgiijagcndggga	TRUE
caocpdclojbmle	TRUE
capapkkepcbcbm	TRUE
ckjgkcfppchhhh	TRUE
cknjfakffpidle	TRUE
dgfjamakpafekm	TRUE
dggllojbogofcc	TRUE
dpppiiobmahpia	TRUE
eaafkdoapllljh	TRUE
ejipeodfnhabgh	TRUE
ejkfmoebhadajo	TRUE
fdapgijdmbgakb	TRUE
fdbmgjhkaihoem	TRUE
fmoofjmjehcnjc	TRUE
fmpeapckoekfid	TRUE
ggbmicipappemd	TRUE
ggcemcngaeamoc	TRUE
gpnoachednoajf	TRUE
gpoienklpgocld	TRUE
hleihklhmhfcne	TRUE
hlemolefkldcdj	TRUE
ifbagpcmneoilo	TRUE
ifbamhiimfjiic	TRUE
iofkahbigapmem	TRUE
ioflfpljcccfja	TRUE
jhpepbajpdepao	TRUE
jibgjoojjheill	TRUE
kbmlafjlncflcm	TRUE
kbmngiajmmidgh	TRUE
kmmabjbjehdnhg	TRUE
kmmmfcgdldlcmc	TRUE
lhhohhfejknpmm	TRUE
lhigklebbldaid	TRUE
mcfigfcahkekhh	TRUE
mcfpjgbogfofen	TRUE
mmhabbanpbfofk	TRUE
mmjjfcnekgjhbf	TRUE
ngiopgkjapmmef	TRUE
ngjkbbidjnlbpp	TRUE
oabnnnnaaaogke	TRUE
oachnpbainaapk	TRUE
oldjjjbhmjcmlm	TRUE
oldmjapedmecip	TRUE
pfabcalankkkkf	TRUE
pfbdmbfpcidhkc	TRUE
aacbdenkbeabcd	FALSE
aadghhefbgabcd	FALSE
akjcgdmimlabcd	FALSE
akjenepcpdabcd	FALSE
bepfcdphpmabcd	FALSE
bfapadfdjbabcd	FALSE
bpedbmjmfiabcd	FALSE
bpejneomfbabcd	FALSE
ckaknghhnfabcd	FALSE
ckcfmfamioabcd	FALSE
dechoncfjpabcd	FALSE
decphgoelkabcd	FALSE
dodljcaoacabcd	FALSE
doebedpdbjabcd	FALSE
eiapmfinkbabcd	FALSE
eibghlhclcabcd	FALSE
fcckkdhjpjabcd	FALSE
fcclpoimjbabcd	FALSE
fmnahibklhabcd	FALSE
fmndlocihmabcd	FALSE
ggpioneeanabcd	FALSE
ggpkljljibabcd	FALSE
hakpecebiiabcd	FALSE
halpajoacjabcd	FALSE
hmfmalcjppabcd	FALSE
hmhfccacliabcd	FALSE
igddcimfpabcdg	FALSE
igehlpafdlabcd	FALSE
ipnbcdledmabcd	FALSE
ipoinlphaoabcd	FALSE
jjiklbgbbcabcd	FALSE
jjkamimnmbabcd	FALSE
kddnhooggeabcd	FALSE
kdejbnmbjiabcd	FALSE
knnbdkobciabcd	FALSE
knnibdlkfcabcd	FALSE
ljabjegbdeabcd	FALSE
ljanjfnmfpabcd	FALSE
mckjelgammabcd	FALSE
mckpfenapbabcd	FALSE
mmkaohdgggabcd	FALSE
mmlogoafgoabcd	FALSE
nhfhcalfnfabcd	FALSE
nhfhnncaicabcd	FALSE
obhbiookkkabcd	FALSE
obhjcceoecabcd	FALSE
okfmlmgoplabcd	FALSE
okgjicpkgmabcd	FALSE
pfgonmfdlfabcd	FALSE
pfhbedeicfabcd	FALSE
aacbdenkbeghhef	TRUE
aadbgcmodlnmbgd	TRUE
akjnljeadhdgkbh	TRUE
aklihhaabadbjha	TRUE
bdonkciigpmdheo	TRUE
bdpaofehnakgcid	TRUE
bpbmochahpmepff	TRUE
bpbpphhlcnihcea	TRUE
cjkilpieghklfok	TRUE
cjkkilkjilefojf	TRUE
defiakhefcflccn	TRUE
defkjcefjcdkipm	TRUE
dobflhjenibbdeh	TRUE
doblkalnbpapeoo	TRUE
ehpmcempigmpfce	TRUE
eiallfmpfpngdjg	TRUE
fccmjlgocbenonn	TRUE
fccnepcnojjmahk	TRUE
fmhbheodllkbiog	TRUE
fmheeghkflhpfic	TRUE
ggobndjacfbaief	TRUE
ghcaakbggfblfhf	TRUE
hajmljimkcjkjkc	TRUE
hakdjjegpgbjmab	TRUE
hlgicanchiiocbc	TRUE
hlgmgfickcnicbn	TRUE
igommocipnhjejk	TRUE
igphagamjocoldc	TRUE
ipmjckgjjobbnmc	TRUE
ipmkggfempponbb	TRUE
jjmfinljnldaccc	TRUE
jjmocgigdjdpjli	TRUE
kdgbfckcabmknbp	TRUE
kdhkphiicknbclj	TRUE
knnmhhjapnbplmf	TRUE
knojpnbclflgmka	TRUE
lijnmbcgibgjjhi	TRUE
lilbpjfjombbgon	TRUE
mcmiceaabmpdfff	TRUE
mcmliogikokfkco	TRUE
mmmonbnogpbkkjm	TRUE
mmobbbhgeogenho	TRUE
nhchlfkfeahfblp	TRUE
nhcinjkhgeijhek	TRUE
obilomikmclookd	TRUE
objbengckdkhipd	TRUE
oliaehipgikcfdd	TRUE
olikhblmdjgihdc	TRUE
pfgeegfdknikodc	TRUE
pfhmjknfahojakb	TRUE
aaacgheafkoabcd	FALSE
aaafdgadaheabcd	FALSE
akeiemhgdfoabcd	FALSE
akejaagckndabcd	FALSE
bfbehoaooanabcd	FALSE
bfgjemchadpabcd	FALSE
bpmbcfddgjhabcd	FALSE
bpmegnalbkaabcd	FALSE
ckaiemojfaaabcd	FALSE
ckakkoegibgabcd	FALSE
dejdlhahkbcabcd	FALSE
delgjgbjefcabcd	FALSE
dnmhdlpgjkeabcd	FALSE
dnoojpmhjahabcd	FALSE
ehgdjaknggoabcd	FALSE
ehgicnecfekabcd	FALSE
fbdmmdkbfjpabcd	FALSE
fbdommafldiabcd	FALSE
fjmgmbgjlgnabcd	FALSE
fjmjmbmjjfcabcd	FALSE
gdingeflndnabcd	FALSE
gdjcggipeedabcd	FALSE
gnjbdilackmabcd	FALSE
gnjhbjdcflbabcd	FALSE
hifoiidglpaabcd	FALSE
hiijlcmngacabcd	FALSE
iddlkefkelkabcd	FALSE
idfckmhfhlpabcd	FALSE
infmjhhndcfabcd	FALSE
inhfbhajbjmabcd	FALSE
jgfcikimdllabcd	FALSE
jghhknbbodpabcd	FALSE
jphahpmgkkfabcd	FALSE
jphejbhdfmjabcd	FALSE
kjkhjpieeajabcd	FALSE
kjmobdmkafkabcd	FALSE
ldpbdkhceomabcd	FALSE
ldpdefimhmeabcd	FALSE
lolckhppppabcdi	FALSE
loldajimbceabcd	FALSE
mjfpjfoehojabcd	FALSE
mjhoplkcmigabcd	FALSE
neiiecmefmabcdi	FALSE
nejglmomhffabcd	FALSE
noghjhchipcabcd	FALSE
nogkdkaigpcabcd	FALSE
ojjdmodahleabcd	FALSE
ojjpbcfefbhabcd	FALSE
pdjleapaopdabcd	FALSE
pdppdhgaahlabcd	FALSE
aaahgbhlepmahphl	TRUE
aaaidhfleefmjpak	TRUE
aknaipaoblkgfkhp	TRUE
akpggfgnpokgjpgg	TRUE
bfbohgocjlnikbih	TRUE
bfcekkpegdigfjfi	TRUE
boohnhjcgfbddnni	TRUE
boojdoajhkmeobao	TRUE
cjmfffpmfbpoledi	TRUE
cjmhdkokdiimbked	TRUE
dehfokkcfdahebbg	TRUE
dehidmlccnpmkenf	TRUE
dookeojfmloplpah	TRUE
dophdoalkkofnbcp	TRUE
ejfnldalmkmnhgcl	TRUE
ejgfnnbfahjnbebg	TRUE
feghadkicdhelcgb	TRUE
feghpegpdpopihfo	TRUE
fnmbmeiheoeoindk	TRUE
fnnkcdajhmcplbfk	TRUE
gicdocadbnpkmadj	TRUE
gicjjeogdlbkehaa	TRUE
hcfmifnnaaanghfl	TRUE
hcgkmhfdlckplkmh	TRUE
hlnennaiipbkmfpf	TRUE
hlnkmhkclmnbimcd	TRUE
ifpgcakjebadjhnk	TRUE
ifpobmjilckklpjm	TRUE
jamdolppdbicodhg	TRUE
jamemclhjllpijej	TRUE
jkdblacecmhkgecj	TRUE
jkficfidigdkcbhj	TRUE
kelbpifhifhcgaip	TRUE
keldhffmfmmocdii	TRUE
kongiklghdegbnng	TRUE
koobcmgmopcnlemc	TRUE
ljgfimoalekdpgga	TRUE
ljgojcmdpjhbeghj	TRUE
mechckgpghfbehid	TRUE
mecnjdmkhfnmkehi	TRUE
mnmgaocablmbgmdn	TRUE
mnmjijiainahklcd	TRUE
nicaejkbihpiapdo	TRUE
nidmlbbjjgeppbnb	TRUE
obocmfoofhicidoh	TRUE
obpeekfaiggbdpgj	TRUE
olbnllaojdkdljnd	TRUE
olclgnhgkhefmfmj	TRUE
peeamdgidfdmobgj	TRUE
peefdnfmohcdkmcj	TRUE
aaahgbhlepmabcdp	FALSE
aaaihldhfleeabcd	FALSE
akobjbikjjheabcd	FALSE
akoijgfddnodabcd	FALSE
bfdjpoeephgabcdk	FALSE
bfeadkaagmclabcd	FALSE
booegnhjidggabcd	FALSE
bopblfjkhgonabcd	FALSE
cjjmdhjohejhabcd	FALSE
cjlhjcgfbddnabcd	FALSE
deggplfckbdbabcd	FALSE
dehbhndbkiphabcd	FALSE
dohfgaejdnojabcd	FALSE
dokegnlbnaniabcd	FALSE
ejenenbkopciabcd	FALSE
ejeodhmfgmfbabcd	FALSE
fenfnbcpipdmabcd	FALSE
fenkckbmiijeabcd	FALSE
fogmfkddbmgpabcd	FALSE
fohfiemaonidabcd	FALSE
giimdinedbjbabcd	FALSE
gijolbidmgldabcd	FALSE
hcfhegpdbadlabcd	FALSE
hcfhnfondnleabcd	FALSE
hlokobblbnelabcd	FALSE
hmahalichdkpabcd	FALSE
ifjamnaolbdkabcd	FALSE
ifjdllnaldhlabcd	FALSE
janjonjeicoaabcd	FALSE
jbaflkigecaeabcd	FALSE
jlancecmblamabcd	FALSE
jlbmeepjkjeabcdc	FALSE
kebgakbepfniabcd	FALSE
kebpkbclcimbabcd	FALSE
kojhcojaipbabcde	FALSE
kokafifdddhoabcd	FALSE
lileklcplhgaabcd	FALSE
lilmclnmekpcabcd	FALSE
mdjbebpiflafabcd	FALSE
mdlgmooofampabcd	FALSE
modhijconoafabcd	FALSE
modhpcgjkdliabcd	FALSE
nhlleohdbbekabcd	FALSE
nhmakmcnchnabcdp	FALSE
obmmmkifklonabcd	FALSE
obnapafkmkjfabcd	FALSE
oldioeefedllabcd	FALSE
oldndbjnpbpeabcd	FALSE
pfnaagicjpgcabcd	FALSE
pfoiokaopikabcdi	FALSE
aabfocdjphdjfgenm	TRUE
aabgmfjclegdgbnkk	TRUE
akompmnohhlpldjpb	TRUE
akpgflbcnhkbdcdhp	TRUE
bedmdicdlddaplkmm	TRUE
befifdfimamnkmplj	TRUE
bpolhalcnoiaafmmb	TRUE
bppfchclpciibgdnj	TRUE
cjojlibkooebceppo	TRUE
cjolcpljbekilefko	TRUE
ddpneooeoaaelogdi	TRUE
debmmpcdpgigjopji	TRUE
doaadldjbcgnkbeji	TRUE
dobaaolgdcnpdnmak	TRUE
eilfglppjkfljhefb	TRUE
eimbpcofbinchalgg	TRUE
fcmdcjomgjpkinnaf	TRUE
fcolidlkeecehhchh	TRUE
fndcfiiomieacldjj	TRUE
fnfagkpcpjbgnelon	TRUE
ghjljkmojhonhpaam	TRUE
ghkaanphgnklknfla	TRUE
hbdodnlgcbghiokoo	TRUE
hbehnkfednonmbmkm	TRUE
hlfamdmcmjpfomanp	TRUE
hlfdjoldkbbckognp	TRUE
ifjnjnlfnndlpkkef	TRUE
ifjofheajniapdmbk	TRUE
ipcjhakilppahmpkd	TRUE
ipehhcofbamammbgn	TRUE
jjoeclpioebjlojmm	TRUE
jjpkolghmknhomkhe	TRUE
kdnclppncpcogimjg	TRUE
kdngbkmabgmabhpna	TRUE
kolhdnemkcggaapph	TRUE
komndfbfpbebmpnoe	TRUE
ljjminofbdghbeepm	TRUE
ljldaladcojjkdiak	TRUE
mdcfjbgiphpefjhho	TRUE
mdfdffcilocmkoeha	TRUE
mmjhgfhajmghgdoak	TRUE
mmkdobeephadihmlk	TRUE
ngiailjjikgpimjjk	TRUE
ngjaenplahbkeciho	TRUE
oangginnhoeckggeo	TRUE
oaoebhlfhofmiebea	TRUE
okocmbblndbiclhjj	TRUE
okpehoingdhbogdjc	TRUE
pfpgablbkchlnlbmd	TRUE
pgaamnlliopjiophp	TRUE
aacdcljmphoclabcd	FALSE
aaecppeodgihiabcd	FALSE
aklllfmahkgoiabcd	FALSE
akmbbnjhlplehabcd	FALSE
beknappcnbafoabcd	FALSE
belfdkeaminbkabcd	FALSE
bphgnpbapnkabcdnn	FALSE
bpilghlhfokjpabcd	FALSE
cmabdbldobecfabcd	FALSE
cmbfgpnplfckiabcd	FALSE
dgchlpaohajbkabcd	FALSE
dgcngakfokjajabcd	FALSE
dpnbamjnobhhlabcd	FALSE
eaahmaleglobcabcd	FALSE
ejpdenklnjohhabcd	FALSE
ejpgmdgeoaffeabcd	FALSE
ffbfnmoehflfpabcd	FALSE
ffcmdcaohecnnabcd	FALSE
fopiiblflnadfabcd	FALSE
fopmbfoacdeooabcd	FALSE
gjccoigjbagopabcd	FALSE
gjdcdckaemkeeabcd	FALSE
hebphbcfnjijbabcd	FALSE
hecmpakieemgjabcd	FALSE
hoheaddheepbpabcd	FALSE
hohndhccipcopabcd	FALSE
ihppilidglcegabcd	FALSE
iiaccbdcjcfjjabcd	FALSE
jbfplmoecofdcabcd	FALSE
jbibhfhbjclkhabcd	FALSE
jmbojgdcdebmabcdi	FALSE
jmcagaeehenaoabcd	FALSE
kghclpbfehiplabcd	FALSE
kghdpoolhgdjgabcd	FALSE
kpocfpfdhbbhiabcd	FALSE
kpoeckjbfkcodabcd	FALSE
lkbbmeeecamphabcd	FALSE
lkchadjeombkkabcd	FALSE
mdkphjjbkfhplabcd	FALSE
mdlfflggjmbcbabcd	FALSE
mnbpngppgkmniabcd	FALSE
mndahfecifajmabcd	FALSE
nidmdnnaldaipabcd	FALSE
niebbdinabdfhabcd	FALSE
ocfobijbehakpabcd	FALSE
ochfeaeodljghabcd	FALSE
omkopebbchngdabcd	FALSE
ommieglhoolphabcd	FALSE
pgemjemkiajafabcd	FALSE
pgenadphnblfjabcd	FALSE
aacdcljmphoclcdppe	TRUE
aaedgihihmnhehbgdd	TRUE
akljiklpmkpddjkcec	TRUE
akljkngmclekfplcfh	TRUE
bfknabhfaneepmennl	TRUE
bflhlnmkjhopgaecih	TRUE
bphiimchgjadjkimhi	TRUE
bphjdbifhnjcbghdbn	TRUE
ckkdjklehnplhddkoa	TRUE
ckklhmcllkjmojnioi	TRUE
dffppmccadnhekagfb	TRUE
dfggfkdafggcjbopmb	TRUE
dpnohmnojcbmpkcphd	TRUE
eaaaficgcgooacijko	TRUE
ejkknnjbdmgjhfbdcb	TRUE
ejlfadhdphcgjhkegm	TRUE
fffdckkddhoejhafeb	TRUE
ffhoeigeblpflelpjh	TRUE
fonpgmokmlbpknmghf	TRUE
fopefemongkibdfbch	TRUE
gjccnobealgdpiibpm	TRUE
gjchcfgnkifnkcckel	TRUE
hcgfibnjeoeohkljim	TRUE
hcjemocajennfifnfd	TRUE
hnlbcclpppghigeijn	TRUE
hnpchahmhiagkclmnp	TRUE
iiaefonihanmobgmnk	TRUE
iiakcanmfppkehmlim	TRUE
jblnifondkkidkkjfn	TRUE
jbmjfhlbnailpkcekb	TRUE
jmgfkilokgfdcclice	TRUE
jmhhpghjahmhagjbjb	TRUE
kfpbbfmimbmbbmlnpc	TRUE
kfpbndneelfdgponjk	TRUE
kpkabbbieohlfippph	TRUE
kpkoaimlcecdoofhba	TRUE
ljhffkpicikbfpibng	TRUE
ljiehoeolcokjklppl	TRUE
mddpoealdieajgpgcj	TRUE
mdfbpkbpgmegiagkjl	TRUE
mnhggdldmnbapbhepi	TRUE
mnkfplhcdjdnafaffd	TRUE
nibibebnnihdnelofh	TRUE
nieejncfmecmlgdjja	TRUE
obiogcankdfhkdkaio	TRUE
obkkjggpfjpbocfcpc	TRUE
onbpbbkkllkpadhikl	TRUE
onccdkmdmboipjnjoe	TRUE
pghpdpjklhocehbmgc	TRUE
pgklpfaadpfoegjhln	TRUE
aaacmeoppmpdejabcd	FALSE
aaaifilamhcipgabcd	FALSE
ajfdkahhooedffabcd	FALSE
ajfnhkfffpncjabcdi	FALSE
beajccfkplcjajabcd	FALSE
bebeabjhgamnneabcd	FALSE
bpomjckhahpcakabcd	FALSE
bppafoimdlbkgfabcd	FALSE
cjhonalckpimamabcd	FALSE
cjjfpppdhjkoohabcd	FALSE
demdkeabcnabjmabcd	FALSE
denbgbfjeoebfoabcd	FALSE
dnpbnncegihnakabcd	FALSE
dnplnagokageclabcd	FALSE
ehlhaokblgcnhpabcd	FALSE
ehlidfkdgjliclabcd	FALSE
fbompplibmhkmoabcd	FALSE
fcachfakjoenpaabcd	FALSE
flpdmhnlpakdmcabcd	FALSE
flpjhfapdnhkgnabcd	FALSE
ggfihfmpjjdkgmabcd	FALSE
ggfleklcmcagahabcd	FALSE
hbdbiplpnnnpafabcd	FALSE
hbddbjoadiidfaabcd	FALSE
hldficekdobiodabcd	FALSE
hleddfifdgcfghabcd	FALSE
igbhnllibmfakjabcd	FALSE
igbmicdfppjdpkabcd	FALSE
jamckcfhgbjpeoabcd	FALSE
jamdddgcgbhpebabcd	FALSE
jlipaknphnnojgabcd	FALSE
jljecldfkdojinabcd	FALSE
kfpmeoehjaaapnabcd	FALSE
kgaenbhgeeknipabcd	FALSE
kpeneminkhnhkcabcd	FALSE
kpfabipkcbnaikabcd	FALSE
ljgmfgopoeaihoabcd	FALSE
ljhpoddbglbknfabcd	FALSE
mecpeflhkjlalfabcd	FALSE
medclignbcodppabcd	FALSE
mnmlcjgmbnejpbabcd	FALSE
mnnfhbfckfaoddabcd	FALSE
ngkfnkmkmdppegabcd	FALSE
ngkjamloepodhpabcd	FALSE
oalbgjahebfbmfabcd	FALSE
oamecelnkheidlabcd	FALSE
olllhfhkbmdibgabcd	FALSE
olnicochfdmkbabcdc	FALSE
pffmgimgfnnophabcd	FALSE
pfgalnfgdnkemkabcd	FALSE
aabafgimnnefhfhjbfb	TRUE
aaciodcjciaoolmoekn	TRUE
akaiecndepdfikcmpci	TRUE
akapnminlbpeomiinmj	TRUE
bffoemggdipijgdcmcc	TRUE
bfgiamgcdfpijclcebd	TRUE
bpmkjnklldhjlmailag	TRUE
bpmnamlcdgmdeokhojk	TRUE
ckdghodlpghfjmbhedh	TRUE
ckfbapbdifbconegajo	TRUE
ddignbalaphijglilec	TRUE
ddjaaflanmjmonekoii	TRUE
dndhcodjabgnbnadmhe	TRUE
dndhhlkmccopdhmnfmj	TRUE
ehdfolnajikpckgmigi	TRUE
eheinmgocpgnlkmohil	TRUE
fcondkkcjjdaigkampe	TRUE
fdalidhmenhcgbdgcmj	TRUE
fnhbggkmdljjgfheiei	TRUE
fnhcmempfkkhoblgaag	TRUE
ghmnneabccnblbafphm	TRUE
ghobcehnhakjomlonoe	TRUE
hbeimnlpoldkichlohg	TRUE
hbemmhegafiidpjdkag	TRUE
hmebhdcboigifilfabp	TRUE
hmfjmkkppfciejefgde	TRUE
ifkbalioffniknakhaf	TRUE
ifllgbfbbmagihmienf	TRUE
ipioimoghoeopjbonlg	TRUE
ipipjmdjpchnfgoppjo	TRUE
jjinnaappalbeekgdbd	TRUE
jjldkbfnacjpkkiffhe	TRUE
kdgchokmhpcfhifemci	TRUE
kdiilfcjpbimbadjilo	TRUE
knmifcanheokbdffojd	TRUE
knpfdaajloghfbkgnoi	TRUE
lihlbehablgbmpklmhc	TRUE
lijeoabeeajabngdfdj	TRUE
mcopikfdjkkicajbfpf	TRUE
mdaejcpfggidonpoglo	TRUE
mmnhahbdkkoplpoaokl	TRUE
mmopjjbipmipfkafdlp	TRUE
nikbacdoblpbmleekpc	TRUE
nikhghfiikodiapoenh	TRUE
odflkkcflpnmngbgdga	TRUE
odhpcghbhkgmofbdkgf	TRUE
omajnfddhnofbbimlad	TRUE
omckdefnnlbjianhkdi	TRUE
pfopoinifhnglcihffh	TRUE
pfpngkcmpkjbjokkggp	TRUE
aaaaedbgakkjgkjabcd	FALSE
aablpmolmkkhobbabcd	FALSE
akabblemkcehhkhabcd	FALSE
akacfndonocdjmfabcd	FALSE
becmlcnepkjbldhabcd	FALSE
bedhgbacjadkcngabcd	FALSE
boancfpcoigpaiabcda	FALSE
bobikedoeljelbbabcd	FALSE
chghhpooehgplpnabcd	FALSE
chikkbofljhpmohabcd	FALSE
dblnkendockmnhfabcd	FALSE
dbmgajmphiiffchabcd	FALSE
dlijgdihngidffeabcd	FALSE
dlkppjdnkllekgaabcd	FALSE
eggemmhjlpegghaabcd	FALSE
eggfgnjleodgpkgabcd	FALSE
fbdclipjecnbipgabcd	FALSE
fbgekbgnalpeicdabcd	FALSE
fleflannmpcodppabcd	FALSE
flejapdmmfghajnabcd	FALSE
ggeknjojfihjmocabcd	FALSE
ggfeliifeoijlpdabcd	FALSE
hbagalkbnbhbmidabcd	FALSE
hbahojiihddplnoabcd	FALSE
hlbojpgamcdabnpabcd	FALSE
hlcnjohppfmbeipabcd	FALSE
idmpdboncjjjlaoabcd	FALSE
idofkihbeonjbjbabcd	FALSE
iojdncbbjkefkilabcd	FALSE
iojhejheohlfgfjabcd	FALSE
jjhnpenkcapadncabcd	FALSE
jjljkpojcofmfemabcd	FALSE
kegmaijkedindceabcd	FALSE
kegnfopomhbfdeaabcd	FALSE
koejdjedefmbdplabcd	FALSE
koeocaflbiapfccabcd	FALSE
liaehghgnkhclccabcd	FALSE
liajbjphifiejgbabcd	FALSE
mbhehdmkgjmhmnbabcd	FALSE
mbieomfjcpmndpabcdc	FALSE
mliokihmkbpmlflabcd	FALSE
mlipdmiakpkmnelabcd	FALSE
nepckjmhcenmhlcabcd	FALSE
neplnnninbbdehjabcd	FALSE
oajfbcjokbdabmdabcd	FALSE
oajohnokecddfmmabcd	FALSE
olahiaikgklgombabcd	FALSE
olcafhjapihnhheabcd	FALSE
pfidoephaafjgneabcd	FALSE
pfinljcooongapeabcd	FALSE
