aaackdkkea	TRUE
aaccnlplki	TRUE
aknlaggaea	TRUE
akoifphdga	TRUE
bejpmaeamk	TRUE
belchhbada	TRUE
bomkanocoa	TRUE
bommoikdoe	TRUE
cjfeclpdnn	TRUE
cjfnpakbha	TRUE
ddndcdpcbf	TRUE
ddoddgpala	TRUE
docmipbecn	TRUE
dodpggoipm	TRUE
ejcjdgledm	TRUE
ejdigejjaa	TRUE
fdpbodljbf	TRUE
fdpleggbnk	TRUE
fophjhohll	TRUE
foppkajcea	TRUE
gipmlgiaal	TRUE
gjadiigkia	TRUE
hcmmaajnaa	TRUE
hcmoljeoic	TRUE
hlnbjpdhmm	TRUE
hlnmehdana	TRUE
ifofiheaga	TRUE
ifokefkaca	TRUE
iphfgdmhmk	TRUE
iphijjajka	TRUE
jjlemenbbo	TRUE
jjlladfeea	TRUE
kehnmckncg	TRUE
keifbcfhci	TRUE
kojhgekgbn	TRUE
kojhjdania	TRUE
ljaabcfbaa	TRUE
ljaeilknca	TRUE
mcmocbagai	TRUE
mcojogfpkf	TRUE
mnihaojlca	TRUE
mnikmmbmjk	TRUE
nglhojdigk	TRUE
ngnecgjhhb	TRUE
obeinhedej	TRUE
obekkkkiop	TRUE
olbbgmppcp	TRUE
oldkcolckn	TRUE
pfbcpbmmll	TRUE
pfcdciiaba	TRUE
aaaiakmcka	FALSE
aabjehbmga	FALSE
ajmopgjjhi	FALSE
ajockdpada	FALSE
bdjkmklmba	FALSE
bdkkdmjcea	FALSE
boimmheoia	FALSE
bojddpoall	FALSE
cjdmfmebda	FALSE
cjdobjpmna	FALSE
demcdddcpa	FALSE
denfppiiga	FALSE
dpikdngpha	FALSE
dpjbjfogna	FALSE
ekgcjjmkba	FALSE
ekgkeldkfa	FALSE
fdnahillnd	FALSE
fdnlbglpea	FALSE
fnnkhmieka	FALSE
fnoehgmlha	FALSE
giillhnbal	FALSE
gikbjigjja	FALSE
hcfkdjanfb	FALSE
hcggnhbdla	FALSE
hmjlbdgbpa	FALSE
hmjpkdodea	FALSE
ihbhkmalpf	FALSE
ihbibkjdao	FALSE
jbfmfhcbja	FALSE
jbfoinfpba	FALSE
jmanlgjffc	FALSE
jmbcgolpga	FALSE
kgaaaaahmj	FALSE
kgamfnbaca	FALSE
kpjfefffca	FALSE
kpjmkdikea	FALSE
ljgjipfbla	FALSE
ljglpapbek	FALSE
mdpmohobja	FALSE
mdpnbjogga	FALSE
mngbahdicp	FALSE
mngmenbagm	FALSE
nilpokifka	FALSE
nimdppglpa	FALSE
ocjififfka	FALSE
ockoliieha	FALSE
onahdpdnli	FALSE
onbcekiboa	FALSE
pgglpljjfa	FALSE
pghadkeieo	FALSE
aaaiakmckjp	TRUE
aabebmgpmfl	TRUE
ajoledmkeda	TRUE
ajooockjfea	TRUE
bdhpkpfpbpe	TRUE
bdicgefnfbm	TRUE
bokiaaajnoa	TRUE
bokkenolbgj	TRUE
cjeifbaieba	TRUE
cjepgijcafa	TRUE
deodeabbcpa	TRUE
dfbbeonnefg	TRUE
dpdddbciifc	TRUE
dpdpejnnjfc	TRUE
ekdcillbfij	TRUE
ekedngmmlke	TRUE
ffdekklgfdp	TRUE
ffeaonfjkda	TRUE
foeimlonjlj	TRUE
foejikfmgem	TRUE
ghpjeekjdcg	TRUE
giamippiima	TRUE
hcplaibhgla	TRUE
hdadkgbffia	TRUE
hmhlhhpcpen	TRUE
hmicpcddeaa	TRUE
igdmhmiciaa	TRUE
igdpccbalka	TRUE
jbkjpaggpia	TRUE
jbkohfjencc	TRUE
jlhdhibdooi	TRUE
jlifgjidkjf	TRUE
kfojgchokni	TRUE
kfojkognhlg	TRUE
kpmilleflce	TRUE
kpnjokokhcl	TRUE
lkfgpeioddb	TRUE
lkfnkflkdaa	TRUE
mecgckmfofb	TRUE
meclfdopeob	TRUE
moabjiffbha	TRUE
moalfdbldoa	TRUE
nidimmnohjh	TRUE
niedaedehja	TRUE
ocdahodailh	TRUE
ocdfbfklmnm	TRUE
olpofphfhcn	TRUE
omagebfbmea	TRUE
pgioccmjlmj	TRUE
pgjgeejiekb	TRUE
aaaiakmckja	FALSE
aabehbmgpma	FALSE
ajnkknlkddm	FALSE
ajobmklgopc	FALSE
bdmnlekadln	FALSE
bdncpeplcap	FALSE
bofoaeclmdb	FALSE
bogomdlffka	FALSE
cjpimehbabc	FALSE
cjpjaagpnba	FALSE
demoiaaghna	FALSE
deneoapgccc	FALSE
dpcoldiffia	FALSE
dpdlpjnpipa	FALSE
ekagiadglpa	FALSE
ekaiifogpmg	FALSE
fepgffkaapa	FALSE
fepllididca	FALSE
fogfkmdkipa	FALSE
fogpdeacnli	FALSE
gieihfichea	FALSE
gifekdonhoa	FALSE
hcjgkpklmla	FALSE
hcjoddiilpa	FALSE
hmcmahcbign	FALSE
hmhhmhcclpa	FALSE
igmmmepocea	FALSE
igobnbkgeam	FALSE
jbgkicpkafi	FALSE
jbiabcgkkhc	FALSE
jljnppbmnna	FALSE
jllehnaaoao	FALSE
kfbeefamdoj	FALSE
kfboeifpjga	FALSE
kpfiamiopkc	FALSE
kpjboldbila	FALSE
ljmncnkdgpa	FALSE
ljmnlpfjbna	FALSE
meaginpgnek	FALSE
meapkndalba	FALSE
modjmhgpipa	FALSE
moehfjdkcca	FALSE
njjhlbdadep	FALSE
njjmfjbaohh	FALSE
ochacopalfa	FALSE
ochadiajbia	FALSE
omepineknga	FALSE
omfencdmkea	FALSE
pgecodhfjoa	FALSE
pgefldldeda	FALSE
aaaoppjjmoma	TRUE
aabhkfhhaail	TRUE
akoepmfagfhd	TRUE
akoiajoilegc	TRUE
bembeehpimfm	TRUE
bemdeokdajda	TRUE
bpeifmicdlmi	TRUE
bpekipidnpbl	TRUE
cjjpklfbbfjp	TRUE
cjkdojpnoada	TRUE
ddcffoicieok	TRUE
ddclicooplog	TRUE
dnalmogpoeia	TRUE
dnbfalgbcnia	TRUE
ehccegmdoipo	TRUE
ehcckhdnkcaa	TRUE
fboomkjjppib	TRUE
fbpmdhljfblo	TRUE
fnbobebkaoja	TRUE
fncapdfgbjha	TRUE
ghbgeigahema	TRUE
ghcabeidbanm	TRUE
hbgagljiebca	TRUE
hbgahfbbghba	TRUE
hmdmpfgehefn	TRUE
hmfnjfbhngjj	TRUE
ifklbkpfakma	TRUE
ifknkhcfcldj	TRUE
iplklghdomji	TRUE
iplkobdapoja	TRUE
jjppbgiediif	TRUE
jkacoefjfhha	TRUE
kehkembmdhpi	TRUE
kehlpplfhelk	TRUE
koblijofbhaa	TRUE
kobnhkiekikf	TRUE
lhbnchmafpka	TRUE
lhcnnoeaaicb	TRUE
malcodkmoakg	TRUE
maleoafnlcoo	TRUE
mncmbplpmbdb	TRUE
mnggphlkgaba	TRUE
ngiijpfmgoom	TRUE
ngimciddipjp	TRUE
npajifngddpa	TRUE
npammpafgaap	TRUE
ojklbdcbjchp	TRUE
ojkojdfnclcg	TRUE
pfcjdhlmjigi	TRUE
pfeamdicgboa	TRUE
aaaoppjjmomi	FALSE
aabkfhhaaipa	FALSE
aknnomhmagga	FALSE
akomdnapckpa	FALSE
bellfcjldhea	FALSE
belpjbdhooca	FALSE
bpcjoknmnpea	FALSE
bpdfcbabgbpi	FALSE
cjilfppaihcg	FALSE
cjjdkbjjppaf	FALSE
ddaepojdmokp	FALSE
ddambfikobjp	FALSE
dmphoflmnhha	FALSE
dmpnmcpjgcda	FALSE
egofgcdfpkka	FALSE
ehahkndbckfe	FALSE
fcbdefbdmacp	FALSE
fcbgdnmblmda	FALSE
fmjigpbibfca	FALSE
fmkjkdajagfa	FALSE
ghihodpbacoe	FALSE
ghikfmkbikoa	FALSE
hbbcnpeaefdi	FALSE
hbbmhjegnmka	FALSE
hlnnfekmigna	FALSE
hlomaiaaoegl	FALSE
igdcmcofgiba	FALSE
igdkmagbccnf	FALSE
ipjdlfjmilia	FALSE
ipldcijhjcha	FALSE
jjpegphkfnha	FALSE
jjpnjabbebkn	FALSE
keeaekgdklcc	FALSE
keefbedlfdda	FALSE
knolomogflfa	FALSE
knpggppdmbha	FALSE
lhdfpohomkna	FALSE
lhdplobdboma	FALSE
makpcmfmklfm	FALSE
maloibjkghhh	FALSE
mmadgbgfnbdc	FALSE
mmfigdldhnoa	FALSE
ngloppnhfcca	FALSE
ngnkhhaejejc	FALSE
noppklhohgla	FALSE
npadcljecplg	FALSE
okdckclbohja	FALSE
okhidbcpglah	FALSE
pfcgkickkfca	FALSE
pfegfiaelgel	FALSE
aadhedficmcko	TRUE
aaeceampajhei	TRUE
akgjnldfjhpda	TRUE
akhahkadedbna	TRUE
bdhbekdjnalea	TRUE
bdipmdpnineaa	TRUE
bnojegdpghckg	TRUE
bnolikohjjaka	TRUE
cignichbbklgm	TRUE
cihnbmpcmdjen	TRUE
dehoohbckkhke	TRUE
dehpndnlincmp	TRUE
dobchjbmgbolg	TRUE
dobhfnjgaggja	TRUE
ehgjapeffgamh	TRUE
ehgkmbldnfmcg	TRUE
fbefkbhgijjhl	TRUE
fbempgcgmphhk	TRUE
fjohgfahkcnba	TRUE
fkaafjlknhobf	TRUE
gepjckacdkaci	TRUE
gfdlidbjcnghi	TRUE
gpfkooaielamh	TRUE
gpgpepilgjgkj	TRUE
hkcimmnilahna	TRUE
hkekncliajkea	TRUE
iegioledppnem	TRUE
ieididcebplio	TRUE
jabcccnfobjja	TRUE
jabcgakcjiidb	TRUE
jkhnpgphhnkin	TRUE
jkhonjhgcdbaa	TRUE
kebgdehkkmmld	TRUE
kebnmobbablga	TRUE
knmipfmlmflmm	TRUE
knmokbngfnhhh	TRUE
lijkadikmblma	TRUE
likaaapnodpga	TRUE
mdabnmbmhbica	TRUE
mdadbimikbdba	TRUE
mnolhgidfonck	TRUE
mobjddecpnefj	TRUE
nhpkegboakmla	TRUE
niddbkfkbfedf	TRUE
oclnafmalgfej	TRUE
ocnmclcchelbl	TRUE
oncpkamggonda	TRUE
oncpldlbckfjf	TRUE
pghinnbnbcjih	TRUE
pgihbeggimmaa	TRUE
aadhedficmcka	FALSE
aaeceeampajha	FALSE
akgenahadoijo	FALSE
akgmnhlefpfhj	FALSE
bdhfgbmdjjena	FALSE
bdhfmbjapbijm	FALSE
bnoflmljegdpa	FALSE
bnpckfikohjja	FALSE
cifbhdpffldga	FALSE
cifmcinchenma	FALSE
ddnpomldbajeo	FALSE
ddomdccdjkdfa	FALSE
doaghcohofaca	FALSE
doaifapefcjna	FALSE
ehlbabaobfjoa	FALSE
ehlfnijpmnfak	FALSE
fbhlfoeeajbec	FALSE
fbiiekbkjdjoa	FALSE
fkmkjlnmdbhda	FALSE
fkndgnchkilfa	FALSE
gefnmfeemhmea	FALSE
geidingkbnbja	FALSE
gpgchijlkfjka	FALSE
gpgllbhlmdjma	FALSE
hkdfmbocjnkna	FALSE
hkdgeplleckha	FALSE
ifhdjlmjkcnae	FALSE
ifhgafpfpldjg	FALSE
jabnjmfjmpocg	FALSE
jaccnndbeigim	FALSE
jkcbnfbdoemha	FALSE
jkcloofgdehoa	FALSE
kdjaonofkfdph	FALSE
kdjdcnngiikga	FALSE
kodiiebiefefa	FALSE
koegioeclagnf	FALSE
liijkpckoccha	FALSE
likogebgdmfna	FALSE
mdojljacffaca	FALSE
mdoodiacjllnc	FALSE
mnjfgljaijlim	FALSE
mnjjdbfcljafg	FALSE
njlcopmmmdlna	FALSE
njlgeaapabcaa	FALSE
ocgaihmgdnjen	FALSE
ocgfebaanohca	FALSE
omkambbhleopf	FALSE
omldfgajpbogj	FALSE
phadcepghnlgj	FALSE
phbhaadboabop	FALSE
aabebhjphbigie	TRUE
aabihcolijamag	TRUE
albjkkignnhcia	TRUE
albkghfcacgiei	TRUE
bfmgafioenloca	TRUE
bfoembpgblnnmi	TRUE
cadhoopjcdonah	TRUE
cadppdffmpggha	TRUE
cjmnanohjmjpea	TRUE
cjnieomhfbbaga	TRUE
ddjpmiklmadboa	TRUE
ddkbcgkfnjcmaa	TRUE
dnojppfkkmodph	TRUE
doabjglhkkipca	TRUE
ejijfpnegnjhje	TRUE
ejijlldneenhck	TRUE
fdbajiimpcloma	TRUE
fdbjbgpfhpenfm	TRUE
fmlnblkkmjpcfc	TRUE
fmmimmpchjhoih	TRUE
ggecppbogojggo	TRUE
ggeejhepdmmhmh	TRUE
haojkgdemgnfoa	TRUE
haomgkinkejgla	TRUE
hlnldkhcdloaab	TRUE
hlocfckcedjfkj	TRUE
igoejckalhbpma	TRUE
igpchboedkogfb	TRUE
jakfemkgknaknn	TRUE
jamfdcbbeglgoa	TRUE
jjodhghdbihmeb	TRUE
jjpjffpochhnld	TRUE
keofbcofpdpojg	TRUE
keofmjgeielnne	TRUE
kpkmchkkfmbkbc	TRUE
kpmienpbceimed	TRUE
lkkfeogfjefgjh	TRUE
lklcbimeafgoja	TRUE
mekhphecmmmdbj	TRUE
meojgofpknagka	TRUE
mnnnabmlhnhjca	TRUE
mnnpbpolmgeimb	TRUE
ngojdlhhpigcim	TRUE
ngpmpbhglecppk	TRUE
ocfildhbhfnaga	TRUE
ocflmjnojdaepa	TRUE
olkemdepimhjof	TRUE
olmdjpifacnppa	TRUE
pfmgmaognpdnba	TRUE
pfmmogfakbhnoa	TRUE
aabebhjphbigia	FALSE
aabidhcolijamb	FALSE
alahbmnbllpepa	FALSE
albkfjmfbecggl	FALSE
bfonjjhklalppg	FALSE
bfpoknmclngfka	FALSE
cadopdffmpgghn	FALSE
cafnfllhcobdkj	FALSE
cjlgbdobpgcica	FALSE
cjloflhnbfgcia	FALSE
ddoiflhfnchnja	FALSE
debabggcnjjfoj	FALSE
dobdfnibgjgcka	FALSE
docnffhjllgadb	FALSE
ejanjlopjbmkeo	FALSE
ejbkfcpkadgfdp	FALSE
fcpoekaihggaia	FALSE
fcpphcbjhfdajm	FALSE
fncfaanmkdbaid	FALSE
fnefghpbabnbig	FALSE
ggmopmobfingma	FALSE
ggnjihpbknnoia	FALSE
hbcdfnfpiohjba	FALSE
hbcdlmmlnckdda	FALSE
hmblajpomajhca	FALSE
hmcahedaomhena	FALSE
iggfgbmfclaemm	FALSE
ighhcaliinmbgh	FALSE
japiekailfgdap	FALSE
jbadccgioiiood	FALSE
jkojoopbhioafe	FALSE
jkoolekockpiea	FALSE
kfpcadgjcbnoio	FALSE
kfphaljnpjphdo	FALSE
kpnieebjmmmefa	FALSE
kpogalejjkoeen	FALSE
ljomjjghmadbli	FALSE
ljonmpikijagdn	FALSE
mekbafejagokia	FALSE
mekjbdpeahklop	FALSE
mngeddibopoffa	FALSE
mngomlbeoggcpa	FALSE
nhkplidjgdmpha	FALSE
nhmaedflcjikdf	FALSE
ocehmkmhdnbkja	FALSE
ocelkganheflkh	FALSE
omcembcifiefoa	FALSE
omcldofdnfejca	FALSE
pfmgjkfckpedba	FALSE
pfoklapojaapfo	FALSE
aabogmfgohkaeoa	TRUE
aacccghbpjainea	TRUE
aknpbdpmmbipiga	TRUE
akpbcljlajcfada	TRUE
bfheelnpghpbmpe	TRUE
bfhilpmiihoahja	TRUE
boflhbpgnbfpkdn	TRUE
bohdpeilohiloef	TRUE
ciojnalmbbndlda	TRUE
cipapmglnfpgjka	TRUE
ddbkcfbldkfdchl	TRUE
ddbpcncfihlhoaa	TRUE
doagfoeceahipin	TRUE
dobaohilbelmkpa	TRUE
eikifmlhgogokob	TRUE
eiopomcnmcpljme	TRUE
fcbmikaenhdlbka	TRUE
fcccegbaodjlnla	TRUE
fnecnhgjkdmeocg	TRUE
fneijjojdghghbc	TRUE
ggiiomcedkmlbhf	TRUE
ggjbajhbcnpgena	TRUE
habnmibijdbcgia	TRUE
hacomgobeolkgka	TRUE
hladhckhfhflhka	TRUE
hlaeobcgbjocbad	TRUE
ifjhfdccilgdkhb	TRUE
ifkadmaeekkjjlj	TRUE
japhmpobblldnja	TRUE
jbappjkcebineca	TRUE
jkpimkpfmaihann	TRUE
jkpmbkfkcbaljia	TRUE
kefmjglifjgpiij	TRUE
kegfblplmekpkhm	TRUE
kooghmlcnkjioln	TRUE
kopdclaellcbgna	TRUE
ljaikhoemfpgfja	TRUE
ljaikmlaeladbga	TRUE
mcjgmafjblfnofa	TRUE
mcjoailemgmhbba	TRUE
mmodheiaoboinia	TRUE
mmodljhnmmjkapa	TRUE
nhfokhihjlnikln	TRUE
nhgiamfddeplofa	TRUE
obecbmbobahgfka	TRUE
obechgomaapjngn	TRUE
olhjaofpemiinpa	TRUE
olhndpgnhiiebpj	TRUE
pflnbjcaffhhoda	TRUE
pfmdeglehpkgojg	TRUE
aabogmfgohkaeod	FALSE
aaccghbpjainele	FALSE
akoalcmcpgdehba	FALSE
akohcmhkjcffieb	FALSE
bfjihahjgbpjpjf	FALSE
bfjiolgelkicadp	FALSE
bofakofacflfane	FALSE
bohihlhbpgnbfpa	FALSE
ciocgfenakkalja	FALSE
cipaipoijdmckib	FALSE
ddkfjjkkfgmniha	FALSE
ddlfdifmbanlmef	FALSE
dobmkhkldeiclja	FALSE
docfijkigbnfbka	FALSE
eifokhafdhifjbb	FALSE
eigcikdcbfpkcga	FALSE
fcdllijchicgbja	FALSE
fcfconiannpccpi	FALSE
fmpgamnclpggcho	FALSE
fmpihdebjhbenja	FALSE
ggcojihaobjeikn	FALSE
ggdiecmnindgjpa	FALSE
habgodcooodnigg	FALSE
habkidehpdpobem	FALSE
hkoealcobiedbid	FALSE
hkpgmbedgnodlpa	FALSE
ifkaagjhccnciea	FALSE
ifkidnfmnmcbina	FALSE
jalecilpkjnccef	FALSE
jambeloebkogana	FALSE
jkoiiehdplcbhia	FALSE
jkpeeocgfjlajaa	FALSE
kejggddanfkleek	FALSE
kejlnhjjffgoead	FALSE
kpdjdjpckdpbgba	FALSE
kpebgjeknkldfga	FALSE
lijigaocnkhhmji	FALSE
lildgdoeiifjpca	FALSE
mcgloacldjgdoaa	FALSE
mcigehaglealkal	FALSE
mnhbmofnindjkha	FALSE
mnikomkghlahkdj	FALSE
ngejolafbpdagma	FALSE
ngelmlioilfbika	FALSE
objcbpafhoackca	FALSE
objdbfkkfjiagde	FALSE
olgpidpfkidboba	FALSE
olhfmcfcfefefca	FALSE
pfofcjgbjeghfea	FALSE
pgadkdnbfkpfchk	FALSE
aaaclmpkjakclmmk	TRUE
aabknejbkjfeflci	TRUE
aklbfaidiifknbdh	TRUE
aklfipboafphiiaa	TRUE
behlibhipiojhbnm	TRUE
beignijninakicia	TRUE
bokhmegeamnnpjba	TRUE
bolhcfihmkhfdkaa	TRUE
cinglnjbhbnbngcj	TRUE
cinjdoaidamjjfbk	TRUE
dcghpnoioapcnica	TRUE
dchegbfeaacbjjjn	TRUE
dodhlnmoajdlpeab	TRUE
doeholkknmldjmmb	TRUE
ehpdgpfnjnjnlana	TRUE
ehpgaifhmapphnep	TRUE
fbmdkfkipaoohbpa	TRUE
fbnpekbebalhdoea	TRUE
fmemeplgcbhmeghe	TRUE
fmflkjichgpliflb	TRUE
ggkdhaldhpnglkla	TRUE
ggmkegacpmnphpna	TRUE
haiablabmdnafcjp	TRUE
haimkhdianjhhgbk	TRUE
hjfopkjmgnmdfbho	TRUE
hjhbchciancneiia	TRUE
idfhkhgjiglabnad	TRUE
idfifoepohhnkhdj	TRUE
inpjiamcihcakeik	TRUE
ioapomhpkmegnfia	TRUE
jhlpmccddmkdmgmd	TRUE
jhngjkcinfikjnkn	TRUE
kblmcfdggkghkpbb	TRUE
kblncgnfgogenhed	TRUE
klkdmmgklobpcpgl	TRUE
klkgnclndedjgkij	TRUE
lgmpignmcaomllga	TRUE
lgnlijcjhfaiomba	TRUE
makhhdokldpolkja	TRUE
mallecbobnhhgoga	TRUE
mlacjcdfbdlaellm	TRUE
mlahijdlplpgngpa	TRUE
nfhlggbddpchehfo	TRUE
nfhplncaadcggolo	TRUE
npjjnnpncafddagj	TRUE
nploaffdgbnnlhaj	TRUE
okfdgkagcphnhlea	TRUE
okgadkgnbnfjbfja	TRUE
pfffnfgciolohmbb	TRUE
pfgbpipblgjlkapa	TRUE
aaaohcdmcfgjiama	FALSE
aaappaloldngeona	FALSE
akdijbemipppcgne	FALSE
akdlcnoejpclppgd	FALSE
bfgcajkfanmkeifa	FALSE
bfjgnodnjpgcmbna	FALSE
bokjdjoedcdbfkka	FALSE
bokooegfbfhdgffa	FALSE
cimmocllfinfoppa	FALSE
ciohpaklmdodhfmm	FALSE
ddhmoaapdbpfpboa	FALSE
ddigpbdjinmgncda	FALSE
dnjhappldhfafpba	FALSE
dnllniodhgffkbea	FALSE
eglomonadhidopil	FALSE
egndjelcjbbcikda	FALSE
fdcnenainmajjoda	FALSE
fdcpadibfcepjnji	FALSE
fmbafkhbchnolgcl	FALSE
fmbghhjaaefcenla	FALSE
ggefnddckaccekgc	FALSE
gghomefbbekkhaoc	FALSE
haiiianbkphnacdi	FALSE
hajdaapclpnipdnn	FALSE
hjiigimkjpohjgma	FALSE
hjjdanoempefipec	FALSE
ieieinioopmfhola	FALSE
ieijagopnkangcla	FALSE
jadjlakfnacibcgd	FALSE
jaelbpepllomcbbp	FALSE
jjlgkgcojllfaipe	FALSE
jjnjibadjhgoehhl	FALSE
kebjnmhehpdfnmla	FALSE
keckbhmnhahnmdff	FALSE
koadlikooehckkig	FALSE
koaomibemcgjimdo	FALSE
lhmmgamnjnfgpkgn	FALSE
lhopfmpofiecldpa	FALSE
mbmdljlhbmcebjga	FALSE
mbmmgahddbddjbeo	FALSE
mmjmgkbhpfojnoia	FALSE
mmkajnjkjdpmngli	FALSE
nicneejgafiklpfj	FALSE
nidmcgloifngjpca	FALSE
ochafaamnnihcgep	FALSE
ocipaffbdaieojna	FALSE
omdohdioinknfbla	FALSE
omefnhelgigkidga	FALSE
pfondhllgjonaelg	FALSE
pfpiodignhjafkpn	FALSE
aaaohcdmcfgjiampb	TRUE
aaaploldngeonbica	TRUE
akekgobcfpebbehia	TRUE
akgfbhlodcnimkjfa	TRUE
bfbollcccbhgcofnb	TRUE
bfcfdlajlniplkiea	TRUE
bogaaeenihpijfnkj	TRUE
boggbbdblnlihhnkc	TRUE
cipbgnnakdhahgejb	TRUE
cipgmondmojggdgaa	TRUE
ddhfgaheomabknmie	TRUE
ddicppeopaljollba	TRUE
dnooolkiekppnpdgn	TRUE
dnpbglahhdcgacaoa	TRUE
eibcjkcmlncojlmfk	TRUE
eibeimaggcidmlima	TRUE
fcgaodjmflglcippa	TRUE
fchfcdpnfadjkjoac	TRUE
fmobabhegjpnfljca	TRUE
fmogdidcenglnclnm	TRUE
ggmjcjelibpflanpa	TRUE
ggnckooilfalijbka	TRUE
hahbdfjjmclecojca	TRUE
haidhicpdkpominba	TRUE
hjlabcgdimmgiajaa	TRUE
hjmgkmdmibhannjia	TRUE
ieekfniljgllpbegd	TRUE
ieiplmmemgigoojfe	TRUE
jaakngnkkmmkaffga	TRUE
jaanfiafbndkidjka	TRUE
jjidhaijcincclapd	TRUE
jjiicpcpgljpeohml	TRUE
kddcfejjgiphbmgmo	TRUE
kddppnikleagdladp	TRUE
knahmaiandegfakon	TRUE
knblnabpaoelmbilh	TRUE
lidhikjmedjlafhia	TRUE
lidibloaippffdfba	TRUE
mckkkkhdnjdahbmia	TRUE
mcknmjnolfbdkkmaa	TRUE
mmopbjgecplfjengn	TRUE
mmpconhpofcajbhna	TRUE
nhobhhjdbfjjjjllj	TRUE
niaegpomigfcjfbda	TRUE
ocdigbccfjehflplp	TRUE
ocdkobekcplphabak	TRUE
olcaagpiamnnaiijj	TRUE
olcmldjddkjlaimca	TRUE
pfaclgjdnmliljnha	TRUE
pfceecgpdjloffjkn	TRUE
aabkhppgimlnpcfda	FALSE
aacdfdnemdgigdjla	FALSE
amapkidclbgaodfmf	FALSE
ambioihkdkiciheob	FALSE
bfgnnkgllllnfhhha	FALSE
bfgopbpabddpiokbi	FALSE
bonpjmhmmjfidlacn	FALSE
boojbgcbhngkefiba	FALSE
cibgcmndndfophpna	FALSE
ciddkppcdelkeheca	FALSE
dcbibpjgofnknofha	FALSE
dcccgeajcamfigkae	FALSE
dlocnhgkpcppgheka	FALSE
dloeckgehjnhlanpp	FALSE
egiimfdgjfflpchpa	FALSE
egijabcfdedlihcbm	FALSE
faihloabkcghmkagd	FALSE
fajibpnboljojmdjg	FALSE
fkeogeaaflpbondfa	FALSE
fkfemkmnbedbongfa	FALSE
geopmhdbilijcamjk	FALSE
gepnabbgfcpacdape	FALSE
gombciijcilpcnkka	FALSE
gomiogcehkheccefa	FALSE
hjagheemhodoaifoa	FALSE
hjbafhmdfklallnea	FALSE
idjoolokicoiodnna	FALSE
idkegalibmdlbedmc	FALSE
iniihhhmeokcffkap	FALSE
injieodhjgkoifipa	FALSE
jidamdlaggcffmpka	FALSE
jidmmdgecddflbagp	FALSE
kcbnfnojjeopgfkca	FALSE
kcbnphpkhhgpieaoj	FALSE
kmihofnmoimhdmjda	FALSE
kmiifcelacjnginin	FALSE
lhhgpnocplibggoan	FALSE
lhicimncfahpbndjf	FALSE
mbkdafklnklpfpodk	FALSE
mbkgebngenehlioga	FALSE
mlkgaejnccfomaeea	FALSE
mlkgmaogekeiidaba	FALSE
nhdhoicfejncjadef	FALSE
nhfdjjbkfkldiaohl	FALSE
ocbfffophibnnekha	FALSE
occbekhmgimccbmna	FALSE
oldbfplhfiapbkini	FALSE
oldfpfnbbijljpadp	FALSE
pemnobolaakmcilea	FALSE
penfpfcbjpdkfbkha	FALSE
aaafkofejknimddkha	TRUE
aaakkhijpdbkffbgfa	TRUE
ajmlmdljekahnjpmcn	TRUE
ajnopfbbajnpfnpbmg	TRUE
beofidkpnifmcjhijc	TRUE
beohacfhgabolcideg	TRUE
bokdpjhhmldcopmojo	TRUE
bokkdbpdjhjbjgbcdd	TRUE
cihnmjpkehbbhlcaia	TRUE
ciicpmgenojnhdmbbm	TRUE
ddicakjcceegiojamp	TRUE
ddjadeeodbejbmaeik	TRUE
dnnfofemlnahnkdfba	TRUE
dnocofnnkhncggfknb	TRUE
ejahojbkcbniipmjna	TRUE
ejaopooanhilnggoaa	TRUE
fdinolfnkfmlfclgkf	TRUE
fdlgmfejeilbhhgdeh	TRUE
fnkpoeehojfmkifcfh	TRUE
fnleleicfjkljlfbbl	TRUE
ghfckkkdldoghcmdpf	TRUE
ghfdliboifikgfplig	TRUE
hbgfaolloohbbfdban	TRUE
hbhdblpebnmhdejmkc	TRUE
hmbbgkndmjhifahhha	TRUE
hmbegkmdamiillhoka	TRUE
iffpgcomkebidiacda	TRUE
ifhdanadeljomgemjj	TRUE
ipdphnglpgihnnmehk	TRUE
ipelbmidipjndclpcj	TRUE
jjghglblblnbeleolh	TRUE
jjgjakplbjgjnjnlda	TRUE
kcgkbcmmmlcccddlff	TRUE
kcglphfpneackipila	TRUE
knfdapbkpcjamhibaa	TRUE
kngmfbngmofddccmkp	TRUE
licafeelmelocpdlla	TRUE
licckpijaemjppafij	TRUE
mcciknldhfeblkffdc	TRUE
mcdocljchfllmfcada	TRUE
mmjclpibgdkneofofl	TRUE
mmkdjedofglmininci	TRUE
nhnkleabibjhiindja	TRUE
nhnobcdcjhgcbnnaai	TRUE
oaodnbpdmbmlicceca	TRUE
oaoicgpfcalppoalma	TRUE
oljjfhpeenlkmakhfa	TRUE
oljkjaaljbgiaddgka	TRUE
pfgbgecfcpbdobelaa	TRUE
pfgebohahpmlaocefo	TRUE
aaaakooffkebfbolca	FALSE
aabedkjeihoejbabmh	FALSE
ajpeinenjdecibmnef	FALSE
akaalkkcojmeglnlbe	FALSE
beeplmnblmbckcjkfa	FALSE
beggmogobhdnnbncka	FALSE
booikbdlmhelgogdba	FALSE
bopbkncgkdmfkmgoka	FALSE
ckbmblblejbnnlmcea	FALSE
ckcddnabnpamejckfa	FALSE
dehdeldijbfapjjkin	FALSE
dehglibommboffhjpa	FALSE
dplmhibmaffeidjiok	FALSE
dplnckolknnoffboca	FALSE
ekchnanaijphfcjhha	FALSE
ekcjmnljljckhdeaco	FALSE
fdfnkcpibgakfibmeo	FALSE
fdgeahcblmeigimlmf	FALSE
fnjapoggggdjfcmkgf	FALSE
fnjdgnmkiieelmgkfa	FALSE
ggeoeimmgifmkmdjja	FALSE
ggfcbcbmcedhooajpl	FALSE
hajogdblbmalpkapcj	FALSE
hakcdglngjhfacfjha	FALSE
hkcnjbpplfbglngkka	FALSE
hkdhngnbmejgmjdjea	FALSE
iepoejigfddkpnjmfa	FALSE
ifafmfpiepigjmdaha	FALSE
ipjcpjjfkoocaaikoa	FALSE
ipjghpmaecgbklenfc	FALSE
jkhfkoiaiicobbnfji	FALSE
jkhjdgljadigbejddn	FALSE
kfkfbcbnnkdjiboina	FALSE
kfkhlibgjllfkkoina	FALSE
kpocffjiiboibafeim	FALSE
kpodjnaldohlmcokdg	FALSE
lkmmoajagppgipmnla	FALSE
lkngcngljajaedbgal	FALSE
meclimboindnglhjka	FALSE
meeaokplibphhjbbbi	FALSE
mnoklailipbpoamjna	FALSE
mnpoaobimjefmcdljd	FALSE
nijdhfclhjclhfjaih	FALSE
nijgpoagdilgifbpen	FALSE
obffmeelpolamighdj	FALSE
obggboelacnnfobikl	FALSE
olcmflkdiijkhgkmha	FALSE
olehlhicimjfhfaana	FALSE
pelpgeepjgcjnoedpa	FALSE
penigbhenokfbomioa	FALSE
aaaakooffkebfbolcee	TRUE
aabkjeihoejbabmgcca	TRUE
ajpfkebchpcijbmehfa	TRUE
akapomlinjbghkcpknf	TRUE
beggfnopcfkkbjkogdk	TRUE
begmbgfpjdkbfnhnnie	TRUE
bpbdlfmaodkllfcfgla	TRUE
bpbogcmbfoadelijiha	TRUE
cjmijebklobocnigeaa	TRUE
cjnchlkhhhepefdhcmg	TRUE
dfhcdmphkmlopgdhlfo	TRUE
dfiigpopifjncljakca	TRUE
dpifdmlhknjfmladlia	TRUE
dpkieogcmmlidjgfooj	TRUE
ejkpmbjdanaponeolij	TRUE
ejlamnhfbjdabfmldaa	TRUE
febiecfcdegppohklmd	TRUE
feblheligapcfmbkija	TRUE
fnjenalecngnpgpolla	TRUE
fnjmglgmgihpadbnpka	TRUE
ghapjjodceolkkkplea	TRUE
ghdgcllljonnfojiobg	TRUE
hanbcjjfmdbhjdojkda	TRUE
hannefoifilbamfplfd	TRUE
hkepnnabiegffljbhia	TRUE
hkgfgoajoimolmdknka	TRUE
ifeodjlejndidaoifoa	TRUE
iffodinglpodigmocci	TRUE
ipghllccogejpncoapa	TRUE
ipgigofokbilegdhbkj	TRUE
jkjikbdhmgicheamalf	TRUE
jkkdebkeblkenjhgkdj	TRUE
kfomnehcadpkanegemc	TRUE
kfpbfhbhcopoidhifbg	TRUE
kpodfgomcadgmongbna	TRUE
kppdkckaiagienganah	TRUE
lkigdnlobkpbpnbbmfi	TRUE
lkilggadgjjbjomdmka	TRUE
meeicfnebdmhlilgicf	TRUE
meelmagkdikbehiegia	TRUE
mobpnihmdoifpjklidi	TRUE
moclmdaoofgmkhgfgka	TRUE
niibgncllffchcjdekf	TRUE
nijcfccfbogkenjlkgo	TRUE
ocblohonoefonllgbij	TRUE
occdploggamgfkgofae	TRUE
okpdffndpeifbinceoe	TRUE
olbgjiifdhofadoopia	TRUE
pfgbaapdooiialfnbia	TRUE
pfgppnimdmllmadbgja	TRUE
aabhdobajnjddbndien	FALSE
aablnkcmiofddbiggka	FALSE
ajgjpfolkpdchdlmblc	FALSE
ajijddenckelgfdmklb	FALSE
bdpmhdklolbmbdandfb	FALSE
bdpmhpejgeejicninfa	FALSE
bocapbilihmbggdfolj	FALSE
bodankdbjhejmkgllnh	FALSE
chmbfleokfdnejfbmba	FALSE
chmfljhhfokaefhdcjd	FALSE
dchipcgndcimbhidmja	FALSE
dchockgpmmegmpndkfa	FALSE
dnfjafpabpnafjhboeo	FALSE
dnfnbabnnamggcccoia	FALSE
egjpjadacjpnolbcdna	FALSE
egkagddlakjflecmpba	FALSE
fakkneebiigjdlbnnjh	FALSE
fakpfkbahhigcgmdaee	FALSE
flemnenbmelklecchla	FALSE
flgfjfnglcbdonplima	FALSE
gfoobckfonhboccnbja	FALSE
ggbmpjnielbhjdblcga	FALSE
hacdihbmnhcgflphdon	FALSE
haciafomldokinpjboa	FALSE
hklegdkcgeegcidplfa	FALSE
hkmfhkebogcfndbijai	FALSE
iffmpcnbdoeeehiplea	FALSE
ifhcnkbhkhngnmmohja	FALSE
ipcdhaiedjfobpkbada	FALSE
ipcdlenebjecnfbjmpa	FALSE
jimciakecgngmlbnngg	FALSE
jimogiodcmlkajepimi	FALSE
kdmapdeciieaoolnoia	FALSE
kdmlelibccddeidecoa	FALSE
kofpgfbdanneoinfhkd	FALSE
kogkecmfkhdgdgjfnea	FALSE
linmkiicfjdfekkegka	FALSE
linohihnfncbmemigca	FALSE
mdocgbbfdokjmlilmma	FALSE
mdodcgmmghdgbocohha	FALSE
mnodoilomdbjohgnhfa	FALSE
mnogjpdgjgnfanpcbkn	FALSE
nimbiadjnjpdehknaoa	FALSE
ninaanemeddcgpighna	FALSE
odlnnhnmliakmefdcjl	FALSE
odmacnahbppmcdedgja	FALSE
onbcabfagejmleebjma	FALSE
onboanjcdklpifjbmfp	FALSE
pgepdlnelcbkheljlja	FALSE
pgfolofgfabkehkfkmj	FALSE
