aaafhoocdh	TRUE
aaakggigic	TRUE
akfoenemmg	TRUE
akgbnkegaa	TRUE
beinepjiak	TRUE
bekekghapj	TRUE
bpfelkabab	TRUE
bpfhlebnci	TRUE
cjcafnlgca	TRUE
cjcjnlekbn	TRUE
debhdinceh	TRUE
decdmdeokn	TRUE
doclbpnoaa	TRUE
docmllpebm	TRUE
eieohnconm	TRUE
eiflhkfhpg	TRUE
fcameiccki	TRUE
fcbfkeeief	TRUE
fmbapkccil	TRUE
fmbmaklojb	TRUE
ggnbfcnikl	TRUE
ggndlneego	TRUE
haoigmjnjb	TRUE
haopfcpnha	TRUE
hmfcdihfnh	TRUE
hmfgpjkgen	TRUE
igicoekcjc	TRUE
igiogicndd	TRUE
iphdhpbllg	TRUE
ipicbhmeni	TRUE
jlgmppbodf	TRUE
jlhljljeia	TRUE
kfjgioemek	TRUE
kfjmefdbpe	TRUE
kphjgnknlj	TRUE
kphjlnfinn	TRUE
ljhofamdca	TRUE
ljillopeok	TRUE
mdhnkbgicg	TRUE
mdjakcclpd	TRUE
mmjjeneokb	TRUE
mmkdenbmoh	TRUE
nhbepgcmlo	TRUE
nhbhffmodg	TRUE
obhceaapea	TRUE
obhmcndpko	TRUE
okjlfaldgc	TRUE
okjndcahpi	TRUE
pffpijkmkb	TRUE
pfgfjmmalf	TRUE
aaajcnijab	FALSE
aaanhkofab	FALSE
ajdbnbdlab	FALSE
ajdkpmndab	FALSE
bdleopkdab	FALSE
bdmgmlplab	FALSE
bobgdfagab	FALSE
bobhmfpmab	FALSE
ciglcaipab	FALSE
cihihonbab	FALSE
dcagopngab	FALSE
dcbgpkooab	FALSE
dnpilnjcab	FALSE
dnpkigbeab	FALSE
eifpijihab	FALSE
eigkjjgfab	FALSE
fcggkmidab	FALSE
fchjjeomab	FALSE
fmhlaeloab	FALSE
fmhnmkndab	FALSE
gfeanobkab	FALSE
gffebbofab	FALSE
gphafgmbab	FALSE
gpibdfmdab	FALSE
hkfbffkoab	FALSE
hkfenlodab	FALSE
ideppodpab	FALSE
idfddppgab	FALSE
immfbbpbab	FALSE
imnemcilab	FALSE
jhaifkghab	FALSE
jhbklmpaab	FALSE
kaaolmelab	FALSE
kabjciioid	FALSE
klemejfiab	FALSE
klemlghoab	FALSE
liedfeedab	FALSE
liednccjab	FALSE
mcfgeaohab	FALSE
mcggbjlcab	FALSE
mmfplmgbab	FALSE
mmkcfnlfab	FALSE
ngjbojpeab	FALSE
ngkcnffkab	FALSE
oacdcfbnab	FALSE
oadahgfkab	FALSE
ojpkleolab	FALSE
okbfgojnab	FALSE
pfapmcnoab	FALSE
pfclnffeab	FALSE
aaajcnijhko	TRUE
aaanfpcfneh	TRUE
ajfjjebgppl	TRUE
ajfpcfiaadn	TRUE
bdpbhldlodj	TRUE
bdpljocfimb	TRUE
bnlnpbfagee	TRUE
bnmkbgcnldo	TRUE
cimfcljihfi	TRUE
cimjohbdlaa	TRUE
dccdbgmlacn	TRUE
dcdkfclaiel	TRUE
docembfgmda	TRUE
dodohpnoaaa	TRUE
eiakcmlajfc	TRUE
eidfmbmnioh	TRUE
fchknelammo	TRUE
fcieglhfgfd	TRUE
fmjpjhdgfpp	TRUE
fmkaelnfddo	TRUE
gfncpaihjda	TRUE
gfndpjohgge	TRUE
gpjfpianlni	TRUE
gpkgjibfdkl	TRUE
hjifinoeeca	TRUE
hjifjmmlijl	TRUE
idnlppjjchd	TRUE
idponfelbkp	TRUE
infcddeokmd	TRUE
infphohkapj	TRUE
jgiefamkojb	TRUE
jgkakbmmibo	TRUE
kacfjbmmhaj	TRUE
kadlfcbiagc	TRUE
kmikhamphkg	TRUE
kmiopfepgdd	TRUE
liacappgnck	TRUE
lidaijjfaga	TRUE
mblbfdinkpb	TRUE
mblfadaenmi	TRUE
mmihhhmbpko	TRUE
mmjdobljkge	TRUE
nhcbmbbadep	TRUE
nhcghpclkaj	TRUE
oaeopmchjpd	TRUE
oafcdaaafeg	TRUE
okkkjbljbjg	TRUE
okkmopdlhah	TRUE
pffbnhnjhpj	TRUE
pfgklekgjik	TRUE
aaajcnijhab	FALSE
aaankofpcab	FALSE
ajekbalphab	FALSE
ajfjoofpabc	FALSE
bdmaggfimab	FALSE
bdmkdeinjab	FALSE
bnkmchkgiab	FALSE
bnmdlpejdab	FALSE
chpefmjlpab	FALSE
chpjmkioeab	FALSE
dchcjakbbab	FALSE
dchdnjbcdab	FALSE
dobnogmaaab	FALSE
doddfdndbab	FALSE
ehiebkbghab	FALSE
ehjdnjhifab	FALSE
fcnoggodgab	FALSE
fcocbfdccab	FALSE
fmadldbjcab	FALSE
fmaoeehpjab	FALSE
gflplnmghab	FALSE
gfmhldmfabc	FALSE
gpkffbgjeab	FALSE
gpllpajagab	FALSE
hjglilnfjab	FALSE
hjhinpnheab	FALSE
idflboeblab	FALSE
idgdggljdab	FALSE
ingahbdnkab	FALSE
ingfeiojpab	FALSE
jgghmblefab	FALSE
jgghpgipdab	FALSE
kacamgpfdab	FALSE
kackgoejaab	FALSE
kmdfghnoeab	FALSE
kmejdgkbbab	FALSE
lgnbdahknab	FALSE
lgnjllnnkab	FALSE
mbpnigaddab	FALSE
mcbpigbdfab	FALSE
mmgjafjeoab	FALSE
mmgkkhgajab	FALSE
ngllokanpab	FALSE
nglpfbmodab	FALSE
oacenfgboab	FALSE
oaciiiandab	FALSE
okbnenhlabl	FALSE
okcfpamigab	FALSE
pfchfoklnab	FALSE
pfdpnpkahab	FALSE
aaafiphijkeh	TRUE
aabikjhfopab	TRUE
ajpflbjojpbi	TRUE
akboacbkonkb	TRUE
bdpjcmcedbeb	TRUE
beahgbgjcejf	TRUE
bnklpbgoadhl	TRUE
bnkobcnlahii	TRUE
chjkfnkhbkec	TRUE
chkdfpidbmnh	TRUE
dahifmnnbpdo	TRUE
dahkgfgnoeno	TRUE
dknpgdhcahpk	TRUE
dkohpfgbflfg	TRUE
eebnendoibga	TRUE
eecfkipjelkm	TRUE
enikfkpcnlli	TRUE
enikonplafdi	TRUE
fhbjkhomkmbn	TRUE
fhcbkkegeelf	TRUE
gbfepgefkmmd	TRUE
gbfjbhfpdjdk	TRUE
glmcmhmhbgga	TRUE
glmlkodpjgdd	TRUE
hhebfhfdmamh	TRUE
hhejmifinkak	TRUE
ibihpoekajli	TRUE
ibjalkokigdc	TRUE
imgmbomobboi	TRUE
imjabfooafab	TRUE
jfedhehafbdd	TRUE
jfgfammjpnee	TRUE
jpknpgdocich	TRUE
jplahngoldcn	TRUE
kjnihcojcjnn	TRUE
kjpmnhfbilga	TRUE
lejgnebppnko	TRUE
lejjbpabogab	TRUE
lpaigcegpnph	TRUE
lpamdmjdachm	TRUE
mjeijbmmbdhj	TRUE
mjgaiocncdjm	TRUE
nelkaffkjmff	TRUE
nelnchamcbdm	TRUE
noaofoflfnml	TRUE
noclaenjaapl	TRUE
ojcpjjahbppc	TRUE
ojfdkblpafkh	TRUE
peblbcbmdhlj	TRUE
pebpafjllpmi	TRUE
aaafiphijkab	FALSE
aabehikjhfop	FALSE
ajplhbpmpaab	FALSE
akbcadjojlab	FALSE
bdmlbmpgkmab	FALSE
bdnhpohoegab	FALSE
bodgkcfkkmab	FALSE
bodhnmfnijab	FALSE
chpapnoapkab	FALSE
chpofjnobbab	FALSE
dafnjcemkcab	FALSE
daicofjookab	FALSE
djkbadfjcbab	FALSE
djkelkaenfab	FALSE
eeakkjkmmpab	FALSE
eebomgiknhab	FALSE
encfpojbndab	FALSE
enemboibdoab	FALSE
fhekecpoibab	FALSE
fhfbgmkdhfab	FALSE
gamaiedhipab	FALSE
gammholmmgab	FALSE
gljkejekckab	FALSE
glkcfanabdnb	FALSE
hgakdfcejfab	FALSE
hgcjfilokjab	FALSE
ibhepanifhab	FALSE
ibhgbaepbbab	FALSE
ilnkdfgllcab	FALSE
ilogappjkjab	FALSE
jgdihedahlab	FALSE
jgelmdpcbjab	FALSE
jpkmfgfhehab	FALSE
jpmldhpodhab	FALSE
kjolmbfnjnab	FALSE
kjompfijnfab	FALSE
lfdjopajpcab	FALSE
lfdkcndeikab	FALSE
lpbfmkpjdlab	FALSE
lpdjkcejgmab	FALSE
mjmnoibenfab	FALSE
mjmoijhahpab	FALSE
neaaaiojgeab	FALSE
nealjpbepbab	FALSE
nnlnbnleflab	FALSE
nnnpbbbmljab	FALSE
ojacigiaaeab	FALSE
ojbjhcgmamab	FALSE
pdihmofpgpab	FALSE
pdiiggaeimab	FALSE
aabglmdcbelab	TRUE
aacemojhffgad	TRUE
ajepklmnbbeek	TRUE
ajfengempndnn	TRUE
beelabhcnomab	TRUE
beemlingjpigb	TRUE
bolmlnmcihici	TRUE
bolokgfdkgjeb	TRUE
cipbbicgmhgih	TRUE
cipdmogbekceg	TRUE
ddckkapabjbab	TRUE
ddcknpkbbgefn	TRUE
dmmdjoohjbbhn	TRUE
dmmdnjachnpkf	TRUE
ehkdiapkaggck	TRUE
ehlpdhajffceg	TRUE
fbpmjimimjlkm	TRUE
fcaajcbcnpnkg	TRUE
fmnglpjdfefkb	TRUE
fmohlfkdgjiic	TRUE
gghmlnpcohaaa	TRUE
ggidhgipgcmdo	TRUE
hanhphjllilbj	TRUE
haplghkjknlff	TRUE
hklebmeoaldoc	TRUE
hklplnmmigagk	TRUE
iefodlhgpmlgm	TRUE
iefpjlnmihoml	TRUE
ioaojlmboolhn	TRUE
iobhpeaaffhon	TRUE
jhpomijfbaioh	TRUE
jiailfindenei	TRUE
kcapmcbbfhjgf	TRUE
kcbdcmdocfhpl	TRUE
kmlmcdieoacbg	TRUE
kmmappeffkimg	TRUE
lhhhahnhopckm	TRUE
lhhkngcggodni	TRUE
mbppdilljjaeb	TRUE
mcceokmjmbece	TRUE
mlepldjnbcjbp	TRUE
mlfjojekmdgpm	TRUE
ngjcmemphejgk	TRUE
ngjdejcmcjknm	TRUE
obnmjhkjiaedj	TRUE
obodkignnmooh	TRUE
omdbpdeigmemd	TRUE
omdlkeamolpfm	TRUE
pgkglemkponih	TRUE
pgmbbjommidon	TRUE
aabglmdcbelem	FALSE
aacojhffgacab	FALSE
ajgecknefjlab	FALSE
ajgoplpefmoab	FALSE
bedmpjphlkcab	FALSE
bedoagicadnab	FALSE
boonakbmjieab	FALSE
bpapfddcfjcab	FALSE
cjpdolimaphab	FALSE
cjpleigbmlnab	FALSE
ddabmcfaelgld	FALSE
ddbcmckggmkab	FALSE
dmlejgdmpafab	FALSE
dmpeecflofiab	FALSE
ehlcpecohkmab	FALSE
ehofllobaedab	FALSE
fcmdgbgmjdjab	FALSE
fcnaggmbfgoab	FALSE
fnedpemoecoab	FALSE
fnenaogmidnab	FALSE
ggdbaeknlhkab	FALSE
ggddekiojckab	FALSE
hbaifnkanfbab	FALSE
hbalkbllkgdab	FALSE
hkpjnejckagab	FALSE
hlaapipdlelab	FALSE
iepppbmilobab	FALSE
ifajggcjamlab	FALSE
inpgfcegklkab	FALSE
ioaanmfopocab	FALSE
jhmmlhgkjglab	FALSE
jhmnhcgfnckab	FALSE
kcbgbpjeinfab	FALSE
kccnfommmklab	FALSE
kmldgjohneiab	FALSE
kmmipfkoobkab	FALSE
lhkbdkegegnab	FALSE
lhkeghgcanbab	FALSE
mbphpcimmhiab	FALSE
mcaiejeojcbab	FALSE
mmcpmgcamfoab	FALSE
mmdllkllngiab	FALSE
ngpkdgapnglab	FALSE
ngplceilnbgab	FALSE
obnknmhhafkab	FALSE
obnmgbnpneiab	FALSE
olhjfbmpmeoab	FALSE
oljehchbbapab	FALSE
pfookegjljdab	FALSE
pfopjnngfpbab	FALSE
aabepjhjegfgab	TRUE
aadholgglhbecf	TRUE
aldfecmlkppaai	TRUE
aldfgipdadaffk	TRUE
bfblmcphmignhk	TRUE
bfckjnciigghof	TRUE
bplbjfkfgknpmd	TRUE
bplfklfnncdbhm	TRUE
ckdlagnachlfod	TRUE
ckfbbedknknoic	TRUE
defmmpnohjldfi	TRUE
degfhjkkndjefo	TRUE
dnjbogojeallpg	TRUE
dnjiahalcmpbma	TRUE
eifcdoionndfnd	TRUE
eifjapdhnamobc	TRUE
fbolmcjchnbpon	TRUE
fbpgnfajpffhpm	TRUE
fmcmfgddcjjfoh	TRUE
fmdhkgbadjdjca	TRUE
ggdhdoeihdafke	TRUE
ggdkkkcoknajda	TRUE
hadbecgeimjboo	TRUE
haepkddhgbfoaa	TRUE
hjegmopocpcjkl	TRUE
hjencnfipdppfh	TRUE
idiegiaibpokce	TRUE
idjgekphmgffol	TRUE
ioanlehlhklcbm	TRUE
iobfnlnjcclofi	TRUE
jifomjafgoejhl	TRUE
jifpnnnnpofami	TRUE
kecboheiageohp	TRUE
keceikbcifmaag	TRUE
kobkhlaeankaoo	TRUE
kocbonlhgjeaac	TRUE
lidhcdgompkemh	TRUE
liehbhhimedgcd	TRUE
mckbofooapcdoc	TRUE
mckfckciolihob	TRUE
mnmjmglnadocjn	TRUE
mnmkakodfonloa	TRUE
nhkcnoekfjooen	TRUE
nhkgeepckcbblf	TRUE
ocfmjakclcpgfe	TRUE
ochgemmhmejoih	TRUE
omiakgmaloapik	TRUE
ominpecebnmjcn	TRUE
pfonidlinpehce	TRUE
pfpmdmnnjmoceg	TRUE
aabepjhjegfgho	FALSE
aadlgglhbecfab	FALSE
albdpaicodilab	FALSE
albeffhnpacpab	FALSE
bfgojiceadfjab	FALSE
bfgoogjiddkkab	FALSE
bplhihhdppgdab	FALSE
bplmlhjkidplab	FALSE
cjdgdphoikfhab	FALSE
cjeadfhfknhhab	FALSE
ddkanbmhblablc	FALSE
ddmdfkmmpignab	FALSE
doghcpkjgfdfab	FALSE
dognklpbefnkab	FALSE
eiknifikecngab	FALSE
eimlkepgpgfaab	FALSE
fbmollieddnjab	FALSE
fbnabmekpojhcj	FALSE
fmbmejaogmcgab	FALSE
fmbojoidjldhab	FALSE
ggaapcgkcjnpab	FALSE
ggabgdlcdhcpda	FALSE
hafhbemhngadab	FALSE
haflfjejkmleab	FALSE
hkcpamcelmepab	FALSE
hkdcnomojajbab	FALSE
idcampgbnphjab	FALSE
idccenepcibmab	FALSE
inkceloabagekf	FALSE
inmbmfigcilmab	FALSE
jipdpdadekjjab	FALSE
jipiiampkdnlab	FALSE
kdgmdhinamlgab	FALSE
kdhlheemdkjdab	FALSE
knocimmhkofiab	FALSE
knpinifnilllab	FALSE
lilacomjlcmlab	FALSE
lilekjlplacnab	FALSE
mckijkijionlab	FALSE
mcklhecegajcab	FALSE
modjdlddngbfab	FALSE
modmgnljcgdcab	FALSE
nhmigbheklcgab	FALSE
nhpfoeleeadbab	FALSE
ocipnhlfcakmab	FALSE
ocjompoalehgab	FALSE
ombmladlnjfiab	FALSE
omcdbbammeajab	FALSE
pfohfnmblofcab	FALSE
pgadljpdghkfab	FALSE
aaadbhnpblpmjcg	TRUE
aaagmocpbbiaibf	TRUE
aipfmmogghgeldi	TRUE
aipgendkldegfbi	TRUE
bdofkfjenpcfhfd	TRUE
bdooelnhmdjjhmo	TRUE
bogaoddpjkaobbb	TRUE
bohhlbnlbphmaoc	TRUE
cjhliapogiehold	TRUE
cjiepbbmaghffhl	TRUE
ddmlkclkkjcmmdc	TRUE
ddmmikblopnlhmd	TRUE
dnbieecifpdfahn	TRUE
dndmlifhddgicnc	TRUE
ehiklcgkmhpieki	TRUE
ehiopcfijelonlh	TRUE
fcmegdijnphiapf	TRUE
fcmfjmgnnifgdca	TRUE
fmkcdlcafepabab	TRUE
fmlgphiffhpeokb	TRUE
ggkglblohkajjcj	TRUE
ggkiinibomfkgfn	TRUE
hcaldjpjbgaecfd	TRUE
hcaoodhhpjmpdne	TRUE
hmggdmehffebglh	TRUE
hmhohfpfbpmonbn	TRUE
ihfopheeloggopa	TRUE
ihggfnfaajjeemm	TRUE
jbedgfhibfplafj	TRUE
jbefmffjmengode	TRUE
jlfpcaajlodcjnf	TRUE
jlglgjcbekekokb	TRUE
kffnnpnhkdlhlfb	TRUE
kfhikeeipleahah	TRUE
kphkhpaklcifplc	TRUE
kpjjjamifhbcefm	TRUE
ljlmgmhodbppobf	TRUE
ljncmdpgeohengn	TRUE
mclemmkgmajnppn	TRUE
mclidhkmfjmomhc	TRUE
mobhadheocdnjbh	TRUE
mobmfgafmiojdin	TRUE
ngpcllkdgbkjljh	TRUE
ngpgecjgebpkidn	TRUE
oadocpfgdofdppa	TRUE
oaeiiadgdfajgea	TRUE
okhgecelbhiicei	TRUE
okjgfgjohlfcope	TRUE
pfomljgdfafdmki	TRUE
pfphjnnkdiafkif	TRUE
aaadbhnpblpmjab	FALSE
aaagcgmocpbbiab	FALSE
aipakbbfdcendab	FALSE
aipdiinhankgoab	FALSE
bcnfndigkaaafab	FALSE
bcobfggokmkljab	FALSE
bobeghbilanfkab	FALSE
bobfeoejmdfmbab	FALSE
cilagiiomgdhnab	FALSE
cimccomloaejabc	FALSE
ddplnnmmoallgab	FALSE
deddpimgmlbbcab	FALSE
dndcfhohgomapab	FALSE
dndohbenapjafab	FALSE
egllcdijdenmbab	FALSE
egmapmgghdeklab	FALSE
fccobndacofjiab	FALSE
fcemihalibhafab	FALSE
fnaaipnjmklpeab	FALSE
fnbbghbanamaoab	FALSE
ghecdcgacnpdgab	FALSE
ghgiapgbemmodab	FALSE
hbnadnddgehflab	FALSE
hbnbcpaldmannab	FALSE
hnbfabijcgpdahd	FALSE
hnchnedncihnpab	FALSE
igkfpkgahpokoab	FALSE
iglbgceloaoenab	FALSE
jbdjohkegamodab	FALSE
jbegdknpnhhocab	FALSE
jlgfaifahnjbdab	FALSE
jlgmkoadbfghpab	FALSE
kffnccobacbeoab	FALSE
kfgejlcbdbdmbab	FALSE
kpgofdggdmjcdab	FALSE
kphgmajklolinab	FALSE
ljckdpooooaapab	FALSE
ljdcldllnbnkhab	FALSE
mdcalngnnlhbkab	FALSE
mdcglbefhhofbab	FALSE
mnpochagdbfbeab	FALSE
moadnkelpnlnfab	FALSE
ngjkklddnhnmoab	FALSE
ngkimekogdofaab	FALSE
oaejaeeggejeoab	FALSE
oafcfnjpjonghab	FALSE
ojmbhhphphggjab	FALSE
ojmpmogpmhehkab	FALSE
pfeonhccncglaab	FALSE
pffainhdkblclab	FALSE
aabdgpdhjbgombab	TRUE
aabolblelldddgab	TRUE
akhhkhfbhfflaalm	TRUE
akhiclpobceophkm	TRUE
bekleiaejmmlbibf	TRUE
beklhjcepfomebfn	TRUE
bogaicofcfbajaam	TRUE
boginedoejcfofam	TRUE
chggpedghpgdnecc	TRUE
chhcopigljfjmhml	TRUE
dbkgnbmiidfcpidj	TRUE
dbkiampgdnkcgmnb	TRUE
dlkdeghkmmkoneia	TRUE
dlkohmfkajcgpmca	TRUE
efgoeodfehchaegl	TRUE
efhkhdfkcommbnam	TRUE
eomnmjbjjhplmild	TRUE
epabjhdhdajokeab	TRUE
fjdieeodmoblginp	TRUE
fjdolockbjdpicep	TRUE
gdjangejlejindgd	TRUE
gdjhihfbgkblfooc	TRUE
gnbdlmpkbbpjofeh	TRUE
gnclgipkghkijjpd	TRUE
hhomjgcnjbdfgipo	TRUE
hhopfnkjpaaekajl	TRUE
ichkimjleleidpgj	TRUE
icibbokaadljomnp	TRUE
inckobjdpibdokla	TRUE
incpihjignbgmgih	TRUE
jhkfcfedcabhjmab	TRUE
jhkhmcgmdkdemkbn	TRUE
kcgeeplfhhabmmab	TRUE
kcienecpkkkondgn	TRUE
kngjihnnpmjhgncm	TRUE
knhgalgahjddcgkk	TRUE
lhidemcnnogbicfo	TRUE
lhkmeanipcjifbjn	TRUE
mbcnmcidfkjahmkh	TRUE
mbfnnkpbhfekgmbb	TRUE
mmjnhfehlnmfppio	TRUE
mmkkoagakfdldboi	TRUE
ngaeeekllidbgoff	TRUE
ngbkhafjkedlchgm	TRUE
nplgmgncgnkedgij	TRUE
nplgmnibecccofcc	TRUE
ojoopahcblffpeja	TRUE
ojpnejlabccafnab	TRUE
peppplenpcfcohag	TRUE
pfbcocljbckmpndh	TRUE
aacijmnocnakhoab	FALSE
aackceagphggaaab	FALSE
ajglemkkijbgonab	FALSE
ajieankjpjdjcdab	FALSE
bcddcofofpnjcoab	FALSE
bcepjombnjhpolab	FALSE
bmlknfdcomjkgfab	FALSE
bmlpdnhjpbemahab	FALSE
cgoaglmbonbdjgab	FALSE
chbgencgdakjnkab	FALSE
dcaaapkdfcongaab	FALSE
dcalbdamfflfbiab	FALSE
dnbjdklfjkimgjab	FALSE
dnbodnlencigckab	FALSE
ehmoopmldflakmab	FALSE
ehncklldgjghpmab	FALSE
fbkdhgidfkiomcab	FALSE
fbkpkdekaomkmiab	FALSE
fkmpbgbecnjiheab	FALSE
fkndkenlmhdjkkab	FALSE
geiapacgplolmmab	FALSE
geikmeclhilnoabf	FALSE
gpmophlnkdfbhgab	FALSE
gpniiekccbjdaiab	FALSE
hkolnohkgkekhiab	FALSE
hkolppfgjmkpjiab	FALSE
ififlddaebieihab	FALSE
ifiliololllnphab	FALSE
ipkcdgmgjnfdoiab	FALSE
ipkeofmlahjlcnab	FALSE
jjkekbapgpadlaba	FALSE
jjlchojadbnkfcab	FALSE
kdlmkkhncffkllab	FALSE
kdodecbipgepelab	FALSE
kpgfjdncjejdelab	FALSE
kphebiofeopfebab	FALSE
lkbgafcimgookfab	FALSE
lkbnkjhhfdljobab	FALSE
mdahpmijnlbanbab	FALSE
mdalnlmfghkhhfab	FALSE
mmikhojkkbkfmjab	FALSE
mmjeleedakoggfab	FALSE
nhcamcflnbfoelab	FALSE
nhckkholelfmfhab	FALSE
obodnphigglgidab	FALSE
ocbgnklpbpjpanab	FALSE
omdhkfmeanlcoeab	FALSE
omdiggleiblbpjab	FALSE
pgghcggkkjknlbab	FALSE
pggjilcmjfabdgbd	FALSE
aacijmnocnakhocea	TRUE
aackgphggaamkhedg	TRUE
ajfbjhkpbicgmfgla	TRUE
ajfbjldeonhbnbkdm	TRUE
bbnhfdjnflpgionkg	TRUE
bbnhjjkgegofemgom	TRUE
bmkhfmdnlindmckma	TRUE
bmkkmncfppilggfgh	TRUE
chbphcjhhchceando	TRUE
chcmhelalmgkmfdem	TRUE
dcdnpkmgdolokeggi	TRUE
dcdogjfdkokhmeffd	TRUE
dnhhkigchkindlckl	TRUE
dnhhmnlpgiepacpma	TRUE
ehfbhpojlpepjpdgk	TRUE
ehghgimogaeodhphg	TRUE
fbdchnoamneakphih	TRUE
fbeicpjefjnnpodjd	TRUE
fkienmjgfaogekcjj	TRUE
fkifnhedkkokjbmen	TRUE
gfagbkmacdidbfjde	TRUE
gfamnaeibjfabklab	TRUE
gpkdgaalepmjndahm	TRUE
gpkenahjlmmdnmpbf	TRUE
hkpnhlfmmhndmannp	TRUE
hladbopldbedjcpam	TRUE
ifappbhoekebhkbjj	TRUE
ifccekndkpepbliok	TRUE
ipiihjfekblgkjgog	TRUE
ipkbaanhgkbmfdlkp	TRUE
jjgjkmbdbldcaompc	TRUE
jjhfdepdhnjlojjjd	TRUE
kekeppkjpfebknpdb	TRUE
keknjianamgigjcdk	TRUE
kpikglaglekkmegbb	TRUE
kpjpjbbefaoofkaij	TRUE
liomjgacpjcgnbjek	TRUE
liomjoangcbgifpli	TRUE
mcnfeckemopjpmhae	TRUE
mcojpohbihahffnnf	TRUE
mmmobhaaillcbgdjo	TRUE
mmnlagofcdomhagih	TRUE
nganfdlmcmdniaecf	TRUE
ngaplgjdahjebkcnn	TRUE
ocgjgamhkgdlgagog	TRUE
ocgjgbkmmpccbfcdl	TRUE
olnecppjgdaoedopb	TRUE
olpaopllibbnklhjk	TRUE
pfkbenokgoiiohbmp	TRUE
pfohinagflojaccak	TRUE
aaapkdbnikaaanbab	FALSE
aabhbahgbldddeoni	FALSE
albiaihfopneioiab	FALSE
alckocbpcmhemicab	FALSE
bfgneoeggohlmpmab	FALSE
bfgpmlgabbhopdpcd	FALSE
bpjcodlkcpicagiab	FALSE
bpjkjokedeomcjoab	FALSE
cjfglcdgblcobanab	FALSE
cjgifgfcgpndcafab	FALSE
dcpdcoadfehncegab	FALSE
ddaciifgeohggbpab	FALSE
dnfejecfomdplgeab	FALSE
dnghibppkbhojpiab	FALSE
eiaigojbcclgklbab	FALSE
eibaodioehdlcbmab	FALSE
fchdkkjoaachjakab	FALSE
fcicfjcehffhgjhab	FALSE
fmgehnjldecbekgab	FALSE
fmhfajdlgchkpifab	FALSE
gfoeidlacngkaefab	FALSE
gfpnidnpicinfibab	FALSE
hacphdcjofeafhkab	FALSE
hadadjhhkkjbemoab	FALSE
hjiglhjicjbghdabl	FALSE
hjkdfoafpabcapfja	FALSE
ifdpoeigigildhiab	FALSE
ifediomfooabcepmm	FALSE
ipfkhijpeckbjjfab	FALSE
ipgldhdhhkjnjpbab	FALSE
jjdkppamflfigipab	FALSE
jjdomckmofdddeabj	FALSE
kcoihimngciijopab	FALSE
kcongbllmmogcpfab	FALSE
kmmobpadopidigeab	FALSE
kmnelfdjkfmamdeab	FALSE
lgomdhhdjnjcjoaab	FALSE
lgooeoalkhbljbdab	FALSE
mbpfnpioeddmpkpab	FALSE
mbpiifbpnmodiipab	FALSE
mmglghjjclpipabod	FALSE
mmhafhpokimefleab	FALSE
ngmbnkpkdmkdlhmab	FALSE
ngmfnhhlhlfoifjab	FALSE
obgabobgbolglbnam	FALSE
obgekglijllpmgmab	FALSE
olmmdpcojbhooobab	FALSE
olnapijkmnpmngjab	FALSE
pgcgclcfgchlmplab	FALSE
pgdehblmgddkgdlab	FALSE
aaaegfaokiplnpdehn	TRUE
aaahhnefajaadmcpdf	TRUE
ajicbipiddbcfgoinp	TRUE
ajihafpglhgdgklhka	TRUE
bdniafjbhcncmlnnmo	TRUE
bebanjnlabcnodmkab	TRUE
bonnekmlkbabniomab	TRUE
boofckhoadecdfdmjm	TRUE
cipghajkfpgmmbdiom	TRUE
ciplcilcglbbhkjpic	TRUE
ddhadkifjamlhnipkm	TRUE
ddhbbhjdfncckgmilk	TRUE
dnlhegejdpdfdckhak	TRUE
dnlkijbkjdkkepfoei	TRUE
ehjmhmjmmceppfhaak	TRUE
ehlpfpmgnncimojepa	TRUE
fchljdmacajcifmpnk	TRUE
fcjeockblaijhbmndj	TRUE
fmaoioepiomihimopg	TRUE
fmbccefkjiimkbioei	TRUE
ggelioognkpbjednga	TRUE
ggfbnpggpbhhbnkeig	TRUE
hanoajdajhnnoddgga	TRUE
haojiaflbmapaeogki	TRUE
hlmkdnnaiijfajiekm	TRUE
hlmnbeamfhfhflchko	TRUE
ifdjlcpnmbpndghhpo	TRUE
ifeimefcnpcmdohbmk	TRUE
ipagileaannkmocjfj	TRUE
ipamljldhjndllelah	TRUE
jiiaghicheaapbcipk	TRUE
jiifmjklohlockmjil	TRUE
kchgnakjechbmegoke	TRUE
kcholmebfoehejfkdm	TRUE
kmpafbfomlkolihcdf	TRUE
knadccphnehcilcihm	TRUE
lhimlcgalnklifimmo	TRUE
lhkddkkbcejenbkncl	TRUE
mclhopmgffccjcdnhg	TRUE
mcljhnlkninnhblolf	TRUE
mmmljbcakcoikibmin	TRUE
mmnenbfinpmedidghg	TRUE
nflmaadbnphdachodc	TRUE
nfnbponlheigajgjdb	TRUE
npgopjeigahegelmem	TRUE
npgpbhjilaehehidkh	TRUE
okdjcmdjdpegikjfol	TRUE
okeepbfdmmnfcmipjc	TRUE
pechmdfmoceeidpenk	TRUE
pedbidghcmkkiedbon	TRUE
aaanomeglngcbeooab	FALSE
aablpfpmcppgkhndob	FALSE
akipbihajlopcccmab	FALSE
akjfihgaankikfagab	FALSE
bfncadjooojkhopaab	FALSE
bfojapgjlljnablpck	FALSE
bppplehlcemoebljab	FALSE
caaefmhlidnnbipnab	FALSE
ckmddkliadpklkagab	FALSE
ckmodbmmalejagcgab	FALSE
dfcgeeoeeoljnbjiab	FALSE
dfckfgibjnijkdlnab	FALSE
dpekleckcbikkeekab	FALSE
dpffpjehppkdbjilab	FALSE
ekipdmmnaghkgkjgab	FALSE
ekjpiomlhnojddmeab	FALSE
fepcgedmllhgbjihab	FALSE
ffagakphophccdonab	FALSE
foamahmahcmnhebmab	FALSE
fobdfmajbgbalbigab	FALSE
gijpnmaibnmfggfhab	FALSE
gikcmbfcpmboeghfab	FALSE
hcdmejkjacmaclmbab	FALSE
hcefgifdcdjelaleab	FALSE
hmllgihboaapncjaab	FALSE
hmllpgdcaaeadbidab	FALSE
ihlmakhcbpmilkcnab	FALSE
ihmakoccijnhgcggab	FALSE
jbldllhmpeaegfmmab	FALSE
jblgbbmkhflbdkcbab	FALSE
jmjddpommokkoeacab	FALSE
jmjmncfcdploakhlab	FALSE
kgljdpebbidgkojjab	FALSE
kgmbgjpiamjfiehcab	FALSE
lafimgbfjmhfbdcbab	FALSE
lagghkkolklelchbab	FALSE
ljlikjemicjjchefab	FALSE
ljlmbkakhmljmkdmab	FALSE
mejdcodinbnffdikab	FALSE
mejiejgkohlicembab	FALSE
moagcbedffoidkieab	FALSE
moakcafojpadeacdab	FALSE
nhkfmepeolkakipkab	FALSE
nhlghlaicidbhkpeab	FALSE
objoigmflmfidgfjab	FALSE
objomgedodfnibbnab	FALSE
olinbmfcekljljilab	FALSE
oljlnhjgegmebbigab	FALSE
pgemgpdfhbhapaohab	FALSE
pgfbckcebgplaphgab	FALSE
aaaciigjfpjbeejapoa	TRUE
aacjdeimjijfcinjkdl	TRUE
akogpdcoeiokiklelgg	TRUE
akpmjkgipjipdcapmhd	TRUE
bffpjoabjeoflgbmcab	TRUE
bfgiemifgklfommehfk	TRUE
caljbmijagbeilcbcid	TRUE
camcelknofbnpbjmooh	TRUE
clicbeajgfipkcmimeh	TRUE
clidipogofmfcabdhab	TRUE
dfekijbpjoommpnlgdo	TRUE
dfenbfheablegfdkpab	TRUE
eajidaagbofgeedndan	TRUE
ealagilneibnfamheim	TRUE
ekikkooakpgeninohnh	TRUE
ekjihdmjifcohjmpfem	TRUE
femgjkekfdkmlbdimpl	TRUE
fenbnpjlilfbiflkekj	TRUE
fogcfkhnpdfbebgccpf	TRUE
fogdjhdekhniaejfdep	TRUE
ghnccihggbmebinonoj	TRUE
ghogpeoeebgjnafdepd	TRUE
hcecididegmnfpjmhjl	TRUE
hcednlichnmaepnbica	TRUE
hmheapamaoneidjdbbi	TRUE
hmipbecnjjkdlendofd	TRUE
ihaomihfpnidkffkdfj	TRUE
ihceclmajkoldcbcagb	TRUE
jbkoapflgmjgpcmkgpo	TRUE
jblajffflgjjhginill	TRUE
jlghbmlbikgmgchoepm	TRUE
jlibnmenkoihdmpmpgl	TRUE
kfofdejhmggclafobdc	TRUE
kfongiceigfegjphdae	TRUE
laaoadoefoceopieofg	TRUE
laapapdfkodaheikihk	TRUE
ljjpbmihepeoijejlpe	TRUE
ljknmnoedjdlilfbgdf	TRUE
mdimojaalpbonlnbakh	TRUE
mdjcpgdbcpjeelkoclo	TRUE
mngpaglojajpeehdjai	TRUE
mnhdbihkeagdnpfejnc	TRUE
ngcgjcioedfmpdladbo	TRUE
ngciekfghpbdfckbben	TRUE
npofciknkibhncoklco	TRUE
npohhknkgikgnkfofaj	TRUE
okfnmdjnljfgffjpgjk	TRUE
okgdaimeldmedgnopng	TRUE
peijjmaokgchpjngdce	TRUE
peililnnmdgpanhlige	TRUE
aaahobpfgcjajgkenab	FALSE
aablllbekdhahimmigc	FALSE
akelcghmlndoihlaabe	FALSE
akfagoeplniopoegeab	FALSE
belmfpfcfaihoeaepab	FALSE
bemfgapmebmahbhamab	FALSE
bnjijmmakghpajclcab	FALSE
bnobcoeiigkkomhccab	FALSE
ciegcgblgnfdbjgbbab	FALSE
cifgfkfmacabcfchmko	FALSE
dccbjgepkhflnmncgab	FALSE
dcdjdlepgldjboifkab	FALSE
dmheoolgnbbpfckneab	FALSE
dmiedgbccnagaeoobab	FALSE
ehabfaodiifhjebejjc	FALSE
ehaenopodbkpoomcfab	FALSE
fchcfdebjlgngigalab	FALSE
fciceffgeaialglpkab	FALSE
flhhcnfmhjkkhedddab	FALSE
flhpfjdgchbafbhmiab	FALSE
ggbgbogfmpekelfjcab	FALSE
ggbhhaifiebfliailab	FALSE
gpgmdmefmcjenmelpab	FALSE
gpgpchhingbapgjgbab	FALSE
hjjhapgkgfhpaeokaab	FALSE
hjjnlmebffnehdmkbab	FALSE
iehghfddjopjimfaboe	FALSE
iehpnbnbadkpoflpdab	FALSE
iofbkoocajopckhbhab	FALSE
ioflpeackcbjdhmelab	FALSE
jicmomhihgbcjbfkhab	FALSE
jiedapbpdfpcajfppab	FALSE
kbaacaacknobmndgfab	FALSE
kbabhjalhfpbldmcpdi	FALSE
kjpjjidgafpnclhfcab	FALSE
kkaijajlpelopmnodab	FALSE
lemaeaandiljdihadab	FALSE
lenlgjhaifaompenkab	FALSE
madihdpeefkhceldiab	FALSE
maeecccnldebfmbmjab	FALSE
mklpdgpgdpifonhioab	FALSE
mkmenlhncmbkngffcab	FALSE
neoojnpoofagcbgapab	FALSE
nepcijfjjkefhegodab	FALSE
oaoipmphjollekapfab	FALSE
oaolmgpnjmkliidgpab	FALSE
okiadkkobknbflbliab	FALSE
okjhipnedpjgaajegab	FALSE
pfeaiahnmfdlfodblab	FALSE
pfgagklmlkpbmehnabk	FALSE
