aacimepmgk	TRUE
aadepfkiia	TRUE
akffnpfoll	TRUE
akgmjcpjba	TRUE
becknocooj	TRUE
beecdjgeci	TRUE
bomnbgpggm	TRUE
boocnaenkf	TRUE
cjgodalbdj	TRUE
cjhhpigmaf	TRUE
deemcnchbm	TRUE
defhmmpnio	TRUE
dpbkbpeaoc	TRUE
dpbmjmbccp	TRUE
eilhdjnmja	TRUE
eimnopnjhl	TRUE
fddhdpenoa	TRUE
fdeclgocco	TRUE
foghfenfdh	TRUE
fogjlacpoh	TRUE
gicmlanook	TRUE
gidbkhlaoj	TRUE
hcdiabodab	TRUE
hcdioljbdl	TRUE
hmfkjeceha	TRUE
hmggkoocpi	TRUE
igigajeioi	TRUE
igjbkebcgo	TRUE
jancphamja	TRUE
janhjldfbi	TRUE
jljfmcecmj	TRUE
jllophnldb	TRUE
kfanmhpdjl	TRUE
kfaollpalj	TRUE
kpolphoepb	TRUE
kpphadikji	TRUE
lilfhfjocl	TRUE
lilleodjdg	TRUE
mdahppmkpm	TRUE
mdbdfcoeno	TRUE
mmoglcobek	TRUE
mmohefeobc	TRUE
ngmdndgipf	TRUE
ngmhcdhoge	TRUE
oceecilgla	TRUE
ocfnpclkag	TRUE
olmeablaln	TRUE
olnlongkoe	TRUE
pghcgkkedb	TRUE
pgiedhilnf	TRUE
aacimeabcd	FALSE
aadpmgabcd	FALSE
akcmhmabcd	FALSE
akcnbnabcd	FALSE
bdmhhmabcd	FALSE
bdnabeabcd	FALSE
boeeidabcd	FALSE
bofoboabcd	FALSE
cjdilnabcd	FALSE
cjdngoabcd	FALSE
ddngijabcd	FALSE
ddoammabcd	FALSE
doonngabcd	FALSE
dopackabcd	FALSE
eiffdbabcd	FALSE
eifmncabcd	FALSE
fecnhkabcd	FALSE
feelhgabcd	FALSE
fofgoeabcd	FALSE
fogaihabcd	FALSE
gjbmgabcdd	FALSE
gjdhhpabcd	FALSE
hcgadfabcd	FALSE
hcgckhabcd	FALSE
hmjmakabcd	FALSE
hmjmmmabcd	FALSE
igjfdpabcd	FALSE
igkehhabcd	FALSE
jbfleabcdj	FALSE
jbgcamabcd	FALSE
jkpoaiabcd	FALSE
jlahamabcd	FALSE
kflaheabcd	FALSE
kflkmmabcd	FALSE
kponbhabcd	FALSE
kppaopabcd	FALSE
ljhgljabcd	FALSE
ljigccabcd	FALSE
mchndiabcd	FALSE
mcimahabcd	FALSE
mnbcfiabcd	FALSE
mncojcabcd	FALSE
nhijcjabcd	FALSE
nhjclmabcd	FALSE
obkkmbabcd	FALSE
obkphbabcd	FALSE
olilliabcd	FALSE
oljfciabcd	FALSE
pfpoghabcd	FALSE
pfppppabcd	FALSE
aacimepmgke	TRUE
aadpfkiiabb	TRUE
akcmnppolle	TRUE
akcncnpgobd	TRUE
bdieoiiifgo	TRUE
bdjkabgepem	TRUE
boaillglkpl	TRUE
boaolmlijpg	TRUE
chmabjogeii	TRUE
chmobagmbij	TRUE
ddnbepllkgi	TRUE
ddnmbgnkgde	TRUE
dpelacbiohm	TRUE
dpffinlmpjp	TRUE
ejhmfidiheh	TRUE
ejihgnghkkf	TRUE
fdaokfhfgjh	TRUE
fdbfenfdhla	TRUE
fnnddbngkai	TRUE
fnoammjbkkp	TRUE
gimgoegidcb	TRUE
ginebiadndl	TRUE
hceolbghaaa	TRUE
hchjogibebn	TRUE
hmhkapegapl	TRUE
hmkmgemgild	TRUE
igkpihlbbjb	TRUE
igljanjdjbp	TRUE
jbbognnfnec	TRUE
jbcbbecjljo	TRUE
jlhjolbfmlo	TRUE
jliadajmbpm	TRUE
kfhohmjndfo	TRUE
kfnphebfpfb	TRUE
kplegciecjk	TRUE
kplfccbfhid	TRUE
ljdhgjbkjbe	TRUE
ljdkhpljmck	TRUE
mdhfcjcgfeo	TRUE
mdhjbcjdccj	TRUE
mndefakhcnn	TRUE
mndneppinag	TRUE
nheglbndobd	TRUE
nhephobedcf	TRUE
obpkdbikdaj	TRUE
obpkfkkiepk	TRUE
oldmnpchekl	TRUE
olejodjblel	TRUE
pgalobnjamf	TRUE
pgapepjjbib	TRUE
aabebhpabcd	FALSE
aacccljabcd	FALSE
ajbbeppabcd	FALSE
ajdbaidabcd	FALSE
bdbdhmfabcd	FALSE
bdblmneabcd	FALSE
bneemgiabcd	FALSE
bneolcdabcd	FALSE
chdchkaabcd	FALSE
chdiomnabcd	FALSE
dchefemabcd	FALSE
dciajanabcd	FALSE
dofknbnabcd	FALSE
dogfgdhabcd	FALSE
eipboojabcd	FALSE
eipcoalabcd	FALSE
fdagalaabcd	FALSE
fdaheciabcd	FALSE
fnelcdfabcd	FALSE
fneoepnabcd	FALSE
ghapkgjabcd	FALSE
ghbeolmabcd	FALSE
hbkophcabcd	FALSE
hblbknkabcd	FALSE
hlddicfabcd	FALSE
hlddpblabcd	FALSE
ifojnhabcdf	FALSE
ifokimhabcd	FALSE
ipmolmhabcd	FALSE
ipobbjdabcd	FALSE
jjaicljabcd	FALSE
jjbcikcabcd	FALSE
kdgedllabcd	FALSE
kdhgikjabcd	FALSE
knmoaiabcdh	FALSE
knnbidaabcd	FALSE
lilhlcgabcd	FALSE
liliadeabcd	FALSE
mcehobgabcd	FALSE
mcgjdbfabcd	FALSE
mnclapabcdc	FALSE
mnepeflabcd	FALSE
niggckbabcd	FALSE
nigjkgdabcd	FALSE
ocgkgfabcda	FALSE
ocgplpkabcd	FALSE
omjhepeabcd	FALSE
omjmfifabcd	FALSE
pgggpcbabcd	FALSE
pggnkmcabcd	FALSE
aabebhpcccfl	TRUE
aacjpmddbcoj	TRUE
ajbaklkjpadf	TRUE
ajciapejleal	TRUE
bcijaookjgkg	TRUE
bcjlkkmmigke	TRUE
bnabkogaehdl	TRUE
bnailbickekd	TRUE
chhpahjjkckg	TRUE
chicaffhaped	TRUE
dbknmiopaiib	TRUE
dbkokimpagja	TRUE
dnifedpdiggm	TRUE
dnjhbmkdcjej	TRUE
eioggflfgida	TRUE
eiopjpiobgce	TRUE
fcmidacdgnna	TRUE
fcngebpgkcaj	TRUE
fnglbmlaijed	TRUE
fnjgadaeckko	TRUE
ghnadjddnhck	TRUE
ghnjelbfelac	TRUE
hbhnanakdffb	TRUE
hbijiemmcohc	TRUE
hlchnhahncpm	TRUE
hlcndknobmfb	TRUE
ieolfmjkdfom	TRUE
ieongafhopeo	TRUE
ipikolfdedch	TRUE
ipjgilgnceoo	TRUE
jiccolbfepfh	TRUE
jicfmjgokheh	TRUE
kdlbikjnflfh	TRUE
kdljbhkieian	TRUE
kncnbkjcjmno	TRUE
kncoemffchfd	TRUE
lhnpbjikcnin	TRUE
lhpaopiokbkm	TRUE
mcmcglhbicod	TRUE
mcnfjegdefdn	TRUE
mnncnpejidgb	TRUE
mnncokhnfogk	TRUE
nhompkdlpeco	TRUE
niaemkgbdnjd	TRUE
ochenbcbhmkh	TRUE
ochkoedlphag	TRUE
onagdgeljcll	TRUE
onaljohfokjn	TRUE
pgbnhpijcaan	TRUE
pgcfeicfbmlc	TRUE
aaafhfhdabcd	FALSE
aabgbejfabcd	FALSE
akbcnfpcabcd	FALSE
akbijnagabcd	FALSE
bdeggbmhabcd	FALSE
bdepkfapabcd	FALSE
bmeiehanabcd	FALSE
bmfaipkhabcd	FALSE
chikmgniabcd	FALSE
chlbcnbhabcd	FALSE
dbmjmbloabcd	FALSE
dbmoibdmabcd	FALSE
dmdjfbocabcd	FALSE
dmejdfheabcd	FALSE
eflcgnmpabcd	FALSE
efncnkooabcd	FALSE
epakffeiabcd	FALSE
epanjonkabcd	FALSE
fjnjplelabcd	FALSE
fkamalggabcd	FALSE
gdobgncnabcd	FALSE
gdpbfllnabcd	FALSE
gnghocjbabcd	FALSE
gnhfbinhabcd	FALSE
hijgclblabcd	FALSE
hikihinhabcd	FALSE
icphbgljabcd	FALSE
idbpmncpabcd	FALSE
ineafppjabcd	FALSE
inemokmoabcd	FALSE
jhlpcpgoabcd	FALSE
jhmaefloabcd	FALSE
kccognonabcd	FALSE
kcdifaiiabcd	FALSE
kmnmigaeabcd	FALSE
kmocgnhnabcd	FALSE
lhfpffjpabcd	FALSE
lhfpohioabcd	FALSE
mbppodlnabcd	FALSE
mcachdakabcd	FALSE
mlnpboleabcd	FALSE
mlodaplcabcd	FALSE
ngcimkahabcd	FALSE
ngclddcmabcd	FALSE
oapgpedkabcd	FALSE
obadjoeoabcd	FALSE
olabegkdabcd	FALSE
olamoopcabcd	FALSE
pfabdkmhabcd	FALSE
pfaddojjabcd	FALSE
aaafhfhdgbejf	TRUE
aaboiipfabkcb	TRUE
akaahcilkbhep	TRUE
akaemiaakfjce	TRUE
bdlpefdnoelda	TRUE
bdndebmfgajha	TRUE
bngjldoioklci	TRUE
bngomkkgfmbbo	TRUE
chebncjoljlng	TRUE
chffdjpbbngjd	TRUE
dbpepeiflokpp	TRUE
dbpldolefdfaa	TRUE
dmcpdcnpmjnph	TRUE
dmfgmpfnlhooc	TRUE
efnbjcfhadcpk	TRUE
efneimhneolgf	TRUE
eoplnpkbbnaei	TRUE
epbgdajlgllei	TRUE
fiibbbpngpohi	TRUE
fiicappflhcmc	TRUE
gdonokcddpklk	TRUE
gdpdojmnbabna	TRUE
gnkdbkaempfkb	TRUE
gnkofpmjgjpen	TRUE
hhooiohmdnlao	TRUE
hhpddhpoofcfk	TRUE
idpfbpaahlchl	TRUE
idpmkdfakngen	TRUE
imjhjlcbnkkhb	TRUE
imkjappgcegnk	TRUE
jhghknncphjca	TRUE
jhgpddhkkhcpc	TRUE
kbmdngjogjmof	TRUE
kbmgaicbgoldn	TRUE
kmbockaddkmfa	TRUE
kmbpfknhfnlfm	TRUE
liceojnelkebo	TRUE
licilhdhegfhd	TRUE
mbnopmmmlimif	TRUE
mbogjpdliijla	TRUE
mlmipbgkfdglb	TRUE
mlnjjkpamphfm	TRUE
nglfdakmanjge	TRUE
nglpnfapemkld	TRUE
oalibnlabhokp	TRUE
oamdcifdpfebn	TRUE
oknhoemkkkcjf	TRUE
oknogebpmonbf	TRUE
pfiapdfcidikn	TRUE
pfigbcglljodk	TRUE
aaafhfhdgabcd	FALSE
aabbejfoiabcd	FALSE
akcphohababcd	FALSE
akdldhhonabcd	FALSE
bdeacbhjaabcd	FALSE
bdedbpclfabcd	FALSE
bnfigfcggabcd	FALSE
bnfmbabjkabcd	FALSE
chgnlohkpabcd	FALSE
chhiifmkpabcd	FALSE
dboincmhlabcd	FALSE
dbokhdjhbabcd	FALSE
dlljgfdjpabcd	FALSE
dllnbbngjabcd	FALSE
efocnglkkabcd	FALSE
efohbhibmabcd	FALSE
epdelfjljabcd	FALSE
epeifnnapabcd	FALSE
finkcopobabcd	FALSE
finnccigoabcd	FALSE
gdimnnapnabcd	FALSE
gdjegmkkeabcd	FALSE
gniokfbfdabcd	FALSE
gnjaiamhjabcd	FALSE
hhokhkogabcdn	FALSE
hhpdccgppabcd	FALSE
ickagjpidabcd	FALSE
ickfbpjhcabcd	FALSE
inpbgnneiabcd	FALSE
inpoppflgabcd	FALSE
jibkbaadeabcd	FALSE
jibnbgkalabcd	FALSE
kcbnhikgkabcd	FALSE
kcccfeeababcd	FALSE
kmnpdpncgabcd	FALSE
kmpfeipnbabcd	FALSE
lhdlijegdabcd	FALSE
lhebbpkbfabcd	FALSE
mceiccmlaabcd	FALSE
mcfllgknkabcd	FALSE
mlipohdimabcd	FALSE
mljlbhjpcabcd	FALSE
nhadpjckoabcd	FALSE
nhbfbdphhabcd	FALSE
oamihpkmcabcd	FALSE
oanplgdfabcdn	FALSE
oklblkalgabcd	FALSE
okllbnjfgabcd	FALSE
pfcfknokkabcd	FALSE
pfdnhnjjiabcd	FALSE
aaankfjgjffhfh	TRUE
aabbefklifecgo	TRUE
aimojkmomhpeol	TRUE
aindklejcnoakb	TRUE
beflgjknhphdkj	TRUE
behaiknjjhkdal	TRUE
booiakkbghilci	TRUE
bophfogphhefhh	TRUE
cifepdepejngpb	TRUE
ciffgjinceiobn	TRUE
dcabhmeifofoel	TRUE
dcahfdlghdmmgb	TRUE
dkmhmificoiiml	TRUE
dkngclmegnhimi	TRUE
efgnnjbcgnffep	TRUE
efhdjkojahchlb	TRUE
eoflghjehecnfj	TRUE
eogecgbggjcgmc	TRUE
fidbmedlookfcp	TRUE
figknfphheocik	TRUE
gdonjpeohikcjd	TRUE
gdooihghkjeocp	TRUE
gnijbomclhhnnm	TRUE
gnjaobjcaiglkl	TRUE
hikedhilhgjlap	TRUE
hilmnknknembij	TRUE
icpknedkkgoknd	TRUE
idbmkndgikggho	TRUE
iojkbibpejnbac	TRUE
iokobmbbhkepaj	TRUE
jighjfngeghcme	TRUE
jigljfdhmipibk	TRUE
kcaifchhomhckb	TRUE
kcapaebapnmkll	TRUE
kljgedcankngim	TRUE
kljlhcocbaelfj	TRUE
lhidmdccceopce	TRUE
lhilcbfcaknhlm	TRUE
mcmjkkgeifdhlf	TRUE
mcnfljebgchnom	TRUE
mnkmooabknhlmg	TRUE
mnlolphgmhpdoj	TRUE
niiechabpmoikd	TRUE
niihlbmlebpbfa	TRUE
ocphdplboelbbm	TRUE
ocpndaofodjpbm	TRUE
onohgedmkkldnb	TRUE
onojkimpkngmck	TRUE
pgoonfgjflkfjg	TRUE
pgopaaafonibmm	TRUE
aaankfjgjfabcd	FALSE
aabffhnbefabcd	FALSE
ailjpdpbnaabcd	FALSE
aipnhndanhabcd	FALSE
beciofalbmabcd	FALSE
beddcebekgabcd	FALSE
bopgnlngehabcd	FALSE
bpbbejplmkabcd	FALSE
cincacmhbaabcd	FALSE
cinnfaoejpabcd	FALSE
dbkakokakfabcd	FALSE
dbkbhehbpcabcd	FALSE
dldckjggepabcd	FALSE
dldeoahjedabcd	FALSE
efhjlalnoeabcd	FALSE
efhlhmiligabcd	FALSE
eoopmgffnbabcd	FALSE
eopaemjapiabcd	FALSE
fjghhakllfabcd	FALSE
fjhmmkalpbabcd	FALSE
gdfjkojahcabcd	FALSE
gdfkhlbljeabcd	FALSE
gnhphcbjloabcd	FALSE
gnikicamomabcd	FALSE
hicjdjegmkabcd	FALSE
hieljficleabcd	FALSE
idefomibgabcdn	FALSE
idggbinjinabcd	FALSE
iopdeglcbbabcd	FALSE
ipaeaafnhhabcd	FALSE
jigjiapnhoabcd	FALSE
jihbhaplimabcd	FALSE
kcihmkgdnbabcd	FALSE
kcjncokdncabcd	FALSE
kmhokfodmmabcd	FALSE
kmioillfobabcd	FALSE
lhbkiplglmabcd	FALSE
lhbmfhkakmabcd	FALSE
mcadanjcfoabcd	FALSE
mccfofpdmkabcd	FALSE
mnhaenhfilabcd	FALSE
mnhbmgbedlabcd	FALSE
nigapapcklabcd	FALSE
niihcdboglabcd	FALSE
ocohhipkmfabcd	FALSE
ocplkbdjjcabcd	FALSE
onbkpchhomabcd	FALSE
onbmhckbaeabcd	FALSE
phjidfjgjnabcd	FALSE
phkenpfpbcabcd	FALSE
aabbeddiofjnljl	TRUE
aabbmfahicmobbb	TRUE
alkddinakllbapn	TRUE
allbkdpckkldnci	TRUE
bfhleeakiaiokem	TRUE
bfhogjnepeapebd	TRUE
bompaadcfekjadb	TRUE
bompcanohooooga	TRUE
ciggpmmdojimfbg	TRUE
cighbmefjoobdcb	TRUE
degblhfhahclllo	TRUE
degfbccnnfbfmlp	TRUE
docjjhpgfkoogdm	TRUE
doegckfkoeddhhb	TRUE
eiebeofpmbpcfah	TRUE
eiehmlicinknjjp	TRUE
fbiojhjlnkbnbcd	TRUE
fbkelihkpppefad	TRUE
flffgfcggbojpbm	TRUE
flfglkcbakacpbd	TRUE
gfijabdodfbmpfl	TRUE
gfijjhioeiehdji	TRUE
halepngpeicicch	TRUE
hamcepfcljffpoc	TRUE
hkeoniapcdedgle	TRUE
hkfhlojmeahngjn	TRUE
iebdepgnifdfcgn	TRUE
iebnogfgjnpjbao	TRUE
ipdjpiobahbcldk	TRUE
ipfkdgfpngonehl	TRUE
jjdmgekaoakfbhm	TRUE
jjejfkmafiehbbd	TRUE
kdbndoednlfgikl	TRUE
kddnmjgnjbhmbpd	TRUE
kodlaaeapkgmjjj	TRUE
koeaohgaeliahjg	TRUE
lihpchlnfndopjm	TRUE
liilpbcanaiofjj	TRUE
mcckndmchankmoc	TRUE
mceijadodfijijd	TRUE
moapblondlgpnll	TRUE
mobbggnmikebljm	TRUE
nhjjpaolglcidhc	TRUE
nhjldohdjgfpdad	TRUE
ocgjgcnkpaokjin	TRUE
ochpjmhmbenoeae	TRUE
ombpoabplgnjdeb	TRUE
omdpahiblelogej	TRUE
pgecajpiojmjpaf	TRUE
pgecjnilokibfkh	TRUE
aacddfpkjjkabcd	FALSE
aacedbbeadeabcd	FALSE
ajpmeoagbhhabcd	FALSE
akaajgeiakiabcd	FALSE
bfjibjbolcjabcd	FALSE
bfkhcbfllababcd	FALSE
canajpjlmfeabcd	FALSE
cankbddafghabcd	FALSE
cjpdndolmhfabcd	FALSE
cjpokbgleolabcd	FALSE
dfncpllfjkbabcd	FALSE
dfodhinnpaabcdi	FALSE
eajhckkbgejabcd	FALSE
eajljoccipgabcd	FALSE
ekheoehamgmabcd	FALSE
ekijlkpcaelabcd	FALSE
fehegkjpndjabcd	FALSE
feieiecdibdabcd	FALSE
fngjgepbocgabcd	FALSE
fngpiaabfipabcd	FALSE
ghnbahfokhoabcd	FALSE
ghnbahkdcccabcd	FALSE
hbphmmkalimabcd	FALSE
hbpkmhoemhjabcd	FALSE
hlgcaojejnfabcd	FALSE
hlhclahjonfabcd	FALSE
ifocckjmbgbabcd	FALSE
ifpedlbjpahabcd	FALSE
jacgbnnoijfabcd	FALSE
jaejoccajfpabcd	FALSE
jklnbkfkhomabcd	FALSE
jknlnbjbpbdabcd	FALSE
kdkogpehlioabcd	FALSE
kdlhhimjdnpabcd	FALSE
knkeppoganmabcd	FALSE
knlfhcbgnneabcd	FALSE
lhfehmanlaabcda	FALSE
lhgeddemkmnabcd	FALSE
mbnjkggphmmabcd	FALSE
mbokbhfggegabcd	FALSE
mmpehffaochabcd	FALSE
mmpikmepnkmabcd	FALSE
ngpcpnpgbbeabcd	FALSE
ngpilcbabacabcd	FALSE
obhkkkdkkohabcd	FALSE
obhpcdnailoabcd	FALSE
olmcnmgmjceabcd	FALSE
olnaakhlmlabcdc	FALSE
pfkhmelggjfabcd	FALSE
pfmggkjoopiabcd	FALSE
aacddfpkjjkdbbea	TRUE
aacedelojlhlcige	TRUE
ajpdbppccigbbeap	TRUE
akaelokodjbfepkk	TRUE
behganhjpaollghn	TRUE
behgikphhkpohbea	TRUE
calibilfddoecknb	TRUE
calmhfonobfmjbpl	TRUE
cklhmplblefjilhf	TRUE
cknhcmjejomiklah	TRUE
dfgdibhimigindkh	TRUE
dfkjckfgblmknmeb	TRUE
eaidfpeehdkiimfg	TRUE
eajjbioloahafinn	TRUE
ekbpgjkbjefdckod	TRUE
ekdaobfgkmappgdi	TRUE
fedhekkdbhcgnpcf	TRUE
feejkjboojpmnkpi	TRUE
fnnobmolchkeokao	TRUE
fnoakfeopnfokajk	TRUE
gidhpfhkhaghcdej	TRUE
gidimpihceajlohi	TRUE
hcahhjfblbbkdhpc	TRUE
hcbanagchkjfbenk	TRUE
hleogephefigomib	TRUE
hlfmpdcdlpjendja	TRUE
ifpdcgomheidlelm	TRUE
igakgdbmdnicnlgi	TRUE
jajhpjcbpkiedhjc	TRUE
jajnijiokcipdnje	TRUE
jkdamelacnbiehcb	TRUE
jkdpfndaomcbhlim	TRUE
kekenhlpgdoemccf	TRUE
kelbgocdjhnnhbdh	TRUE
knglnjnaibknimdl	TRUE
kngolaiplobgafnb	TRUE
lifelbhpcaijpenm	TRUE
lifhogjgeaahcghd	TRUE
mcijgonmgcoknfhp	TRUE
mcjgbjjafchkclpg	TRUE
mmlemfdahbcmeoki	TRUE
mmlibngendkgiabh	TRUE
nheooalbgnokmcmm	TRUE
nhfcmdmlkjhnaikk	TRUE
obiohankjdjfielj	TRUE
objkgdhpkofadoil	TRUE
ombobmeldjncegch	TRUE
omchkkmndoihffpj	TRUE
pffggoocfbfdfhfl	TRUE
pffhihhaolegipbm	TRUE
aaafodpcfigbabcd	FALSE
aaapokbambblabcd	FALSE
akempojlpacdabcd	FALSE
akfbplnabdmpabcd	FALSE
beakdmmkpimoabcd	FALSE
beanbjihgnmbabcd	FALSE
boblbkjgfmibabcd	FALSE
bocifjofigmhabcd	FALSE
chjjndfjhjajabcd	FALSE
chjobmckdlhbabcd	FALSE
dbjipapgifhmabcd	FALSE
dbjpnllhchcgabcd	FALSE
dleomjdhhbboabcd	FALSE
dlfegkhenbalabcd	FALSE
eeglgekkpcnbabcd	FALSE
eehcepiolkfeabcd	FALSE
epjhkjcllhdmabcd	FALSE
epkfcngaldmmabcd	FALSE
fjglmphffihhabcd	FALSE
fjgnenhdghhiabcd	FALSE
gdndocoiplicabcd	FALSE
gdngonindfngabcd	FALSE
gnpfondmaknnabcd	FALSE
gobpdhpbijppabcd	FALSE
hicoiilboikpabcd	FALSE
hidlaandjicmabcd	FALSE
iamjpneonpfpabcd	FALSE
ianhfdipjofbabcd	FALSE
ikocciakbignabcd	FALSE
ikpfdlmbjmoabcdb	FALSE
jeiajmiinfehabcd	FALSE
jeimfebodjmdabcd	FALSE
joppbejddbnbabcd	FALSE
jpbjkjngdadkabcd	FALSE
kjidkfjlbeibabcd	FALSE
kjknakppmmccabcd	FALSE
lefjkalkjccdabcd	FALSE
legonlimeclgabcd	FALSE
lponhgijaeilabcd	FALSE
lppikomfpabbabcd	FALSE
mkhacgodbjheabcd	FALSE
mkiabejehjfbabcd	FALSE
ngaljcmcngpabcde	FALSE
ngbbmneccbopabcd	FALSE
oaeeoomcojhmabcd	FALSE
oafccmghjklgabcd	FALSE
ojkmcdlohneeabcd	FALSE
ojknofmlphlbabcd	FALSE
peldcembcnoeabcd	FALSE
pellicbcmjonabcd	FALSE
aaafodpcfigbokbam	TRUE
aaapbblfbjjddoifp	TRUE
akcjboicacailffja	TRUE
akediopkbldhjcidk	TRUE
beinnokpbmaljdonb	TRUE
belaedchhjmkakbdp	TRUE
bnjbdjhhhdmhlooan	TRUE
bnjecjkaggbenmieb	TRUE
chmgfjhnlbgdlnpah	TRUE
chnjicfjncciheocp	TRUE
dbcilokomacocodcc	TRUE
dbcjfonikpjeegdjh	TRUE
dkncekfooneodiann	TRUE
dknjkkfaniohfmnnp	TRUE
edncgppgbcbclbipk	TRUE
edpekgepoakhkepmi	TRUE
epdkljhlghogddpcd	TRUE
epebhjlbeiaehdakf	TRUE
fjoijgiadjpgafkgl	TRUE
fkalcmgelnopbiiee	TRUE
gehfkgpighiljioeo	TRUE
geifkimeinnfijfam	TRUE
gohhgfolihnmdpcom	TRUE
gohmhdmdbanfebfdj	TRUE
hhoekgibpmodcfokm	TRUE
hhogoncoelpbjjlne	TRUE
ibdgjobfdiopaimlo	TRUE
ibehobpbkfnfnejcf	TRUE
ikfkfgmjgbnjhdcak	TRUE
ikfnlonmhoafcmjfj	TRUE
jeongbnbdielgfmjd	TRUE
jfcjgeohcnconchpe	TRUE
jpfjabmdlogcfbmjl	TRUE
jphdlpojbfnpnmkgo	TRUE
kkcakepioldhdbgjn	TRUE
kkdboodcjdpkhbofg	TRUE
leikcicggpiainmkk	TRUE
leikkloaffghbcbib	TRUE
lppcmecbdijfcbkld	TRUE
lppejcjmccafogafb	TRUE
mkilnhajfafneabkm	TRUE
mkioghbkekbpfbfek	TRUE
nfkepebmdockjhokf	TRUE
nfkjbffilgkdpaeki	TRUE
oacppklajihjnipeh	TRUE
oadgocmgamffjhdph	TRUE
okliilgalibooefob	TRUE
oklplibkimcomfljp	TRUE
pfaacnlmfiicoblia	TRUE
pfainehgclaciibeg	TRUE
aaclganhlcbikabcd	FALSE
aacmgiainkhlfabcd	FALSE
alckcdpjpgojnabcd	FALSE
alcnlkaafdijnabcd	FALSE
bhbjeeencamjbabcd	FALSE
bhblcmnaljfjnabcd	FALSE
caenlmojhjcmoabcd	FALSE
cafabhppjpgefabcd	FALSE
ckfbdijfdicmkabcd	FALSE
ckgecaokolpbhabcd	FALSE
dfdngipihlmknabcd	FALSE
dfehmacmjcckcabcd	FALSE
doeadncbilhemabcd	FALSE
dofeaeoogbkdmabcd	FALSE
ehmgfendoeolgabcd	FALSE
ehmkphdpppjmkabcd	FALSE
fbnbhalpjhkiiabcd	FALSE
fbnobdfonohgbabcd	FALSE
flbgflffieiolabcd	FALSE
flbhapfdfmadcabcd	FALSE
gfnpbdbfgnkkgabcd	FALSE
gfppgpfhbaifiabcd	FALSE
gpdmedphkmkhoabcd	FALSE
gphahdeodhdjpabcd	FALSE
hjaebkljflcieabcd	FALSE
hjaiimpnjbhbpabcd	FALSE
iekenofjlimdgabcd	FALSE
ielgpoidmemijabcd	FALSE
ioedcloepnhigabcd	FALSE
ioeldjhnfblelabcd	FALSE
jjheaodffaecabcdb	FALSE
jjiddipicjenkabcd	FALSE
kcnhkegpcehnfabcd	FALSE
kcnmemojmhegabcdi	FALSE
knknfnnpeilmcabcd	FALSE
knnciaolhknbfabcd	FALSE
libfbolmkbomiabcd	FALSE
lidnfodkaofdlabcd	FALSE
mbgfahcecanhpabcd	FALSE
mbhjijepigfgmabcd	FALSE
mmhacmfmlgllhabcd	FALSE
mmhfldbhdlodpabcd	FALSE
ngeomifnkipopabcd	FALSE
ngepjnbpfneddabcd	FALSE
obeceoannekckabcd	FALSE
obemlifllngmjabcd	FALSE
olgadbanmjeejabcd	FALSE
olgkaphconljlabcd	FALSE
pfgdccganbmicabcd	FALSE
pfgfaclpgjpknabcd	FALSE
aaafjjpgdojdjolmna	TRUE
aabepecbahkdgjhcjn	TRUE
aldebknhicinnbphgj	TRUE
aldmlhejlmnndjhbli	TRUE
bgdhgemidjjaakjakn	TRUE
bgfeiimikooaklfkgm	TRUE
bpfebafjhanmfidggl	TRUE
bpfgajgpcdgalmibjj	TRUE
cinlbebjlmoknhnfga	TRUE
ciojgbfnmmioobkibl	TRUE
dcllakaelmdeocgini	TRUE
dcllbeklgbmllmkibp	TRUE
dneodelmgpjhmpgefb	TRUE
dnephhhjlojpaiodnf	TRUE
eiglfjjifglapieifo	TRUE
eigpmnacgjmdildpbo	TRUE
fcjnbkkkacdmfjkkii	TRUE
fclaccmibpfdoejjkp	TRUE
flnnhcfaooechinnmm	TRUE
floamhahhdeoelnglg	TRUE
gfacainkpmnigllood	TRUE
gfblpcbkajflicgemh	TRUE
gommcmhcplgnhbjabb	TRUE
gonbhliopofbegalee	TRUE
hkdlkcgcdmaaggacdk	TRUE
hkdmpmpjjncdepeedm	TRUE
ieghfkklenoofhkobj	TRUE
iehlajopondhapgiha	TRUE
iodbbfcbfmkpmcidfp	TRUE
iodgfpambddndfhjdf	TRUE
jjakdnaoeofcgndelm	TRUE
jjakkjddeefijbnnjm	TRUE
kcpilingdhijpaofnl	TRUE
kdabcmmddbfpbaidcc	TRUE
klnmmkncmblbmgfhae	TRUE
klpfjnngchhoeeaokm	TRUE
lgfnfbambecpbpelif	TRUE
lgggeecgljlbggboon	TRUE
mancjomadbgnnanjim	TRUE
manmjiagcjlbghnpna	TRUE
mlpgkejflaclekopdc	TRUE
mmaabinaadnhfmcomj	TRUE
nfpiofgkndnnckhahb	TRUE
nfplhidmabophiolli	TRUE
obcnddflodllndfomh	TRUE
obdaalchclhndokheh	TRUE
okeindaabecbgglgpb	TRUE
okfkgjijbfgjckakjb	TRUE
pfbdnhbbjfnkklkdie	TRUE
pfbgnkanioadamkncg	TRUE
aabnnckhlhjmmeabcd	FALSE
aabpdekoaacgkoabcd	FALSE
ajndmpcpkmlinbabcd	FALSE
ajnncponkkpjadabcd	FALSE
bdpjobdfifcebmabcd	FALSE
beaimjikgencjkabcd	FALSE
bpabolmmaibkhbabcd	FALSE
bpbjhcpakjocijabcd	FALSE
cippjhjmjfiohbabcd	FALSE
cjandfjnfocdbnabcd	FALSE
ddcelkmfcfffkhabcd	FALSE
dddpeckhonbjmoabcd	FALSE
doekmljdgehdikabcd	FALSE
doenahllnjibpabcdk	FALSE
eieibbnpgcekneabcd	FALSE
eiflnmpcnmnnfbabcd	FALSE
fbmeijjaieambkabcd	FALSE
fbmjcpbfckiodmabcd	FALSE
flhjoejinijcapabcd	FALSE
fllgllhgnoflnfabcd	FALSE
gfbocnlcoejanmabcd	FALSE
gfcpkdnckncaahabcd	FALSE
goehpglgbhhbnjabcd	FALSE
goejdiojmbaflfabcd	FALSE
hkecnkcnooihpdabcd	FALSE
hkffhnpemlalplabcd	FALSE
ifpccilcimfaciabcd	FALSE
ifpjmmfobkpikhabcd	FALSE
ipilplgdckpcjkabcd	FALSE
ipjemandffibfaabcd	FALSE
jkgfegdaelpdliabcd	FALSE
jkgiobbianjigoabcd	FALSE
kfbdddmnmbmdhdabcd	FALSE
kfbfkkpmibnldabcdm	FALSE
kpncleojoedbeeabcd	FALSE
kpnlopmhimpgmiabcd	FALSE
ljpkcfgcmbhlppabcd	FALSE
ljpkmdjdbomapnabcd	FALSE
mdoconmplagakkabcd	FALSE
mdpbmhfjdcjkcpabcd	FALSE
mnejkmlomhlclkabcd	FALSE
mnepihempnjddhabcd	FALSE
ngmnkgiggbnfaiabcd	FALSE
ngobmiolcepdpfabcd	FALSE
obmkelbbhlikbmabcd	FALSE
obofifdholhhceabcd	FALSE
omedjpfnomeakeabcd	FALSE
omeofmafkgieofabcd	FALSE
pfjjpngcbhgjoabcdl	FALSE
pfkhpgfobdgpdfabcd	FALSE
aabnnckhlhjmmedekoa	TRUE
aabpacgkonnkckbfcnc	TRUE
ajmmjlljeijohebjjga	TRUE
ajnaliccikanpanfikl	TRUE
bembahhaodmhajddneg	TRUE
benggcdbiooibnigbkf	TRUE
bofcbilnacanejicofd	TRUE
bofgfmmpfpgdhdjcmof	TRUE
cijokfghkihiiopffcb	TRUE
cilpmhpdmpdmhkfjlpc	TRUE
ddaphgcdhedapfefkip	TRUE
ddbmaonpnpccmfllakg	TRUE
dnonmidcgfnepdebled	TRUE
dnpdjefccpepmepkhph	TRUE
ehmeibjncmpeaidgohn	TRUE
ehmfplljniecjjlelmb	TRUE
fbekbklhmopjmfkgdjd	TRUE
fbemlnjhmfihpiknihp	TRUE
fkkglhheocmclcdakng	TRUE
fkllfcljhnpjgkmmflg	TRUE
gfgbbdgogkpjpnhebcg	TRUE
gfgbollmefcmoflfnke	TRUE
gomhoikdkckaehcoofg	TRUE
gomlnpolpnlfbdiaghn	TRUE
hkdapkklpboikojdlmc	TRUE
hkeaoimniknblpobllg	TRUE
iepnpjekbmkfaebcflc	TRUE
ifaemnlkcbanhfgbagk	TRUE
ipjjokkcpgkmicpigop	TRUE
ipjmlleebaklajedpje	TRUE
jkeakhjdmipojdkcleh	TRUE
jkejndjkgmdagbanbae	TRUE
kfggkjcamkbijbghpdd	TRUE
kfhjdfaekcdliiapomb	TRUE
kpmggnfloocapdgjhbg	TRUE
kpmkdigdehambmpcnmc	TRUE
ljkkoodldcfllocbjli	TRUE
ljklncgjciekddimhij	TRUE
mdddaijnfoanlpanhfp	TRUE
mddnjlaebgppiklnflk	TRUE
mmhbpgclkcbmiiddgmo	TRUE
mmhebanbccoklnhgfoi	TRUE
nhamaidmaglebnknmaa	TRUE
nhannjkoiomhklinflj	TRUE
obifjnajehcpehpempk	TRUE
obijbdnbplpfdcmcdpa	TRUE
omcheikoeafifejaheh	TRUE
omckmbhmihaijochpid	TRUE
pgeolaomphodoobndbl	TRUE
pgfkikfmhhhjmdfenpk	TRUE
aaajfkbhnadleneabcd	FALSE
aaalplhlikfhjfabcdl	FALSE
aljfpfmcpjbicjlabcd	FALSE
almaeejnfmabdmiabcd	FALSE
bggbehiebnaalefabcd	FALSE
bgkdmcnodicohmkabcd	FALSE
cbmcbbmhihchibcabcd	FALSE
cbmcdghmpnpppcfabcd	FALSE
ckemhcaehdfkpaaabcd	FALSE
ckfbnaccnahfnpfabcd	FALSE
ddkkimhchociidbabcd	FALSE
ddlhllclhofhfmkabcd	FALSE
dnfbkfehegkmmipabcd	FALSE
dnfkbljhepfmpmdabcd	FALSE
ehplmnkkbeefpibabcd	FALSE
eiabpelbamnaijgabcd	FALSE
fcdcbbeidkakaaeabcd	FALSE
fcdeifiabkoaikcabcd	FALSE
fndfijogabnghiaabcd	FALSE
fnelkjnpdgfnmhnabcd	FALSE
ggknmcplfmffbedabcd	FALSE
ggoieffdgaebenpabcd	FALSE
haielojnafbffmeabcd	FALSE
haikfmpfddnconpabcd	FALSE
hkncjjjngjohpnkabcd	FALSE
hkoockchdfchghjabcd	FALSE
ifaiodlenjdijklabcd	FALSE
ifbdpdcfmpghmgabcdm	FALSE
ioihmmgednnkmhnabcd	FALSE
iojihfkgminhmhnabcd	FALSE
jidcplmchapjegnabcd	FALSE
jieakjjnblccogpabcd	FALSE
kcmmbgdooclmpflabcd	FALSE
kcmnfpiopndnmknabcd	FALSE
kllomillbdhjhecabcd	FALSE
klmbmgcinkppabnabcd	FALSE
lflipphincooecbabcd	FALSE
lfljddenffbbelpabcd	FALSE
mbgcfaclebkipllabcd	FALSE
mbgkmjcjmgjemjjabcd	FALSE
mkkcgbjoiaagmecabcd	FALSE
mkkplfdmoecamcgabcd	FALSE
nfpcpohodndmdgmabcd	FALSE
nfpiceohhjpkljdabcd	FALSE
npkcbgeobaefbekabcd	FALSE
npkdgihleamacigabcd	FALSE
olggacalljcgpglabcd	FALSE
olgnacdkbihclflabcd	FALSE
pepaimiommdoadbabcd	FALSE
pepcoaoaflcokmbabcd	FALSE
