abajedfjgo	TRUE
abanfnflcg	TRUE
aiogmpodbc	TRUE
ajbfkfkcbh	TRUE
bdgaleopid	TRUE
bdgblgaglj	TRUE
bmandmofkh	TRUE
bmbljkegeb	TRUE
cfgfhicgei	TRUE
cfgjccapop	TRUE
cpnbpafkpf	TRUE
cpnecfeeno	TRUE
dkicljpdfi	TRUE
dkkagkfigh	TRUE
efcdeacemm	TRUE
efcmnhdknp	TRUE
eppjmfhjij	TRUE
fabgepdeoc	TRUE
fklhjcjoen	TRUE
fklnjpchno	TRUE
gfpbcldhhn	TRUE
gfpcbjajkg	TRUE
hbnjpiobef	TRUE
hbnmnlebid	TRUE
hmehdapdjd	TRUE
hmfidhoecg	TRUE
igkbjboidd	TRUE
igkciephpp	TRUE
jbafkilhnb	TRUE
jbaglccdnf	TRUE
jlmicppcaj	TRUE
jlnipipiek	TRUE
kfihifjcff	TRUE
kfimdhbmbn	TRUE
kocmjplbfd	TRUE
kodbcohfkb	TRUE
lifbopbolo	TRUE
lifoicpoej	TRUE
mdadnhkmng	TRUE
mdahlciggo	TRUE
mmlhbhklpg	TRUE
mmolapnkba	TRUE
ngkiipbpad	TRUE
nglobjiohd	TRUE
objnilfkck	TRUE
obmfbmoimp	TRUE
ollpcbeanc	TRUE
olmdggbagp	TRUE
pgcjgdjocp	TRUE
pgcnajhnpc	TRUE
aabipllfpc	FALSE
aabjhegbhl	FALSE
alfeihblaa	FALSE
alfkpmlaii	FALSE
bggibjmnaa	FALSE
bghhcjgiaa	FALSE
caikjegjla	FALSE
caipmkmfna	FALSE
ckchebplaa	FALSE
ckfacleila	FALSE
deilngblaa	FALSE
dejcbdolaa	FALSE
doggonjcaa	FALSE
doglanbgaa	FALSE
ehchjjmkaa	FALSE
ehdbcljoaa	FALSE
faidmemnoa	FALSE
fajoehkmac	FALSE
fldedlkpaa	FALSE
fldmiionaa	FALSE
gfajklgcfa	FALSE
gfbgdhbkaa	FALSE
gnlgihabaa	FALSE
gnmpkedfaa	FALSE
hibimflaka	FALSE
hibnnehgaa	FALSE
ibndmnofaa	FALSE
ibneihbfaa	FALSE
imgmipaoka	FALSE
imimipdpaa	FALSE
jhfjdpohaa	FALSE
jhfngnffaa	FALSE
kbgodpaoma	FALSE
kbkoenfcaa	FALSE
knhlejohaa	FALSE
knjnpiifaa	FALSE
likkbggcaa	FALSE
lilfkipfaa	FALSE
mdamojecag	FALSE
mdboddejaa	FALSE
mndcnjdfaa	FALSE
mndidaoffa	FALSE
nieiifldaa	FALSE
nienlfdpaa	FALSE
obniafcpca	FALSE
obnpcocaal	FALSE
omfejipkaa	FALSE
omggegdnaa	FALSE
pgckhidjaa	FALSE
pgcndakfna	FALSE
abbhlpnoeme	TRUE
abcokiajeee	TRUE
almfihifopi	TRUE
alniibemoin	TRUE
bgjofaloklg	TRUE
bgmfjknkclf	TRUE
cadejnhbnmk	TRUE
cadigmikpnf	TRUE
cldcfpbfpbm	TRUE
clebonefcne	TRUE
deghaemdplp	TRUE
degiklahmjc	TRUE
dofmbmdfbdl	TRUE
dogcmahncen	TRUE
eighphpebkl	TRUE
eigkemjgfia	TRUE
fafpellpggb	TRUE
fahpignddne	TRUE
fljcmjhpmnk	TRUE
flkhpplgiae	TRUE
gefnohdnooh	TRUE
gegdfbppofp	TRUE
gnpiiolbomp	TRUE
goaookngddg	TRUE
hhggfidmodg	TRUE
hhgjmjdhaog	TRUE
iblkghnoipg	TRUE
iblnlckpadl	TRUE
immgpbkonla	TRUE
immhhhmoadn	TRUE
jglfjlhgbhf	TRUE
jgnjmdcjakh	TRUE
kbjmlodcinj	TRUE
kbkjkjkcobj	TRUE
knfmamcimol	TRUE
knfngeopeio	TRUE
lijcdiibjoo	TRUE
lijibebffen	TRUE
mdeckjnbfjk	TRUE
mdendodicho	TRUE
mndpjimcbpn	TRUE
mnedphgmagg	TRUE
nheboehipkf	TRUE
nhfblffnkln	TRUE
ocblaneekbk	TRUE
occmmmepghc	TRUE
omcndhojfbf	TRUE
omegdakipfc	TRUE
pgknnaelipe	TRUE
pglajhibiag	TRUE
aabipllfpch	FALSE
aabjegbhlpn	FALSE
aldbhhgpmaa	FALSE
aleegklemao	FALSE
bhbehepebaa	FALSE
bheapiaflmi	FALSE
cagpkpcpakn	FALSE
cahmdcljmea	FALSE
ckmihopkmaa	FALSE
cknbiepkdaa	FALSE
deebelmkoaa	FALSE
deedmegjfaa	FALSE
dnolhjhioaa	FALSE
doahacdfjgi	FALSE
ehkebmblpaa	FALSE
ehlbffkahna	FALSE
faegbbfmcaa	FALSE
faelcgmnoha	FALSE
fkjfngpfjaa	FALSE
fkmfibjplaa	FALSE
genakejekga	FALSE
genlfboifaa	FALSE
goheelgelaa	FALSE
gohobkjhbaa	FALSE
hhjnoohdfaa	FALSE
hhkbppofpaa	FALSE
ibekkgpdcaa	FALSE
ibempejdiaa	FALSE
imjkicbcaap	FALSE
imkgpdjfpaa	FALSE
jhcacnggpia	FALSE
jhdoloainoa	FALSE
kbijpihnpaa	FALSE
kblcncipaca	FALSE
kngnndhgpaa	FALSE
knhnfhcpbaa	FALSE
lifedogbdaa	FALSE
lifehobofaa	FALSE
mdjhilffdaa	FALSE
mdjihcbdjaa	FALSE
mnjnnemjcaa	FALSE
mnlnkkekiaa	FALSE
nhimhbcjiaa	FALSE
nhjcekgllaa	FALSE
obeeodnmmaa	FALSE
obfchkbdpaa	FALSE
omgligddcaa	FALSE
omgmmdiekaa	FALSE
pfdofbdklaa	FALSE
pfeallcbmaa	FALSE
abaelencleoi	TRUE
abbapgjedpig	TRUE
akgjjpclelgl	TRUE
akhiokfcohdf	TRUE
bdpmlibbgkbm	TRUE
beabhmgappgd	TRUE
bnmppefgajce	TRUE
bnoihajlldph	TRUE
chimegnobdnj	TRUE
chlmjmfiknhe	TRUE
dbpifbbljegb	TRUE
dbpokigigalh	TRUE
dmnigifkfbip	TRUE
dmnjifmfoohc	TRUE
ehbangddbllb	TRUE
ehchcikidejh	TRUE
fbngonednnad	TRUE
fboakgoolbdb	TRUE
fmjlomdgpppp	TRUE
fmlijajjomfo	TRUE
ghiccbcekbhd	TRUE
ghjcjpmapmmb	TRUE
hbchbekiocap	TRUE
hbdjloemjddk	TRUE
hlfoibgcdlhp	TRUE
hlfolfccjbli	TRUE
ielclijehfkg	TRUE
iepgcfffgifh	TRUE
ipjjegaedeoe	TRUE
ipjllipnbapd	TRUE
jjognchefhof	TRUE
jjokfhgcpomf	TRUE
kcobdgdlgkhf	TRUE
kcodglcmcjlm	TRUE
kodaplhjjehj	TRUE
kodcgoppipbc	TRUE
lijanpgjcpie	TRUE
lijhnhjjimec	TRUE
mdlfpocoidgl	TRUE
mdlofnbpmkal	TRUE
mnlcgobmhnkk	TRUE
mnmloejjcpkc	TRUE
nipoijglnaic	TRUE
njappijjbokj	TRUE
ocdaoinpnjoh	TRUE
ocdhmejfobkl	TRUE
ollhgfjnppmc	TRUE
ollihnjihmnp	TRUE
pgifelakkhig	TRUE
pgiiobdbhihl	TRUE
aaajblnpabbh	FALSE
aaakdbcmjmgl	FALSE
akgjifcibana	FALSE
akhjfpkkjman	FALSE
bdoaccimnpia	FALSE
bdoniacegdka	FALSE
bnohblcmjmaa	FALSE
bnolcmamjmla	FALSE
chfeiaekjiap	FALSE
chgiphfadbaa	FALSE
dbfincmedfaa	FALSE
dbgfdpgjdfaa	FALSE
dmfnlkiohiaa	FALSE
dmgkiehlmgaa	FALSE
egoeilacppia	FALSE
egoobjkdopaa	FALSE
fcdipemcpdaa	FALSE
fcefpfialpha	FALSE
fmeakpkcclma	FALSE
fmffaniclnga	FALSE
ghebdkjhckaa	FALSE
ghgcfneegmaa	FALSE
hbdijgchjlaa	FALSE
hbfhginjicaa	FALSE
hkkilbgoakca	FALSE
hkkmfjiccfaa	FALSE
ifcoedocmiaa	FALSE
ifdmohjdglaa	FALSE
ipleabodoeaa	FALSE
ipljpldmoiaa	FALSE
jjidljncmeaa	FALSE
jjinghbnpnaa	FALSE
kdnjfdlgjiaa	FALSE
kdnnndeleoaa	FALSE
koeeogkdobaa	FALSE
kofaejpcomga	FALSE
ljdkomadfmma	FALSE
ljdmodbbihaa	FALSE
mddknagegkoa	FALSE
mdfabgjpdhaa	FALSE
mnklkodegpaa	FALSE
mnobbeajfhoa	FALSE
niikamijhcma	FALSE
nijiacmkikca	FALSE
ochliahlkila	FALSE
ochnlmelbfaa	FALSE
olomefjogfaa	FALSE
ombgbnjcblaa	FALSE
pggmgdhimdaa	FALSE
pghdeplopeaa	FALSE
ababdnjklgmnk	TRUE
abcppepegpdhc	TRUE
ajofefcbjkdfh	TRUE
ajolpldcgdkdp	TRUE
bdiajegblljlh	TRUE
bdihimicngoal	TRUE
bnnpiiaemhmjb	TRUE
bnodfkjpjdfep	TRUE
cibdcoeigbdkl	TRUE
ciefdiglhjebe	TRUE
ddgaonmbjegde	TRUE
ddgkoeafmeggg	TRUE
dmopgbiojgopp	TRUE
dncmpjnlbipog	TRUE
egnjgkgadckba	TRUE
egocoeohfdgij	TRUE
fcjajckmjkhnb	TRUE
fcjidbfhkfkfa	TRUE
fmljnlcneeajo	TRUE
fmlkedkhklnln	TRUE
gfjhhbgjindle	TRUE
gflehfhngbhmb	TRUE
haiifhipnejde	TRUE
hajballnhpipo	TRUE
hlfbojopmngio	TRUE
hlgicoooiliib	TRUE
ifpamdlmplnbd	TRUE
ifpjkpoiifkgj	TRUE
jafdggljcdegj	TRUE
jagfjecfleokn	TRUE
jlfcfeaejkgii	TRUE
jlgaiclhoeoio	TRUE
kfihdlchenpej	TRUE
kfikieppdnjeg	TRUE
kpoelpoegofep	TRUE
kppmkdgnmjhfb	TRUE
lkfldlfimdchd	TRUE
lkfpdhcjbappj	TRUE
mdpbkphdiloco	TRUE
mdpgijgdbdlga	TRUE
mnmdopjbjpckj	TRUE
mnmgjigefojbg	TRUE
nhjeeihkbpdfd	TRUE
nhjnjihhpjghf	TRUE
ocfgijkdelomj	TRUE
ocgipfglgpbbg	TRUE
olkafchnkggeg	TRUE
olkknbjpclokf	TRUE
pgejmnfgadhpf	TRUE
pgenffpikdmnp	TRUE
aabcnjhlinkeg	FALSE
aacnlaodadnjk	FALSE
ajgbileickfaa	FALSE
ajginpceoaaih	FALSE
bdhledihhfkaa	FALSE
bdighlmfhdjaa	FALSE
bodgonknlmnaa	FALSE
bofieflblmoaa	FALSE
cioiclgfnjeaa	FALSE
cioleppkboiaa	FALSE
ddkajfjneihoa	FALSE
ddkikdbpehpaa	FALSE
dnecdmnakhfka	FALSE
dnegjnjmmkpaa	FALSE
ehannebdcihaa	FALSE
ehbhedmcnoama	FALSE
fblkeohfdgiaa	FALSE
fbmjaifmbipaa	FALSE
flmdljcggjjaa	FALSE
flmiomgdcmiaa	FALSE
ggmagobcjgmaa	FALSE
ggmbfljkgjjaa	FALSE
hapklhphkhnla	FALSE
hbaobhbipfeaa	FALSE
hklfkbpclloaa	FALSE
hklgooljbanda	FALSE
ifpgkkgmdfhaa	FALSE
ifpkdkaeabcdc	FALSE
jagdahlaaofcb	FALSE
jaglochffhlia	FALSE
jlepnlibopdaa	FALSE
jlgjkbpplnfaa	FALSE
kfppeeojcjnaa	FALSE
kgamhpgjmfdea	FALSE
kpnlmgjcjbjaa	FALSE
kppibimgehiaa	FALSE
lkhkfilididaa	FALSE
lkkbdhoepkaja	FALSE
meigffikfggaa	FALSE
mejcaihgfdioa	FALSE
mnhibmnlleaoa	FALSE
mnhphlencccaa	FALSE
nhhfmapnjneia	FALSE
nhjcnpnbchcaa	FALSE
oceeegnjenbaa	FALSE
ocfbophclblaa	FALSE
omdikbiabdgaa	FALSE
omdndhkeoonaa	FALSE
pgekfdblcnpaa	FALSE
pgfbaefmkgeoa	FALSE
abadbnhdpcpikp	TRUE
abadcigfhjkejn	TRUE
akdhkngpfbpjdd	TRUE
akdpideppfiipo	TRUE
bedgljnfljlooe	TRUE
bedhhanmlgdelg	TRUE
bnecgcpmnmhcad	TRUE
bnenedhedfjobh	TRUE
chdjogblcgphgi	TRUE
chdolfikkbeljn	TRUE
ddblkeoclmhpgg	TRUE
ddbpoebjdbgbdh	TRUE
dnkdobnopncfnn	TRUE
dnlbcdhohlaljk	TRUE
ehohfonjhmpfna	TRUE
ehppanebhaojhi	TRUE
fccmjhdfcjehdi	TRUE
fcdcdekgkieonk	TRUE
fmdbhfhenefakb	TRUE
fmejonfmhflpin	TRUE
ggmacklokdmmjl	TRUE
ggmdgjdkpoeffk	TRUE
haijppoenhhnml	TRUE
hajghiincoicib	TRUE
hkcgmpcokchdgl	TRUE
hkchcblhkbihag	TRUE
iedcgbkkcjjolg	TRUE
iedinpfkebfhip	TRUE
iodomecckkldgb	TRUE
ioeicibmcnokji	TRUE
jhgjeilmgdflbh	TRUE
jhiaokikpokcch	TRUE
kcbjmnieleohcf	TRUE
kcceihoadpflkl	TRUE
knenannmggmmpo	TRUE
knepgbmbpmjegp	TRUE
lhjocckkflebpb	TRUE
lhlfambknipahh	TRUE
mcafjgfcndjhdc	TRUE
mcaipihncccbkg	TRUE
mmgilgmojohglo	TRUE
mmlihemfnfgejg	TRUE
niegjleliemiif	TRUE
niflfkconjldba	TRUE
objcedhclljkhn	TRUE
obkjipcdncgjgg	TRUE
omljokhpbghlcl	TRUE
omncfbpopijaie	TRUE
pgnkaggbhjbjhf	TRUE
pgnomcbolgagki	TRUE
aaahcfaaappfcd	FALSE
aabdcpadgpgfpc	FALSE
ajmjhbpiefibaa	FALSE
ajmkjbhanineea	FALSE
bcpokiildmhnaa	FALSE
bdbeefaddkehla	FALSE
bmmbhlamnpoioa	FALSE
bmmdngnpaikmca	FALSE
chobckdfmjljaa	FALSE
choficpdlainaa	FALSE
dcjgjijjcfglaa	FALSE
dcjppleclcekaa	FALSE
dmlmjfmfkjjfaa	FALSE
dmnoklehdpodaa	FALSE
eidcaafbcnpdpj	FALSE
eidedeecipmfaa	FALSE
fbpgdhnfjocfaa	FALSE
fcaakifmkpinjo	FALSE
fmopdochokngaa	FALSE
fmphgfmcehdafa	FALSE
ghddccmeejljaa	FALSE
ghdpakkfkpkpla	FALSE
halimcadiclflb	FALSE
halpihafdfmoil	FALSE
hjkddjpannpoma	FALSE
hjklfhkjbohjaa	FALSE
ieabpkcldlomaa	FALSE
ieajpehbdkbfaa	FALSE
inieaolimpbmaa	FALSE
injocgdpncieaa	FALSE
jibgabhnidgiaa	FALSE
jibmbhhbknfkaa	FALSE
kcikolgfgednaa	FALSE
kckgneoldpcjaa	FALSE
knbicpcehbmoaa	FALSE
kncclanhiejena	FALSE
lhklfbjkidnjaa	FALSE
lhkmcfidipdmaa	FALSE
mbkpmbcphghgaa	FALSE
mblhieagblhlaa	FALSE
mnakjpnkphcoca	FALSE
mnbhicpogndlaa	FALSE
nidehfhinppiaa	FALSE
niehmimfpojcaa	FALSE
obdfejegkhldaa	FALSE
obdfhadbjcfgaa	FALSE
ondnmjaejcodka	FALSE
ondofphnfbocaa	FALSE
pgcgbgfedgnjaa	FALSE
pgdbachmmbonaa	FALSE
abalikfblbnmpkj	TRUE
abampigbacblnfl	TRUE
akcnmcccjbochfl	TRUE
akdnnlkmbfcbgde	TRUE
bdfmnpkmklpkggp	TRUE
bdgfdfhiiladbpm	TRUE
boajkilnkbpagep	TRUE
boddogibaljlnej	TRUE
chiigbheckboejb	TRUE
chjbipkgpkajiee	TRUE
dbfhbpjgbfjfbnl	TRUE
dbfiojhddnbglmd	TRUE
dljpkhikkbinpmh	TRUE
dllklbkaklonjbk	TRUE
eejjlinecabkeml	TRUE
eejkocfbgjlpnmc	TRUE
epolbkenclljogn	TRUE
epoofkajjbknffj	TRUE
flbaflpbleljeoe	TRUE
flbhnblenmlmlme	TRUE
gefnbcndgfaijio	TRUE
gehgfjfmfapfmpp	TRUE
gopakbblmbkbebj	TRUE
gpdchpfopolgpcn	TRUE
hkbpjekncmmagbl	TRUE
hkbplckniibodlg	TRUE
iehlpleeneehpen	TRUE
ieidfloafmehhhp	TRUE
inplblfbppkknpk	TRUE
ioacloknehlilok	TRUE
jjecnooddckhkng	TRUE
jjgaomjldojckol	TRUE
kdhnnamofmmijjp	TRUE
kdikkeelklhbmkp	TRUE
kohmlihnehohmkl	TRUE
kohnhgcpnckplmf	TRUE
ljaflhnhgfhhckj	TRUE
ljafmhlbnijofaf	TRUE
mcmfpnbfncjbdbn	TRUE
mcmibdnjajdkgcl	TRUE
mngcekapnebhfjn	TRUE
mngmlcjncihohak	TRUE
niegdphjammjncb	TRUE
nifkiememhigfdj	TRUE
ocombgokkklkfad	TRUE
ocpjcjpdoblgkam	TRUE
omclafbmpafojnd	TRUE
omdbclojaonpcko	TRUE
pgllfmemhanfbpj	TRUE
pgmgjffhohamkfi	TRUE
aaaadibjjkbiged	FALSE
aaakbeelojlnmne	FALSE
akababkeedkipdo	FALSE
akabhhnplfegnmj	FALSE
bdfalpeodidngia	FALSE
bdflkbbelhelana	FALSE
bmifmamadpkpjaf	FALSE
bmigchleihgkaka	FALSE
cgiodidjocopfaa	FALSE
cgjffpbcilbdpaa	FALSE
cpknnajacgefkni	FALSE
cplganjpblfbnaa	FALSE
dkkpckcceimcoaa	FALSE
dklalnplohcdnai	FALSE
edobfaokcnddgia	FALSE
edoibpoblcphlaa	FALSE
eodgbijdejdhgaa	FALSE
eoeigmmbkbiljaa	FALSE
fipplpngdacbana	FALSE
fjadpcadlfmcngm	FALSE
gegddnjnkmgmlaa	FALSE
gegildleijnncaa	FALSE
gokonbepacecpna	FALSE
goldkmmficfoeaa	FALSE
hidocehejbkgoaa	FALSE
hiebfpgdgdplfaa	FALSE
idabjkjmhelhoaa	FALSE
idafpfnfdlnmaca	FALSE
ineddpekdniedaa	FALSE
inepdicnimlaola	FALSE
jihjdeipnagkmja	FALSE
jihjoojhjndoiaa	FALSE
kcgjjcllnoedbaa	FALSE
kcgpjfihgleepaa	FALSE
kmonmlkefbkjmaa	FALSE
kmooiimlnenijaa	FALSE
libokdlgimibhaa	FALSE
lickmllghhbnlaa	FALSE
mbhglieookhioaa	FALSE
mbkfiaopkhhfjca	FALSE
mmbidedpojjjeaa	FALSE
mmclgnhiggcmjaa	FALSE
nfplebeagppmfga	FALSE
ngbcjiobdhbgpaa	FALSE
oailojadjpffjdd	FALSE
oajhjodgildhmla	FALSE
oldengbbhljaina	FALSE
oldoameaiecebbk	FALSE
pfgpenlpejkemaa	FALSE
pfhbljaegflnjca	FALSE
abagfpkfhggcjfdn	TRUE
abbhgpphfjkmijdj	TRUE
ajnkhioimingmjlc	TRUE
akbefchomofnamlb	TRUE
bdgpdjepenmlffih	TRUE
bdjkhikkhlclfemp	TRUE
bnbnalodplbbpnfo	TRUE
bndomdnfpkfgahdn	TRUE
cfinlpfkackeogno	TRUE
cfkibjllkechfali	TRUE
cpidffofhbafbpha	TRUE
cpihojjjlomoipcp	TRUE
dkeoenldilkhapdc	TRUE
dkfnpmbghofapjbd	TRUE
eeabkpoflahfioem	TRUE
eeaddlddoomiopnk	TRUE
enpoopfhkhgmjldj	TRUE
eoaedomomlicgebk	TRUE
fkjlbhblfepdachd	TRUE
fkjogekdmlodajeo	TRUE
gehbhpabfcagloei	TRUE
gehiaomgihhfeoim	TRUE
gohmngokdpcblfjc	TRUE
gohpjjpfpiajihcd	TRUE
hjgclolbanofdebh	TRUE
hjgdejmjohpblhej	TRUE
idcfpemnfdonhjhf	TRUE
idcldmkplodflbmi	TRUE
inecjckjegllpogl	TRUE
inehimojhekcnopi	TRUE
jibfglnoioaoegmk	TRUE
jidpggkhioebnkpm	TRUE
kcciejlebadndjnj	TRUE
kcdekhdiblpbaocl	TRUE
knedlmdlgboielgg	TRUE
kneepbcepokllmme	TRUE
lhmljnbifmgofpgc	TRUE
lhmohhjaglmgoikp	TRUE
mcgpnemfiegjkgio	TRUE
mcheomojipgelkib	TRUE
mmifpgfgbibkhdco	TRUE
mmihfidgclcjekhc	TRUE
ngghimijdjeeghal	TRUE
nghedkihlggmakhh	TRUE
oahfcipfhdmiemoc	TRUE
oahhbpbhbgmfgdjg	TRUE
okhipillnbcemjlm	TRUE
okhniggpljblbifb	TRUE
pfjobbfgkmbgmaie	TRUE
pfknpaeibhhklngo	TRUE
aaaacefmcihjpmdh	FALSE
aabgpiojeocpaoec	FALSE
ajedkjkgacgkaeek	FALSE
ajehjcdhmbbbeoaa	FALSE
bdjdabmlogbfniaa	FALSE
bdkpddcbcblghhaa	FALSE
bnkhhpilgnekogaa	FALSE
bnkkpadojcikjoka	FALSE
chlaphknlgkmloaf	FALSE
chmaocaeojfppdmm	FALSE
ddkpjljdbjloegaa	FALSE
ddmacijllbpffiaa	FALSE
dooeekllchgfcoaa	FALSE
doonahjepglgeiea	FALSE
eighpljfdjbfpkaa	FALSE
eiimcpbaccgncdea	FALSE
fcekankejmggjhma	FALSE
fcfaoefclmakhpnb	FALSE
flnheconciellmaa	FALSE
flnnpjobkinhepaa	FALSE
gfbofebjmjjdhfaa	FALSE
gfclediabmbiekaa	FALSE
gpgkanjcicfefkga	FALSE
gpgmefmpkcbeejaa	FALSE
hilicgljbgmndfaa	FALSE
hinkoogaeiapkjkm	FALSE
idppcpegmibagjia	FALSE
ieadajjmnphgpjea	FALSE
iofaljibaklfkadh	FALSE
iofbjgcmjbmnpgaa	FALSE
jhkmollcafmmkgna	FALSE
jhkpdbaenbkgkiaa	FALSE
kdaagfcnnhgjbijf	FALSE
kdbkkpdoacbjaaca	FALSE
kmmfdficfcmpggaa	FALSE
kmmmbipnabpcbaka	FALSE
lgpmbkadeocamnfm	FALSE
lhbbkbnicfpeahca	FALSE
mapaiaopndaejnhn	FALSE
mapelbogcbbldjaa	FALSE
mkjaakkaiochpcfd	FALSE
mkjacpkmohjaokam	FALSE
nfecghaklpdgdbaa	FALSE
nfgamnjbknmnipaa	FALSE
obflockhbijhbkaa	FALSE
obhafpdcnpjkllla	FALSE
olnadmomgnegbgaa	FALSE
olnbkbjmciehjpaa	FALSE
pgponoemkaedfmma	FALSE
phciobkooemadpna	FALSE
abafdgfbdfkpgofcf	TRUE
abappkgcjjdckodfp	TRUE
ajkkjckipignlgmic	TRUE
ajmbhpmgeolmlikfo	TRUE
bddlecfjkkecakgle	TRUE
bdefffgbngddogdbe	TRUE
bnijiniipddofinng	TRUE
bnjbaigmbhefhhofg	TRUE
cicfdajpnmnbmfgnh	TRUE
cieadjejhhnbgnkie	TRUE
deacgginodmmkjjfh	TRUE
debpjlcgabenocfgf	TRUE
dokblgckafmeonbnd	TRUE
dokmcjjajcjmddpmn	TRUE
ejeofipmmgjginpbl	TRUE
ejggibhbnipbdemcp	TRUE
fcelegckjdddghlkb	TRUE
fcenlnijhddogenjo	TRUE
flibkdceoldlacpij	TRUE
fljdpgfjedcnjclkl	TRUE
geoccmloakfbkgobl	TRUE
geooaifijcngcjnfi	TRUE
gpmfpmjkhcodlmhap	TRUE
gpngjplncafcndieh	TRUE
hkhfilddebioehgng	TRUE
hkiingpddfinidmdn	TRUE
idhelbefammbblnkl	TRUE
idhfjpfkffjaoeken	TRUE
inlmmonfikjmpieeg	TRUE
inlnlcemppbgllphg	TRUE
jidkgfdoljpbhefkh	TRUE
jidobcoagbbeommmg	TRUE
kdhnoahhnemhnbcjh	TRUE
kdhofegbbfopjhjoc	TRUE
kmjniemlfgnmoecoi	TRUE
kmkfkkmffmpalcfoo	TRUE
lhenmfhimbgecbhmh	TRUE
lhfcdainfcjiimhcj	TRUE
mbbggbaiegblakgdl	TRUE
mbbielneddmohcahc	TRUE
mkppkggdmhnpphocm	TRUE
mlahjifnkfdhielfl	TRUE
nfkgcoglphgjemcln	TRUE
nfllnhkkocbkmnllj	TRUE
obeaohdphoengnfdd	TRUE
obehgohgaofhooigi	TRUE
olmmlaemhdgmiblbp	TRUE
olnpekcgefjjefiae	TRUE
pfphbphaomfiiohmc	TRUE
pgbgigomenpjpdmbd	TRUE
aaaikpiedphbgpjck	FALSE
aaelmeeoephdphndk	FALSE
aklddnogaploigpne	FALSE
akodglnbgimmbmiaa	FALSE
bebbgfckbddaghofa	FALSE
bebjeapcbgknagnpa	FALSE
bokiplpoahbehnoaa	FALSE
bolcdpkcabhcgggaa	FALSE
cihoehmmnffiednaa	FALSE
ciiikpaofplpbamla	FALSE
ddjaheddedebkkkaa	FALSE
ddjckocmcbegfpgaa	FALSE
dnnnhajjcjbblgnaa	FALSE
dnoihjcgcjbojojaa	FALSE
eighmfmmfpgomnama	FALSE
eigngllpcfifjlhaa	FALSE
fcplkopclkcdiaadk	FALSE
fdacdahkcgpjkhgfc	FALSE
folcdgndifileifaa	FALSE
folmbecgloidcgpaa	FALSE
gjamjamhfljcgpnoc	FALSE
gjbpaijjibaoeddma	FALSE
hcbbjkklhmcleneaa	FALSE
hcbfpbhceppbpofaa	FALSE
hmajlcegblpiipgaa	FALSE
hmbafgnoplikokdfa	FALSE
ifjglendfeppoffaa	FALSE
ifkekdeofljmmpeaa	FALSE
ipelcggpfoionjoaa	FALSE
ipeohladfdnjmbaja	FALSE
jimkioehjnoickiaa	FALSE
jinanmageaicofnhd	FALSE
keccdaiohgiamcopc	FALSE
kedlfofdnjkfjleaa	FALSE
knoifkildpmnhcjaa	FALSE
knpbopdjhmngebpaa	FALSE
lilpbipmomebdclaa	FALSE
limmclpcphcgfmana	FALSE
mdohglfflonoalaih	FALSE
mdpbpkpdkkdnhfkaa	FALSE
mnoengliokpepdana	FALSE
mnomhieiohjnpefaa	FALSE
nhmeidbmcjdojnjaa	FALSE
nhmhfalocdbmemiaa	FALSE
ochnnedbcnmjhbiaa	FALSE
ochogjhlnopfgidaa	FALSE
omfjdijpffaakklnj	FALSE
omfmledanjfmemfia	FALSE
pfpihcdjjjfpaflal	FALSE
pgahmciomjpjdfcka	FALSE
abafpjpfjjfbjbpoaj	TRUE
abbhlemdaimdnnkphi	TRUE
akkheehjcebhmompll	TRUE
aklfoilhnoeofhidim	TRUE
bdnjffgnbfloenoami	TRUE
bdopphdpancocnpbbc	TRUE
bokloneefdiebnjdeb	TRUE
bokpcfjfmpgkddbjbb	TRUE
ciaboombggcalhgdic	TRUE
ciannpbdlahdknphdo	TRUE
dbochodighdhapdpjm	TRUE
dbodigdhepaecfbfng	TRUE
dljjcplcigdgmplhgh	TRUE
dlkaodlljjnicjnmin	TRUE
egefnejnnidebiodmi	TRUE
egemkpalnpclehlepl	TRUE
faopjbpagpnlhimjbe	TRUE
fapghojkhhkhplbopm	TRUE
fkihkalglcieoepibj	TRUE
fkiochbmpekopanoek	TRUE
gddjbgdplknfabbpfj	TRUE
gdebcnjoglmbpcfmhd	TRUE
gohglhhjpdnnlgebac	TRUE
goicmpbdacoijdmbhj	TRUE
hikabnkhghejdofpbi	TRUE
hikaehcfllejbjnmlh	TRUE
icneacpjenkpongllh	TRUE
icnkcoobokfgnglegg	TRUE
iodnambdbbdbdelleb	TRUE
iodpoahejfdioegbpj	TRUE
jjfkgnekkakbfeebhd	TRUE
jjfpmkaojogjlbngfg	TRUE
kdljhdcnhkhpbhbcle	TRUE
kdmajcgbmnodpoljob	TRUE
kmiiogfdejjaibjoeh	TRUE
kmimpelnpagjefibgf	TRUE
lgjjfajpobnlmdpcpp	TRUE
lgkecbbpceaodljmeg	TRUE
mahfbeggpcenpebhjn	TRUE
mahiipoikndncfjkcn	TRUE
mkolleoaplgglnlpkk	TRUE
mkoobambjnlkekfdho	TRUE
nfoibkaijdekgmbdgc	TRUE
nfonbdecilbchpcfde	TRUE
oabeaddifbgmlbcboh	TRUE
oacdmkhikkhnppkhkn	TRUE
ojficgmncdjobclopf	TRUE
ojfopokdjdonobicao	TRUE
peoflhigfmnjnbhaff	TRUE
peolgkcgonmidnjeig	TRUE
aabjdgcbkmpjoniiia	FALSE
aacdppdendohliibgb	FALSE
akonafkofmejhdnamb	FALSE
aladdhmiimbeadecmj	FALSE
benkonmlcnjpnnbbaa	FALSE
bepdahcnkkkalilepa	FALSE
bpfbjjpfogncenbama	FALSE
bpfgljbjmbmjfppfaa	FALSE
ciobpoalchhpppnaao	FALSE
ciokabodnegolopeaa	FALSE
dckafhmkpnlijllgga	FALSE
dckedbolfmekmlboaa	FALSE
dmkeknoidhbaohncfa	FALSE
dmmcbingaokafbgfmi	FALSE
ehibbogkifoiphppaa	FALSE
ehihfibihmggkkdaka	FALSE
fcccgehefhmflnibaa	FALSE
fccmdocbjkcjkjbcaa	FALSE
fnacjephpepmmkfdca	FALSE
fnamalaofimebmiiem	FALSE
ggjmakiglkddoejlpa	FALSE
gglcmbmdedllcjkpaa	FALSE
haobimpfjdclibgcaa	FALSE
haookgkeidjkockjoa	FALSE
hmajlkapjehbbelbie	FALSE
hmchgmhoklegachjha	FALSE
ieoccjfngdnhlifnaa	FALSE
ieomlhmapfkjblkcaa	FALSE
ipbbhjfcdcjhdiheaa	FALSE
ipbbmljgjhlgdkmdaa	FALSE
jiodpchdgabdbkpaha	FALSE
jipggbblpbalecckfa	FALSE
kchhfjfoafhgnfijna	FALSE
kcijleaiihhnpbpnaa	FALSE
kmipkhafcfnipcelai	FALSE
kmjbbdfhhnomkaccma	FALSE
lhfmmaahofbpioiljn	FALSE
lhfndlgfjaahfcojkd	FALSE
mbkflohjccdgkggaoa	FALSE
mbkgdmonngjblkdoaa	FALSE
mmdhjdmjaflhddmlca	FALSE
mmedgjaondamilobkc	FALSE
ngicahlnggjmjnlgma	FALSE
ngicgmbggfikjjkoaa	FALSE
oaieocdajobgeemmdd	FALSE
oaiiiabkpjaelofcjm	FALSE
okhhajhdmjklamcdhi	FALSE
okhlolaaclogkblmfc	FALSE
pfbjmochlfmjljiiaa	FALSE
pfdgioagihpcficjoa	FALSE
abajmbnklojmppdachn	TRUE
abbdonacpkfpokcogpk	TRUE
albgolojieleohelnjk	TRUE
aldcpplecnmmodfccon	TRUE
beilhajkcbomknicnci	TRUE
beinejfgohelofbekdi	TRUE
bpbdfepmgecbiochgpl	TRUE
bpbmjfimhibfgibmilb	TRUE
cjadhgkfpholobcplfe	TRUE
cjahmffbphnlccbmkpo	TRUE
dcmbeoapmjikephjipg	TRUE
dcmlkjogjnhndjohgbe	TRUE
dmgfdhjooohklogeinl	TRUE
dmglbccfoboemobijin	TRUE
ehhkeilhjnmnlbkkmao	TRUE
ehicecpdkaggkdffmnm	TRUE
fcgpfehlagkihnboeol	TRUE
fchgkhfeaiddclnicnm	TRUE
fmmodgekmofmjgefhnk	TRUE
fmnpjnbijhgccdmblhh	TRUE
ghihbilampbcljhhikc	TRUE
ghijnhkphhcedgpjmkj	TRUE
hbajocegbhpafpjomge	TRUE
hbbaegjmncckmpbfaei	TRUE
hlhjgpafllohpncepmj	TRUE
hljlepcgelohakninkk	TRUE
ifehofbkkmfkiliohjb	TRUE
iffenfgflhdlhcoifbe	TRUE
ipdgjmelafddheknneb	TRUE
ipdlaeokcbgdkbbogfh	TRUE
jijmmjohkmjjbgnphdi	TRUE
jikbgdjbholjpebgnjo	TRUE
kcbbapmflojhmbodfnh	TRUE
kccacfcmfkopeijogbb	TRUE
kmgipbjhaicjhlngdkf	TRUE
kmgnelfehlajemboajb	TRUE
lgikmcnjiaipfhnpnhb	TRUE
lgimggbbegkedkacfdc	TRUE
mbnemgdkkbkcoceihhg	TRUE
mbnlhfgpbedfmdkefdb	TRUE
mmffodpiiehkeddbfpb	TRUE
mmfpfeffpiojbocnija	TRUE
ngefaciknhnmdjdkhbn	TRUE
ngeflhngdohlpcppdli	TRUE
oahbedeokjeeghcocob	TRUE
oakphjfemkelgpinldk	TRUE
okpahnjnimjfkmnnedj	TRUE
okpchhphmklhpimkfil	TRUE
pflodonmmclnmgoladj	TRUE
pfnaigmfmbjonedibdg	TRUE
aaadinaacpebdpbmmnl	FALSE
aaaecgihkgpnnigmbin	FALSE
akjnbklplebacfmopga	FALSE
akknpcalaoollmhbnlo	FALSE
begjanohchhgjgkmlaj	FALSE
behigflhgjdchfkolaa	FALSE
bodjcmlajldcgoplgab	FALSE
bodolejhpdkeinodjaa	FALSE
chmnfhkbjhfdghlkpaa	FALSE
chmobpeomcmdjihnlaa	FALSE
dceongoodidocoifmaa	FALSE
dcfpgbcnibppkoomlaa	FALSE
dmidpdkojgglbgpkoaa	FALSE
dmkkbdibnnhafffainj	FALSE
ehbncfeobmmlknighaa	FALSE
ehcjgpbpjhdkgmfhbaa	FALSE
fbgpkmjalbnpoimaifa	FALSE
fbhdkalefflgnmdogfa	FALSE
fklbakiihmmgpalienc	FALSE
fklicelefmhhcefmcaa	FALSE
gecikbchkcfekhnlfaa	FALSE
gedfkdihkbjpioeigaa	FALSE
gnngnaejekjkpocdpda	FALSE
gnnkmmfbjbacjkcmfda	FALSE
hhmjkcjibcnbgnfabaa	FALSE
hhnliknegojhdicgkaa	FALSE
icgekeeknfmdildhoaa	FALSE
ichaedgkcabljopldmo	FALSE
inbnifaajmokihidgoj	FALSE
incdmmjolodfoihbcaa	FALSE
jhhkmcohoplamnnfbaa	FALSE
jhihbchemgmmepnlnaa	FALSE
kcgiioiakhbanjngbaa	FALSE
kcihoppgiagoimalfag	FALSE
knjgbnkggbnhahkafbd	FALSE
knjlflcobpapehddlka	FALSE
lgnjfhnjncfkmpefcaa	FALSE
lgnjpcmhcpoicfjklaa	FALSE
mbdbpkapibaamleoabb	FALSE
mbdlchnlgigofbdihaa	FALSE
mkimmmhhghfkfnpofaa	FALSE
mkjijobfkghihpmiafa	FALSE
nenakcndkkibicejhaa	FALSE
nfahidfekbmfaljhjga	FALSE
noednooikelmcmpdbaa	FALSE
nofhfmikhmhdnfbciaa	FALSE
ojjegkljabjjmhllcaa	FALSE
ojkijbghnkfdebapmia	FALSE
pebcjpndcecjmjbapca	FALSE
pebhbnkpmbbihomejaa	FALSE
