aaaghpnghh	TRUE
aabjkdgmni	TRUE
akhdfgnjco	TRUE
akibjmpace	TRUE
beladchmgn	TRUE
beljfbogfp	TRUE
bogjbjniei	TRUE
bohokjmjph	TRUE
cieeefhhbm	TRUE
cieidnobnp	TRUE
dccbmmgbgk	TRUE
dccoagicdk	TRUE
dnebicponj	TRUE
dneihicoll	TRUE
eheblldgci	TRUE
ehfjcodlma	TRUE
fbidiphhhk	TRUE
fbjbpcodio	TRUE
fkopbjdbah	TRUE
flaefdnaji	TRUE
genilmcgmf	TRUE
gepeocbfdk	TRUE
gpfadfmfeo	TRUE
gpgkdplail	TRUE
hikacjalmo	TRUE
hikbcinlpk	TRUE
icnbghffel	TRUE
icnnmkbokp	TRUE
inppknmekb	TRUE
ioafmojgnc	TRUE
jjdopldnbo	TRUE
jjdpnaffol	TRUE
keglgfldck	TRUE
kegmejlehf	TRUE
kojjngcdig	TRUE
kojlngminj	TRUE
lilmkooocj	TRUE
limchciejl	TRUE
mcjjgpfldb	TRUE
mckcgncaof	TRUE
mmdhccjdgk	TRUE
mmdobgdonf	TRUE
niageeiabg	TRUE
niaopjkeip	TRUE
ocakefiado	TRUE
ocdckldcdo	TRUE
omjedlofcg	TRUE
omjhhblamp	TRUE
pghfnffkig	TRUE
pghmgaiiok	TRUE
aaaghpbaba	FALSE
aabnghbaba	FALSE
akicnlbaba	FALSE
akiehnbaba	FALSE
beagpdbaba	FALSE
beapihbaba	FALSE
bnoffkbaba	FALSE
bnpiopbaba	FALSE
chpgfgbaba	FALSE
cianolbaba	FALSE
dcilodbaba	FALSE
dckiljbaba	FALSE
dnbbgfbaba	FALSE
dncjfnbaba	FALSE
egihnobaba	FALSE
egjafobaba	FALSE
fbbfdnbaba	FALSE
fbcohebaba	FALSE
flbpkobaba	FALSE
fldljobaba	FALSE
gehklbaoba	FALSE
geiciababa	FALSE
gpebchbaba	FALSE
gpfbdjbaba	FALSE
hilcdnbaba	FALSE
hiljjkbaba	FALSE
icpmepbaba	FALSE
idaaebbaba	FALSE
injifibaba	FALSE
inkbpbbaba	FALSE
jinfjpbaba	FALSE
jinpcebaba	FALSE
keakkibaba	FALSE
keapmbaeba	FALSE
kogihpbaba	FALSE
kogkiibaba	FALSE
ljjjmobaba	FALSE
ljkhkdbaba	FALSE
mclajkbaba	FALSE
mcmmebbaba	FALSE
mmodgjbaba	FALSE
mmpndgbaba	FALSE
ngfelmbaba	FALSE
nggmmjbaba	FALSE
obkglababa	FALSE
obmkehbaba	FALSE
omdnkhbaba	FALSE
omhbjibaba	FALSE
pfmggpbaba	FALSE
pfnalibaba	FALSE
aaabhpgpfok	TRUE
aabepfchgfp	TRUE
akndjklbgkb	TRUE
akogpflgnlh	TRUE
bdkpnkchkla	TRUE
bdlfbpjpdna	TRUE
bnpghoojgao	TRUE
bnphkcdgbam	TRUE
chjiibjokfe	TRUE
chjjilmjkia	TRUE
dagifbkmhel	TRUE
dagommeblgj	TRUE
dlcgojbpmfb	TRUE
dldnefmfclm	TRUE
egbdkdmnnak	TRUE
egdbnamejff	TRUE
fabpjbmdcbd	TRUE
facemongacc	TRUE
fjpcdejmbnj	TRUE
fjpjmkhngob	TRUE
gfchjnndbbn	TRUE
gfcjeknjckc	TRUE
gppgndhicgl	TRUE
haafoepopig	TRUE
hjfpmonfpkh	TRUE
hjgjghlndfi	TRUE
idfhkfgimkn	TRUE
idgkidmflal	TRUE
inhfhepahpi	TRUE
inhjhaepncn	TRUE
jhchjfdgijh	TRUE
jhcjmhdbkbb	TRUE
kbjajacdcpo	TRUE
kbjamlojlld	TRUE
klihmngkjfp	TRUE
klilnngnffp	TRUE
lgjcihglbmc	TRUE
lgjnhaighck	TRUE
mbbapfhmoaf	TRUE
mbdhhdnobho	TRUE
mlmcklfelnb	TRUE
mlmoiedcbme	TRUE
ngeoakcfeag	TRUE
ngfangmfbko	TRUE
oadngfnmeid	TRUE
oadoapolkjd	TRUE
olimamanbch	TRUE
oljahbmhami	TRUE
pfmenoipcgg	TRUE
pfmfpcaombm	TRUE
aaabhpgbaba	FALSE
aabpfokbaba	FALSE
akkgohebaba	FALSE
akklamnbaba	FALSE
bekkhpobaba	FALSE
belnhdfbaba	FALSE
boejiolbaba	FALSE
bofkafpbaba	FALSE
chhdjjdbaba	FALSE
chhpgbfbaba	FALSE
dahcndjbaba	FALSE
dahpglmbaba	FALSE
dlfpggjbaba	FALSE
dlilnbfbaba	FALSE
egelojcbaba	FALSE
egfgiefbaba	FALSE
fabmmembaba	FALSE
facnfddbaba	FALSE
fjpcmkibaba	FALSE
fjpnapdbaba	FALSE
genfbjibaba	FALSE
gepbblpbaba	FALSE
gpppbmibaba	FALSE
haabilcbaba	FALSE
hjlepddbaba	FALSE
hjljipmbaba	FALSE
icnmdkjbaba	FALSE
icpbpcobaba	FALSE
imlfjikbaba	FALSE
imngidhbaba	FALSE
jhhnmhobaba	FALSE
jhjamilbaba	FALSE
kbhodaobaba	FALSE
kbibkfpbaba	FALSE
klgpgjjbaba	FALSE
klhdhckbaba	FALSE
lfibabiokba	FALSE
lfjfdchbaba	FALSE
mbendkmbaba	FALSE
mbfaphababa	FALSE
mmioaobafba	FALSE
mmjdnhbanba	FALSE
nfphdiababa	FALSE
ngamldgbaba	FALSE
oaeidcobaba	FALSE
oafaidnbaba	FALSE
oljhkndbaba	FALSE
olkknjababa	FALSE
pgjmhhebaba	FALSE
pgjmpaababa	FALSE
aaabhpgpfoke	TRUE
aabpfchgfpga	TRUE
aknnhjlndfja	TRUE
aknogcpgplgl	TRUE
beaccgmmnjel	TRUE
beajoehdfehc	TRUE
bnngpdofniea	TRUE
bnnpgnbdhapc	TRUE
chbbccndblkh	TRUE
chbiclhpnlgb	TRUE
dagofhhdjldd	TRUE
dakaidhinkge	TRUE
dlojjmmicpek	TRUE
dlpfkjjlonee	TRUE
efjachicjick	TRUE
efjahenbadge	TRUE
fabmfejkgdgp	TRUE
facfecohedbd	TRUE
fkbjkkfdogcp	TRUE
fkdajfloicko	TRUE
gejcbkjcflpo	TRUE
gejhnfondkck	TRUE
gppnhkikidcb	TRUE
haabaoeimfjh	TRUE
hjfjigpplodp	TRUE
hjhahniopbja	TRUE
idhpbpjgglkk	TRUE
idlgejehphne	TRUE
incollcgmfmi	TRUE
indahkiabbmk	TRUE
jhiifncnajpj	TRUE
jhjaicibngbk	TRUE
kbkjecmdbdpg	TRUE
kblbdmacplki	TRUE
kmfbeokemdck	TRUE
kmgdknfjihbo	TRUE
lfjopmlfgnjj	TRUE
lfkhcljlmemo	TRUE
mbbhcgmnljfa	TRUE
mbdhnjbnljpo	TRUE
mmlncjbdbfhd	TRUE
mmmlbbjdgfcn	TRUE
ngbkjnadfkep	TRUE
ngckapjccdnm	TRUE
oahneppjnocp	TRUE
oaibnpjimlae	TRUE
omchlgeknepb	TRUE
omdbbahognnp	TRUE
pfnhfjkjmpgf	TRUE
pfnjpmhkbkcp	TRUE
aaabpkefbaba	FALSE
aaailnnebaba	FALSE
akioboabaoba	FALSE
akjknccbbaba	FALSE
bficagodbaba	FALSE
bfilpjpebaba	FALSE
bpienhedbaba	FALSE
bpjfbjfibaba	FALSE
ciopkndkbaba	FALSE
cjaioacdbaba	FALSE
ddjdekhkbaba	FALSE
ddjpdfpababa	FALSE
doafhbbpbaba	FALSE
doddoeefbaba	FALSE
eialhgokbaba	FALSE
eiangabnbaba	FALSE
fbnceeoobaba	FALSE
fbpifbapinba	FALSE
fmhapgjgbaba	FALSE
fmhgndbaagba	FALSE
ghgonieibaba	FALSE
ghhfpofebaba	FALSE
hacnjbpbadba	FALSE
hadglbfababa	FALSE
hkpgackibaba	FALSE
hlaoalbnbaba	FALSE
idndpdpfbaba	FALSE
idnkjeoebaba	FALSE
iofnnhhnbaba	FALSE
ioghelmjbaba	FALSE
jiijoelhbaba	FALSE
jiipepenbaba	FALSE
kdkgobmlbaba	FALSE
kdlangkebaba	FALSE
kngjkiecbaba	FALSE
kngnajjjbaba	FALSE
lifedcmbbaba	FALSE
lifooojmbaba	FALSE
mdcinnfgbaba	FALSE
mdckfckcbaba	FALSE
mmdaijopbaba	FALSE
mmecdchpbaba	FALSE
nglonmoibaba	FALSE
ngmfmabkbaba	FALSE
oafbichibaba	FALSE
oafnidnpbaba	FALSE
okocgaidbaba	FALSE
okoegfhbbaba	FALSE
pemndgmababa	FALSE
pendnbkjbaba	FALSE
aaabpkeflnneg	TRUE
aaaidkmkmmgge	TRUE
akhehgmmhiada	TRUE
akhejblndpgpi	TRUE
bemilpoahandg	TRUE
bepcceehdnhcb	TRUE
bpkgjfpaffeke	TRUE
bpkhjedjmcdoh	TRUE
cjkkdbflfggbe	TRUE
cjklccnmloahg	TRUE
ddmgedndopdmj	TRUE
ddmiobiccoeha	TRUE
dnppolplfheeh	TRUE
doblpffpbnmne	TRUE
eifndcphkbhdf	TRUE
eifpbekohdfpm	TRUE
fchggkcpfhhff	TRUE
fcjfcedojbkpa	TRUE
fmccbahkkcgej	TRUE
fmcijnhikcobe	TRUE
ggafjdfmbjhpa	TRUE
ggbegikhamfbo	TRUE
hadejonikgoin	TRUE
hadlalfkeeigl	TRUE
hkjagdcodakgb	TRUE
hkjhedbbcamnb	TRUE
iefpekdlpnamf	TRUE
iefpggkdincie	TRUE
ioonmkieinhdi	TRUE
iophmcakckaja	TRUE
jjkllbkcoackl	TRUE
jjldabbponang	TRUE
kdgcbjdgmoogk	TRUE
kdgdkplmopkde	TRUE
knggekcnhdoeb	TRUE
knifjpchheoap	TRUE
lhmaopnainill	TRUE
lhmdepafimlnp	TRUE
mdbebhdgigljb	TRUE
mddaehgigieco	TRUE
mnabkhojidcbg	TRUE
mnailljdfckij	TRUE
ngcljghbnbaph	TRUE
ngdpmlgknppoh	TRUE
oamejpibkkoke	TRUE
oaonmcgpjaelg	TRUE
okjmmocngkgfj	TRUE
okjohjffmpmha	TRUE
pfjackhgnadbi	TRUE
pfkjobligblbd	TRUE
aaadfcemibaba	FALSE
aaafcecfmbaba	FALSE
ajfhglmdhbaba	FALSE
ajfmnmmbobaba	FALSE
bdegfgeanbaba	FALSE
bdgcbjegmbaba	FALSE
boehemhdmbaba	FALSE
bogojhaeibaba	FALSE
ciflkcficbaba	FALSE
ciggimhjjbaba	FALSE
ddbpgmhljbaba	FALSE
dddmdnpplbaba	FALSE
dmfpgomckbaba	FALSE
dmhlfcdkobaba	FALSE
efpgkcodlbaba	FALSE
egalnljcababa	FALSE
fbekaonkdbaba	FALSE
fbenbgjjpbaba	FALSE
fldchfnikbaba	FALSE
fldjiichfbaba	FALSE
gfaddikjlbaba	FALSE
gfbmejiigbaba	FALSE
hagfngdcnbaba	FALSE
hagjodicfbaba	FALSE
hkejnliplbaba	FALSE
hkejooabmbaba	FALSE
iedkbnbdbbaba	FALSE
iegeknfbnbaba	FALSE
iomkninmlbaba	FALSE
iommklbhjbaba	FALSE
jjighcemibaba	FALSE
jjjpfiendbaba	FALSE
kdoabmcagbaba	FALSE
kdokidacgbaba	FALSE
koioimogcbaba	FALSE
koippiopjbaba	FALSE
limkahmeababa	FALSE
linbipmfjbaba	FALSE
mcnifmgnnbaba	FALSE
mcnondcjpbaba	FALSE
mmjhakkjmbaba	FALSE
mmmcpeafobaba	FALSE
ngigoaicjbaba	FALSE
ngkakpifbbaba	FALSE
obfeeimgcbaba	FALSE
obfgoiobebaba	FALSE
oljofkeoebaba	FALSE
ollagnhnmbaba	FALSE
pfklifmpjbaba	FALSE
pflbfchnmbaba	FALSE
aaadfcemicecfm	TRUE
aaaflogpcoanjo	TRUE
ajinlcfelbhbff	TRUE
ajiolokilhjhkj	TRUE
bdfpkkdoijnkmk	TRUE
bdhdogdkgigklc	TRUE
bonmelagmhlagh	TRUE
boopodmopggphh	TRUE
cinooghhhfadga	TRUE
cinpdpibcjejma	TRUE
dcpmpncodealep	TRUE
ddbdnhnjcikppk	TRUE
dlilhnbekilopg	TRUE
dljclafgibafbp	TRUE
egedmgfmchnkhj	TRUE
egejcedafjapdl	TRUE
falikgkcffefnc	TRUE
famnlcoepdgmoe	TRUE
fkjfegohokhijp	TRUE
fkjgakbhjnione	TRUE
gfmkpjjpfgnbdl	TRUE
gfmkpljfgmiofl	TRUE
haijefcljjboef	TRUE
haikneckiahfej	TRUE
hjmjjkhonhaopp	TRUE
hkaloajldgcndk	TRUE
idppnchiecmkig	TRUE
iebfbcmfiomobj	TRUE
iogngbmgkkplkd	TRUE
ioipdpgikagilf	TRUE
jjhfihocjpfbfk	TRUE
jjidhhdhnjbkll	TRUE
kdoaohaodfcjcp	TRUE
kdpildjcmlkbop	TRUE
kooppcmbdijnae	TRUE
kpbklcmojojhdc	TRUE
lindinkkjhmpfo	TRUE
linmgiadchhkpe	TRUE
mdgnmfooiglhak	TRUE
mdhfjlkloiooeb	TRUE
mmlileojafmmgg	TRUE
mmliobneihjmoo	TRUE
ngcjgphjfgeopk	TRUE
ngeikdilcocopi	TRUE
obgailphcoffmi	TRUE
obglialiagfelp	TRUE
olplnodmneejlf	TRUE
olppebjgnicock	TRUE
pfgkaeefhmgfoj	TRUE
pfhiaimdbapjnn	TRUE
aaahfnbligbaba	FALSE
aabaeepgpfpaba	FALSE
akokbomnmpbaba	FALSE
akondgegdkbaba	FALSE
beljajbklhbaba	FALSE
belkmijifnbaba	FALSE
bphimbaokjfoba	FALSE
bpijacoggnbaba	FALSE
cjojbjmbiababa	FALSE
cjphmoccidbaba	FALSE
dffilhpbohbaba	FALSE
dfgkabngbmbaba	FALSE
eaciakdnaebaba	FALSE
eacmjegnohbaba	FALSE
ekijckmmncbaba	FALSE
ekilifjcmjbaba	FALSE
fdlmnidmcababa	FALSE
fdmlcpdlkdbaba	FALSE
fnpokokpdmbaba	FALSE
foajglkimgbaba	FALSE
gjoenfdjbaahba	FALSE
gjpnlhpcafbaba	FALSE
henlkdfmggbaba	FALSE
henpndleglbaba	FALSE
hopfjkejnibaba	FALSE
hopgkjheppbaba	FALSE
ijaafndggebaba	FALSE
ijajdamcedbaba	FALSE
jdkjpiddpfbaba	FALSE
jdlppocpefbaba	FALSE
joeidndgaobaba	FALSE
jofgikojilbaba	FALSE
khlafcjcnobaba	FALSE
khnlaoailbbaba	FALSE
lblhhjhjnababa	FALSE
lbmnifokplbaba	FALSE
llgbkdkobgbaba	FALSE
llgemnbnopbaba	FALSE
mfiplgkkjibaba	FALSE
mfkbahcbekkbba	FALSE
mobecphbicbaba	FALSE
mobhfgbhbhbaba	FALSE
niahcdfgbdbaba	FALSE
niakjgmdeababa	FALSE
obipanfcbkbaba	FALSE
objgplokojbaba	FALSE
olejndfikgbaba	FALSE
olflpfonadbaba	FALSE
pfjbnpkakobaba	FALSE
pfjjleemhababa	FALSE
aaahfnbligoajee	TRUE
aabgfpaeaneflla	TRUE
akncobifnffmhae	TRUE
akndofaakfhfhfg	TRUE
bemankhcpakfcca	TRUE
bennahmpdhkecfc	TRUE
bpkaiodcbglcikp	TRUE
bpmkojaefpcdgnp	TRUE
ckhepamecbgcgej	TRUE
ckigaojepcginjl	TRUE
dffbfnkljadcpdb	TRUE
dffelkchkjjjphj	TRUE
eacanebblchmeol	TRUE
eaclkdemfjjkbcf	TRUE
ekegomnhknedmgi	TRUE
ekfagojabblpfad	TRUE
fdijhlndffogiko	TRUE
fdinjcadojkapdk	TRUE
fohimggjijljpia	TRUE
fohlokefidblbfp	TRUE
gkbjpdmbiibkbaa	TRUE
gkcaicjcbbfaopc	TRUE
hejpgbppnjahnkg	TRUE
hemiebopjpgmole	TRUE
hpalpaknblokehl	TRUE
hpcgmgebihhkidi	TRUE
ijhcddjfbdokffd	TRUE
ijhgflihdcnmmjd	TRUE
jdiehnleoaiehbg	TRUE
jdijdleknpjkime	TRUE
jobcecokehcnhkm	TRUE
jocafpmohpjfmdj	TRUE
khicjcappkfgmjf	TRUE
khjgklomboippbm	TRUE
lckijnipiilbigk	TRUE
lckppkonobljkao	TRUE
llljlgmofnmobmp	TRUE
lllljfipaficglm	TRUE
mfdfnfigheimbje	TRUE
mfdjkmikblplikk	TRUE
mokbcciihanhloj	TRUE
mokfnjdnepcnjhf	TRUE
nhbaogpedhdgfkn	TRUE
nhdkacbflplmbea	TRUE
obmjmkljnlgeahn	TRUE
obmlpjeelflfdjb	TRUE
olcmmmkbnolafol	TRUE
oldlgceidmgeohg	TRUE
pfihcmpdbcgaand	TRUE
pfilnlbjedpogka	TRUE
aaagbjakdbjbaba	FALSE
aabakngdcdclpba	FALSE
akfbbalinhkpgba	FALSE
akgingfelklbaba	FALSE
begjejpeknkbaba	FALSE
bejikgmjhphbaba	FALSE
bokleplhomgbaba	FALSE
bokojhohbbobaba	FALSE
cjckfnklkcbajba	FALSE
cjdihggleipbaba	FALSE
ddgffhaophlbaba	FALSE
ddjaeaoapihbaba	FALSE
dmhldfiamccbaba	FALSE
dmibkghcpeebaba	FALSE
eghflfdgdenbaba	FALSE
eghkkibmkhjbaba	FALSE
fbdkanlehcjbaba	FALSE
fbedbibkjmnbaba	FALSE
fkcpknbnoajbaba	FALSE
fkdnffdheeebaba	FALSE
gfllbijloplbaba	FALSE
gflmaielifkbaba	FALSE
habhecenhchbaba	FALSE
hacegifnoojbaba	FALSE
hjefdalmgaibaba	FALSE
hjeieneikahbaba	FALSE
ienmegcefcibaba	FALSE
ifaelaoiaigbaba	FALSE
jacmfeibmgababa	FALSE
jacmhkfglikbaba	FALSE
jlelhegmgdpbaba	FALSE
jlfijdlmplobaba	FALSE
kfhhllmpnbbaeba	FALSE
kfhlpjihfpfbaba	FALSE
koijmmfmbifbaba	FALSE
kokghnfkamfbaba	FALSE
ljklpgpggehbaba	FALSE
ljmmgaifgojbaba	FALSE
mecahedgpfjbaba	FALSE
meckbnebpnebaba	FALSE
mogcdkabinlbaba	FALSE
mogepbmkedbabad	FALSE
nikkojajhcdbaba	FALSE
nikmgmohfdkbaba	FALSE
ocbclbhajldbaba	FALSE
ocbdloehjjgbaba	FALSE
olfikdgggegbaba	FALSE
olgcdegfghnbaba	FALSE
pgeafdlbjdobaba	FALSE
pgecagcmedmbaba	FALSE
aaafffcncnndjlbe	TRUE
aaamonbojpadhffm	TRUE
ajdheibaflabkaha	TRUE
ajdkggkcgcmfbodk	TRUE
bbmaceondacdfbbp	TRUE
bbmmidbfekpdpkjl	TRUE
bmcnfddknokdcgcj	TRUE
bmembfdalhlehkgl	TRUE
cfpnjpnedilblfja	TRUE
cgaglhkcipehijil	TRUE
cpookendjghhommn	TRUE
daaddmoohlnmmbpc	TRUE
dkkmeohafiincnnl	TRUE
dkkolegocipkjgff	TRUE
efpilidliboephab	TRUE
egaagaacdjghfkhi	TRUE
fabcdcecojmeddle	TRUE
fabffbhgkoldfiom	TRUE
fkgemipehlhfpafd	TRUE
fkgihbmcjbiagian	TRUE
gdjiocnbhlcbeabl	TRUE
gdkgacbponpglifb	TRUE
googjangbbbadapf	TRUE
goomcfngmapgcmok	TRUE
hjfihgmfljaemkcc	TRUE
hjgaibomgjpapblk	TRUE
iehlgllcaidkdiip	TRUE
ieihgaidhcekiobo	TRUE
iofoplibnhkfdlhg	TRUE
iogammebpfafejmm	TRUE
jidddeojhkajbggk	TRUE
jieccdafdggonjcf	TRUE
kapobekeficdjhma	TRUE
kbblipibpnbinkcl	TRUE
klfhnnclciaophfo	TRUE
kljiggpmpjjngfcp	TRUE
lfnginkgjgemdofk	TRUE
lfnlneanpedapnnb	TRUE
magkaldleaelnlbg	TRUE
maglioobhhohehhl	TRUE
mlkenblgboeecgmd	TRUE
mlkkfigmjdlppdpa	TRUE
nepjhmlcabnabikc	TRUE
nepkgeimgcaajhic	TRUE
npmpoegpennkglbe	TRUE
nppclegfecbomomc	TRUE
okgdilfmmjanacip	TRUE
okgneemenobbbcfl	TRUE
pegddmcnnpdaiboj	TRUE
pegejjfhdlknagme	TRUE
aaafffcncnndbaba	FALSE
aaamjlbeonbobaba	FALSE
ajcojnhbebhgbaba	FALSE
ajdopdndcdokbaba	FALSE
bbilehngljgpbaba	FALSE
bbjjkkkkmomlbaba	FALSE
bmdhefdmlcgfbaba	FALSE
bmdmffmlelnebaba	FALSE
cggddfdgfmfmbaba	FALSE
cgglgnmbdpcgbaba	FALSE
cppjjkhgelipbaba	FALSE
daafkfbgjliobaba	FALSE
dlgdbpbkpiohbaba	FALSE
dlhajojgffjbbaba	FALSE
efmlpdnplggjbaba	FALSE
efpojicpdnjhbaba	FALSE
facfpmnfbffgbaba	FALSE
fadhkngljkdfbaba	FALSE
fkneggmngapebaba	FALSE
fkpkhpadldlcbaba	FALSE
geoojeaihdambaba	FALSE
gfahhfdpkmacbaba	FALSE
golhjfebjoibbaba	FALSE
goloohogcaoababa	FALSE
hjiiakebgjdcbaba	FALSE
hjjhoggmjigbamba	FALSE
iefdlddedgljbaba	FALSE
iefiinnjffdpbaba	FALSE
ioenclknkcmpbaba	FALSE
iofaalndaelnbaba	FALSE
jhmadimoipbobaba	FALSE
jhoioloegjlobaba	FALSE
kbcjnalbhggfbaba	FALSE
kbcledcgcgdgbaba	FALSE
klkbimffpbhgbaba	FALSE
klkplafdndkebaba	FALSE
lflpmglgcckmbaba	FALSE
lfmdpmffapfmbaba	FALSE
maeoajibafeipban	FALSE
mafkahgploalbaba	FALSE
mldokjakdnpjbaba	FALSE
mlgkcohbigibbaba	FALSE
nggcjbclpjeibaba	FALSE
ngidhagkldnjbaba	FALSE
nplglcdgpkglbaba	FALSE
npmkoijgkaigbaba	FALSE
okmpaokjnaodbaba	FALSE
okmpmoocmknjbaba	FALSE
pffhoelbmlflbaba	FALSE
pffhoobhpniobaba	FALSE
aaaabjljdmjcohpaf	TRUE
aabjahcopijihlkic	TRUE
ajjohmofempfhnefg	TRUE
ajkcjlpjjjjdibnmp	TRUE
bdplmmggfobcdfdjm	TRUE
bdpnndibfhcllmldi	TRUE
bookimkhnlgoikagi	TRUE
boombpdacjohicafn	TRUE
ciphcbamiaigdjkon	TRUE
cipmmjhcocgfpfjbk	TRUE
dcdojbfcioopmeipm	TRUE
dcfellniabnjpedng	TRUE
dlmpdahhpelooilhn	TRUE
dlnldolamhieeankf	TRUE
ehehmilppiocjcbml	TRUE
ehfdbiebjhpglhape	TRUE
fbjchebeoomhbhbfh	TRUE
fbjhbbknappggnmhm	TRUE
fmfhdamgjglbbkkpc	TRUE
fmghdonahlmfehpbc	TRUE
ggojpbmjiaoagbblb	TRUE
ggopdgcmniejkhmkc	TRUE
halmhnokceegljbkl	TRUE
hamegcolfccfoddmb	TRUE
hlhnincghebmpkahb	TRUE
hliokfocnlahjecmo	TRUE
ieloaaabnmmfciaka	TRUE
iemobfpemfgmimmci	TRUE
ipbnonpocnpnjeekp	TRUE
ipebknhjliimpgnoi	TRUE
jiooeljeoiibbkdah	TRUE
jipggkdnaclkoibon	TRUE
kffjjecbcachagnel	TRUE
kffnhjdidjdankndd	TRUE
laamhjbodnbgiiagp	TRUE
labalbheegiolflkg	TRUE
lkjjpkidinlolaldi	TRUE
lkjmdnklgpmomfdnl	TRUE
melippinngdbcjpja	TRUE
meloccgnpblpffino	TRUE
moafdnmollmhnfdme	TRUE
mocbmlgoaimiolinn	TRUE
nhncdoapahfknpign	TRUE
niabmhoilpkaflagi	TRUE
obbgibekbnmcgdfjo	TRUE
obbgokbfdlmefpgfp	TRUE
ojjpdnfbaeopoikha	TRUE
ojkkfkbhajailgnam	TRUE
pelcgfnmopdfkloic	TRUE
pelhilhcemccbikgd	TRUE
aabbkbhihggecbaba	FALSE
aabpoieohejgfbaba	FALSE
ajjofnphleepkbaba	FALSE
ajkgmdnkpnpmmbaba	FALSE
beaebgiannflcbaba	FALSE
beaglnabnnclgbaba	FALSE
bngjjhccmpaeibaba	FALSE
bnhahnghgjolababa	FALSE
chmfnpjpgdciebaba	FALSE
chmopjbhgchiibaba	FALSE
dbgaldhlkoipcbaba	FALSE
dbhgoegoefdihbaba	FALSE
dklpkefedcnccbaba	FALSE
dkmfbilpabjdebaba	FALSE
eeloaeohnkojibaba	FALSE
eemkiamfcgjejbaba	FALSE
eoplhkdjoiolbbaba	FALSE
epbgflfkgkkifbaba	FALSE
fjeahjbnfajhebaba	FALSE
fjenmhibimfmmbaba	FALSE
gclcdakfppmobbaba	FALSE
gclhkckjidlokbaba	FALSE
gnggmjmjgbkbjbaba	FALSE
gngpfkngigaijbaba	FALSE
hidoenfbjccjkbaba	FALSE
hihkgpbidlhobbaba	FALSE
idjnealnmfpmbbaba	FALSE
idllmjgandepbapba	FALSE
imnlckpnpcmfobaba	FALSE
imokpogmooaaababa	FALSE
jggifmhbjiglababa	FALSE
jghgjclfppakkbaba	FALSE
kanaajpbphjhcbaba	FALSE
kanapckjnediababa	FALSE
klfkkonnppgopbaba	FALSE
klglfemjonmddbaba	FALSE
lfhpdffnnnnjibaba	FALSE
lfidhhjnefjbfbaba	FALSE
mbbchbmoajkkpbaba	FALSE
mbccbbjlblenpbaba	FALSE
mlnjemoimcbblbaba	FALSE
mlnolmoldnmagbaba	FALSE
nfldkmakokbgcbaba	FALSE
nflolemeglmbfbaba	FALSE
oalbnlffebhnpbaba	FALSE
oalipbkdkjdeababa	FALSE
ojgmkmcjkpchmbaba	FALSE
ojgmohbcnbefpbaba	FALSE
pecgphecgieecbaba	FALSE
pedkdnkmgmpeibaba	FALSE
aabbkbhihggecoieoh	TRUE
aabpejgfimeoblkmkl	TRUE
ajoccnefgpdmhkbocp	TRUE
ajogacfedkglbbjogj	TRUE
behmbiebcclhmimcli	TRUE
bekhfdepnjilofdlon	TRUE
bncmocbgoiafcmjbhb	TRUE
bncphgiaofegiocnog	TRUE
cgfhahbnebnhnlakik	TRUE
cgibobpjphlioiccib	TRUE
dbanmehgkhoeaeohnk	TRUE
dbbojikiamfcgjejoo	TRUE
dkmkajchegjgnbdoak	TRUE
dknalebeghehaoklgg	TRUE
eemmfledcigamflcbc	TRUE
eeopmgobfpcnnahjac	TRUE
eomlegelcgnmhkjcom	TRUE
eoobofbkjalhaojcja	TRUE
figakoglcmmpooignp	TRUE
fihokbdmgdeigipnoh	TRUE
gdafodbbegibcichdi	TRUE
gdagifiblmeopjclkg	TRUE
gobmdpkekgbnfhhchj	TRUE
gobnkigalgailigmic	TRUE
hinechnldjbmamkcpg	TRUE
hiojckccpiokeceejk	TRUE
icokbgnkgdolidgfeb	TRUE
icpipcjgidhilhaclh	TRUE
imlnliobhnfecfnnmn	TRUE
immbedeelfkbefnhdb	TRUE
jghkonggkbbdijmkgc	TRUE
jgjpabfgflolcnjgkl	TRUE
kbebdgjdcdcdlbdgjp	TRUE
kbghhllplcnkmmocdj	TRUE
kkmnaeodmbbneeedgi	TRUE
kkodegggfiejjlfmgg	TRUE
lfinbhilipikmnnjfl	TRUE
lfjbaipncnpcegenhe	TRUE
mbanneonaggmedpgcj	TRUE
mbeiajbpagjbafjkmd	TRUE
mlgdiemgogmnjpiaab	TRUE
mlgmgkefddapbbjdap	TRUE
nfdkajmodbmhcfdnol	TRUE
nfkemnolgljhmhdlmm	TRUE
oakbeoeepnebcmnong	TRUE
oamknkieafnilpigfn	TRUE
ojfegaedlfekoebhgg	TRUE
ojhcgdpmipahljcpfj	TRUE
pecdbhjjimjeighglb	TRUE
pecogpcdelikaehopp	TRUE
aaahfheafiokefbaba	FALSE
aacjghfnookijobaba	FALSE
alacolfpkboffbagba	FALSE
albkhoajjmkebpbaba	FALSE
bfnmgconcidahebaba	FALSE
bfodadjiepcliababa	FALSE
calndjgllljjekbaba	FALSE
cambnmmmflnaphbaba	FALSE
ckmiedokdkdcfbapba	FALSE
ckmkekjianbmpfbaba	FALSE
deondlaacghcghbaba	FALSE
deoonkkdoldghnbaba	FALSE
dpfmohpdlepdkcbaba	FALSE
dphfpjbhagdmmibaba	FALSE
ejcjnhchpomhnababa	FALSE
ejcljekcdpgbhkbaba	FALSE
fdjhfidloillfnbaba	FALSE
fdjjniidjeaedjbaba	FALSE
foaamafconmojpbaba	FALSE
foakljbmgipfmcbaba	FALSE
gifbfhnbdelmibadba	FALSE
gifggnnhknlpbnbaba	FALSE
hckghoohkegofdbaba	FALSE
hcklcgmllodbfdbaba	FALSE
hmikcfcjcpfjfnbaba	FALSE
hmimbbaodbambifhhi	FALSE
igippijflggcbjbaba	FALSE
igjhiilbhkpbkpbaba	FALSE
jaiemlgihonickbaba	FALSE
jaiibjhhidgmffbaba	FALSE
jkpklngcejkkdkbaba	FALSE
jlacaeiapjpppnbaba	FALSE
kfgijdlkfbagfkkgba	FALSE
kfgkifgljfkccjbaba	FALSE
kpcmclnooeldgjbaba	FALSE
kpgaepcemipfckbaba	FALSE
ljlenpamgjlbcfbaba	FALSE
ljlhpdibpgfigbabam	FALSE
mdoippkoohcgpdbaba	FALSE
mdpnplnohipjacbaba	FALSE
mnnaaimpnejobobaba	FALSE
mnngpkchlapdjfbaba	FALSE
nhjejpkmkplnbaapba	FALSE
nhkapkcefkgpodbaba	FALSE
obpfhpjfilhjkgbaba	FALSE
obpgeahofdndcmbaba	FALSE
ollokdpgbpfcmjbaba	FALSE
olnkknohpmbnpbaaba	FALSE
pggmoccokakfmnbaba	FALSE
pggnbepdolpnmpbaba	FALSE
aaaomhlahjpikiooofp	TRUE
aabiaiknmcejoekkdbe	TRUE
akoaagnllmjpfbcopab	TRUE
akpekegppejgnahageb	TRUE
bfgdpbjfnipcnehcpik	TRUE
bfghcaoepblhpjebjpb	TRUE
calllmnhpolhndpdhpn	TRUE
camcmcdmnhmnilebhjh	TRUE
clfknppboloibbnbcal	TRUE
clfmofjdcmhaellbjjc	TRUE
denjndicbmfacdjdfia	TRUE
deokdaeioiigpiembef	TRUE
dojmlgnmknagfnekkpl	TRUE
dokaleidipieaakmeab	TRUE
eikiefmbbhikbocmikf	TRUE
eilhnjdmngihdpclaga	TRUE
fcchghpmaenkkipobhl	TRUE
fcdbngiiiobgcjkfehj	TRUE
floefkbikgdiaiomkbm	TRUE
flpmpncigpihglcgfca	TRUE
gfpbcgolapfaemldnao	TRUE
ggbbejofjjgjjfcbhdg	TRUE
haicackokemaeiefcob	TRUE
hakmpokbkjbagindmcn	TRUE
hknjpjaddnlfiflepha	TRUE
hkonecbgcgpdahfnaoa	TRUE
igbbimghnmdhgpppejl	TRUE
igccndkephbcejeghko	TRUE
jaoegfffmopkidieico	TRUE
jaojadmilehoimdehci	TRUE
jmhjilbegmgmkomjmgc	TRUE
jmhnhdmpombebpfmldo	TRUE
kfplkklkfadpmedkjnd	TRUE
kfpnnnklifnndigaedk	TRUE
kplgknhmdldioghoeim	TRUE
kpmaejflbblooofgchp	TRUE
ljjdnbgbjjomanchpec	TRUE
ljkdpadnlffcmfdnmib	TRUE
mdceaobdipeapljekpi	TRUE
mdchoboikmnppignlef	TRUE
mmgcpgfihlmlcmgdimm	TRUE
mmgegdkgpncfiojnfkh	TRUE
nfkjndmnmhkfjimkidl	TRUE
nfmbbdnpahhjbmmehcm	TRUE
npoiommdekkdpmeddof	TRUE
npokacabiikhcpgloim	TRUE
oldmnpdhgahebimmamf	TRUE
olfbfelgkmeilemocei	TRUE
pfnjidbnhfnibefmnip	TRUE
pfobalfelohmpknoemd	TRUE
aaahdmahehaeinbbaba	FALSE
aabfobcnicdbbjjbaba	FALSE
aliegldgbfbknfababa	FALSE
aligakkpjfhikacbaba	FALSE
bfagkkalnfbemmdbaba	FALSE
bfbcaeioginmamjbaba	FALSE
bnmjnolbmjlancebaba	FALSE
bnmlendakgjkdlebaba	FALSE
ciillekhhiednecbaba	FALSE
cijhilfoockpcfobaba	FALSE
dblcoaijiboigiababa	FALSE
dblconlobnkihdpbaba	FALSE
dlfpcnnffpblojlbaba	FALSE
dlgibpddhlkblmcbaba	FALSE
egacojiidjdhndibaba	FALSE
eganlhlkmkmeggababa	FALSE
epndhofmogdblogbaba	FALSE
epngkbpjofickmibaba	FALSE
fkfigaomdoihfdnbaba	FALSE
fkfmoeboggbdlnibaba	FALSE
gehmleipcimeongbaba	FALSE
geicfggchjchkeibaba	FALSE
gpnnpkgppffcfgibaba	FALSE
gpolbmebifkhdhlbaba	FALSE
hknghlbnblpmmlbbaba	FALSE
hknjlcpcnmfbccdbaba	FALSE
ifcjnccllafccdababa	FALSE
ifdhkpcjleicbcebaba	FALSE
iopjcliddfpincgbaba	FALSE
ipaebbfdfefpfahbaba	FALSE
jkdfmcjffibjjobahba	FALSE
jkfjcojfncpgmddbaba	FALSE
kfdfgmbfbhapfgpbaba	FALSE
kfdibjibejijnhlbaba	FALSE
kplodgejjblgjadbaba	FALSE
kpmkcidmllkeppbbaba	FALSE
lioconjmedjciidbaba	FALSE
lioeoakpklaimdkbaba	FALSE
mccljingndccjjdbaba	FALSE
mceonmlfoggmhipbaba	FALSE
mmllhcfhmifnacjbaba	FALSE
mmnolonghjmhlekbaba	FALSE
ngpphcnceiaohmlbaba	FALSE
nhadlhnoipkciodbaba	FALSE
occeipmocggjnchbaba	FALSE
occgpodeoadbeojbaba	FALSE
olmfgfodpjalaipbaba	FALSE
olmnbkiepbnjbggbaba	FALSE
pgahclakaaahljhbaba	FALSE
pgbaoajifddljkjlnba	FALSE
