aaacdjgnaa	TRUE
aabbcjibaa	TRUE
akcibfaaaa	TRUE
akcpooaaaa	TRUE
beenbcaaaa	TRUE
befdngaaaa	TRUE
boggcaadaa	TRUE
boigeoaaaa	TRUE
cieeamaaaa	TRUE
cifpphaaaa	TRUE
dblopcaaaa	TRUE
dbmobhaaaa	TRUE
dlkjemaaaa	TRUE
dlknjdaaaa	TRUE
egabhhaaaa	TRUE
egbjpbaaaa	TRUE
ephcjaadaa	TRUE
ephehlaaaa	TRUE
fkfiobaaaa	TRUE
fkfonpaaaa	TRUE
geooloaaaa	TRUE
geppphaaaa	TRUE
gpjdnoaaaa	TRUE
gpjjkkaaaa	TRUE
hjhncgaaaa	TRUE
hjhpimaaaa	TRUE
iedhmoaaaa	TRUE
iegamiaaaa	TRUE
ipdeacaaaa	TRUE
ipdgjhaaaa	TRUE
jjgfajaaaa	TRUE
jjghmnaaaa	TRUE
kdggpiaaaa	TRUE
kdhkkiaaaa	TRUE
knooldaaaa	TRUE
knpflnaaaa	TRUE
lidplbaaaa	TRUE
lieoigaaaa	TRUE
mdfocmaaaa	TRUE
mdfoehaaaa	TRUE
mopejaafaa	TRUE
mopgmdaaaa	TRUE
nhklkhaaaa	TRUE
nhlibeaaaa	TRUE
ochdijaaaa	TRUE
ocimmcaaaa	TRUE
onaiojaaaa	TRUE
onbajaadaa	TRUE
pfpnooaaaa	TRUE
pgalfpaaaa	TRUE
aaafgiepmp	FALSE
aaajpbkkik	FALSE
akdopfapgg	FALSE
akenaijioj	FALSE
becgcipnjn	FALSE
bedhickhnc	FALSE
boaefcbpcl	FALSE
boaehanedf	FALSE
ciadeneoel	FALSE
ciaimaofff	FALSE
dbobonakid	FALSE
dboegbclpc	FALSE
dmbebkjhfe	FALSE
dmbnpgfhkg	FALSE
egkdigeopg	FALSE
egmmckeonn	FALSE
fbaibdahel	FALSE
fbbeihnehb	FALSE
flbdjipilh	FALSE
flbfoebkfl	FALSE
gfoibgamdp	FALSE
gfokmfgafe	FALSE
gpljmgjmoh	FALSE
gpmiihddjl	FALSE
hkeiimcbbi	FALSE
hkekeddeli	FALSE
ieggkjbhan	FALSE
iehigcijle	FALSE
iolmdcbmmg	FALSE
iolmdmkood	FALSE
jipkkdimjl	FALSE
jjacikipfn	FALSE
kcpihfjklk	FALSE
kcpnhnnpbf	FALSE
kofabnhhdp	FALSE
koffliegbf	FALSE
lhmeblmfoe	FALSE
lhmgliegpg	FALSE
mbahnoohkp	FALSE
mbbeknpmgd	FALSE
mkbfnbehik	FALSE
mkcbjabokm	FALSE
neldjkfeke	FALSE
nelincjpef	FALSE
obgdcjiplp	FALSE
obgfobadfj	FALSE
olmjdljobl	FALSE
olmlpohfkm	FALSE
pfenceppdf	FALSE
pfeoiegkcb	FALSE
aaafgiepmaa	TRUE
aaajppbkkaa	TRUE
akebooeaaaa	TRUE
akgjjobaaaa	TRUE
beipbmaanaa	TRUE
bejhhcdaaaa	TRUE
boafgkdaaaa	TRUE
boagihcaaaa	TRUE
cibhiieaaaa	TRUE
cibnnbmaaaa	TRUE
dcmadidaaaa	TRUE
dcmlafeaaaa	TRUE
dmikipkaaaa	TRUE
dmjpncpaaaa	TRUE
egiadckaaaa	TRUE
egiahahaaaa	TRUE
fajfanoaaaa	TRUE
fajnfmaadaa	TRUE
floonafaaaa	TRUE
flpjelbaaaa	TRUE
gfmfbkeaaaa	TRUE
gfohhhcaaaa	TRUE
gpkahhbaaaa	TRUE
gpkamacaaaa	TRUE
hkenlhbaaaa	TRUE
hkfhbliaaaa	TRUE
ieigfkoaaaa	TRUE
ieldclaahaa	TRUE
iokealcaaaa	TRUE
iokjdfgaaaa	TRUE
jihooegaaaa	TRUE
jiidmphaaaa	TRUE
kdengjmaaaa	TRUE
kdfohjiaaaa	TRUE
knoghckaaaa	TRUE
knpbdeoaaaa	TRUE
lhpedgmaaaa	TRUE
lhpickmaaaa	TRUE
malmkieaaaa	TRUE
maoadphaaaa	TRUE
mlegjkjaaaa	TRUE
mlemngoaaaa	TRUE
nfikfkgaaaa	TRUE
nfipilkaaaa	TRUE
obbpaggaaaa	TRUE
obemjjnaaaa	TRUE
olbmnlpaaaa	TRUE
olccdaahhaa	TRUE
pgdgbhcaaaa	TRUE
pgdnedlaaaa	TRUE
aaafgiepmpp	FALSE
aaajbkkikbb	FALSE
akclambhnii	FALSE
akcpfgjgngj	FALSE
beelcdobabd	FALSE
befphjiklaj	FALSE
bodpcacncbc	FALSE
boegnhalbhb	FALSE
cgnipbbcdcg	FALSE
cgnkiphadmm	FALSE
dciefjdloak	FALSE
dcjgemonmbd	FALSE
dmlbabdgoab	FALSE
dmlkolbigai	FALSE
egmlonjfdmm	FALSE
egnblknipce	FALSE
faonidafnod	FALSE
faooodfjipi	FALSE
flmkkljodgp	FALSE
floeamkcgdd	FALSE
gfnoaimbiji	FALSE
gfodkdmhkjj	FALSE
gpkgjefcdke	FALSE
gpkpgafidin	FALSE
hjdibggpfme	FALSE
hjhdhldgjaa	FALSE
iegpmogbjbi	FALSE
iehhggfejhk	FALSE
ioicaiidhcm	FALSE
iokhodbokkj	FALSE
jjeemkndgho	FALSE
jjefackahhi	FALSE
kddolplkhka	FALSE
kdfbgclpiaj	FALSE
knpaaoinfpc	FALSE
knpmibfhcdn	FALSE
liajfokfhoo	FALSE
liaolmlbjck	FALSE
malgjffngeg	FALSE
malioflilff	FALSE
mkmogmapmoe	FALSE
mknnakccomp	FALSE
ngklhfnnadl	FALSE
nglgjgopkoc	FALSE
oanmcoacanj	FALSE
oapddpekdik	FALSE
oleddjadaoe	FALSE
oledhknimal	FALSE
pfmjklkhpge	FALSE
pfmjkmbldjm	FALSE
aaabfgbdjdaa	TRUE
aaahanijhaaf	TRUE
akcolebfaaaa	TRUE
akdfbmjgaaaa	TRUE
bedljekoaaaa	TRUE
bedoapejaaaa	TRUE
bpcapecoaaaa	TRUE
bpciondhaaaa	TRUE
cikjcpfjaaaa	TRUE
cileojekaaaa	TRUE
dcifejnnaaaa	TRUE
dcioommkaaaa	TRUE
dlnopajpaaaa	TRUE
dlofncaaniaa	TRUE
eiclgfndaaaa	TRUE
eidhnlacaaaa	TRUE
fbbenjadaaaa	TRUE
fbbkegpnaaaa	TRUE
flpeniaangaa	TRUE
flpmkcnhaaaa	TRUE
gglindckaaaa	TRUE
ggmcejcoaaaa	TRUE
hbedkmmcaaaa	TRUE
hbhkimghaaaa	TRUE
hmjlibdoaaaa	TRUE
hmlhiilcaaaa	TRUE
igelodhaajaa	TRUE
igepacelaaaa	TRUE
jaibomodaaaa	TRUE
jakleppoaaaa	TRUE
jkajnjapaaaa	TRUE
jkbedklhaaaa	TRUE
keladkioaaaa	TRUE
kemdpeciaaaa	TRUE
kopmfongaaaa	TRUE
kpcpeoplaaaa	TRUE
ljgbhlhmaaaa	TRUE
ljgbmeifaaaa	TRUE
mdebjfagaaaa	TRUE
mdfaimmjaaaa	TRUE
mnkjcddlaaaa	TRUE
mnlnokpdaaaa	TRUE
nhdmlolkaaaa	TRUE
nheeenbcaaaa	TRUE
ocjoclfmaaaa	TRUE
ocjohcfnaaaa	TRUE
omkafialaaaa	TRUE
omkkcieiaaaa	TRUE
pgoclgeiaaaa	TRUE
pgpboepeaaaa	TRUE
aaabfgbdjdao	FALSE
aaahijhafcpj	FALSE
akboelohmjkn	FALSE
akccofncfloi	FALSE
begolmncpfkd	FALSE
bejbikgnopcl	FALSE
boknmafhmheg	FALSE
bolbhgkimmfh	FALSE
cifnpfmkjcjm	FALSE
cigdgabfbgdm	FALSE
dcaglhcgadgo	FALSE
dcaholiijhlm	FALSE
dmigmefbffoh	FALSE
dmijopcieiga	FALSE
egpiangigmdd	FALSE
egpjpojbplke	FALSE
fbgocgfdkand	FALSE
fbifjlnkfoal	FALSE
fmmbcibmflid	FALSE
fmmemcakfbik	FALSE
ghiaolhaddml	FALSE
ghipfojaogmo	FALSE
hbcekhimhdmo	FALSE
hbdlhlhcohin	FALSE
hlpkplpjnlak	FALSE
hmadeglggchj	FALSE
igabpnienjid	FALSE
igccnfldpejb	FALSE
jalhkoafmkoj	FALSE
janegcdfeipf	FALSE
jkdgjcfjilcj	FALSE
jkdibmniddjb	FALSE
keakloiadckl	FALSE
kealachaabpd	FALSE
kpbeiafhjkph	FALSE
kpcpedeaijnm	FALSE
ljbonmfdhdli	FALSE
ljeomedipheo	FALSE
mdbmijilnnai	FALSE
mdeadfapaoke	FALSE
mndgjkkmgfhf	FALSE
mneffekhljip	FALSE
nijegbicbhai	FALSE
nijlbepdmjgi	FALSE
ocmjoeejdgpm	FALSE
ocnhchiheeij	FALSE
omgkejoaekpf	FALSE
omjiogcbnpmk	FALSE
pgafmlklhpjn	FALSE
pgagjgphmbhj	FALSE
aabjcnhhcfiaa	TRUE
aacocmmfhlpaa	TRUE
akgmmblicaaaa	TRUE
akgododeiaaaa	TRUE
bepdhfjajaaaa	TRUE
bfbaakcpngdaa	TRUE
bpeebnghnaaaa	TRUE
bpfjhmkenaaaa	TRUE
cjnclobbiaaaa	TRUE
cjofdojahaaaa	TRUE
dekimmcplaaaa	TRUE
delebeaneaaaa	TRUE
doighakokaaaa	TRUE
doihlilhiaaaa	TRUE
eikloeacpaaaa	TRUE
eiknpmeakaaaa	TRUE
fccjllmcfaaaa	TRUE
fcddmoakhaaaa	TRUE
fmiablojlaaaa	TRUE
fmihgkmbkaaaa	TRUE
ghdocniobaaaa	TRUE
ghdpdaiipaaaa	TRUE
hamoigdgnaaaa	TRUE
haoinemnbaaaa	TRUE
hjpgkohcpaaaa	TRUE
hkadmcgicaaaa	TRUE
idplifhmhaaaa	TRUE
iebfkeafdaaaa	TRUE
iplaahohdlkaa	TRUE
iplegpmcfaaaa	TRUE
jjjaghchpaaaa	TRUE
jjjifmdkgaaaa	TRUE
kddgeabhkaaaa	TRUE
kdeiilkgdaaaa	TRUE
kmlgbklgiaaaa	TRUE
kmmkkljmiaaaa	TRUE
liacbcpjnaaaa	TRUE
licaidecbaaaa	TRUE
mbofjlkiiaaaa	TRUE
mcbedfmheaaaa	TRUE
mmchmjnifaaaa	TRUE
mmciiaemkaaaa	TRUE
nfldlpohaapaa	TRUE
nflobopjeaaaa	TRUE
oaocecaliaaaa	TRUE
obaocacfkaaaa	TRUE
olanbimicaaaa	TRUE
olbpbdfllaaaa	TRUE
pfgeenmkeaaaa	TRUE
pfhjmnpccaaaa	TRUE
aabjcnhhcfioc	FALSE
aacmmfhlpngkn	FALSE
akihhnedlaijf	FALSE
akiiemimiodmp	FALSE
bfehhogkmecih	FALSE
bffgckfpaejab	FALSE
bpinieclbbebm	FALSE
bpkabahhgfbaj	FALSE
ckgblonkajjhl	FALSE
ckgjgaeiojbad	FALSE
deiffkjpapfdh	FALSE
deihfgbefedpk	FALSE
dpamicchkkhnf	FALSE
dpapjchlmiofn	FALSE
ehkemdimhjdhk	FALSE
ehlamddopkipo	FALSE
fbmbdpchbdhjh	FALSE
fbmekhhbkcpno	FALSE
fmhnaboeefpoe	FALSE
fmjbejeonbgho	FALSE
ghdlogngoogog	FALSE
ghdmmajofnokj	FALSE
happfiegjpjhm	FALSE
hbafilhcebkgd	FALSE
hjigeadlhjebi	FALSE
hjijjcpfdbhjg	FALSE
idoikimnkdcgm	FALSE
idpbfbfgeaemm	FALSE
iphphpijfmejc	FALSE
ipkeiapkjakce	FALSE
jiclpbjinmnhn	FALSE
jiedgbcacjgme	FALSE
kdbldalfonkei	FALSE
kdcblkmaopfgb	FALSE
knfjhcgeemhfb	FALSE
kngfcocbbnaea	FALSE
lhffpfbanacdc	FALSE
lhhddfhbkjjcc	FALSE
mbnoaeljmogap	FALSE
mbojbnfjhbaie	FALSE
mmjljahkifpko	FALSE
mmlgdnegdinmk	FALSE
ngdmgmkfddjnn	FALSE
ngelioochpapa	FALSE
oajleinoiddbj	FALSE
oajodlkgkjjom	FALSE
oklmllmdhkbnd	FALSE
oklpelhippdfb	FALSE
pfiakbpealjin	FALSE
pfiophfmijkdi	FALSE
aaafibalcjjbaa	TRUE
aaahnfpgpljgaa	TRUE
alaecbkgbeaaaa	TRUE
albefafglpaaaa	TRUE
bffcihfmheaaaa	TRUE
bfffngjcpjaaaa	TRUE
bpcfhmenjdaaaa	TRUE
bpiomcjgcgaaaa	TRUE
cjkjabennaapaa	TRUE
cjkjjiddhaajaa	TRUE
ddbhjcoohdaaaa	TRUE
ddbkphdnpfaaaa	TRUE
dnedjlflmlaaaa	TRUE
dnepalbinfaaaa	TRUE
eghmccgpogaaaa	TRUE
eghnbjioghaaaa	TRUE
epjjbgmoapaaaa	TRUE
epjnomclmlaaaa	TRUE
fkcocollpjaaaa	TRUE
fkffeddmojaaaa	TRUE
geogmcpgpjaaaa	TRUE
gepoaadlnaifaa	TRUE
hbahphcoeoaaaa	TRUE
hbemaidpmbaaaa	TRUE
hmacaahgenkhaa	TRUE
hmadcpimjlaaaa	TRUE
igbdmlcehgaaaa	TRUE
igehidfpmhaaaa	TRUE
jaedbbciddaaaa	TRUE
jafibpiiifaaaa	TRUE
jlgooanlmaalaa	TRUE
jliljpknlaahaa	TRUE
kemkempopfaaaa	TRUE
keochgfajoaaaa	TRUE
kodlbioeeeaaaa	TRUE
koeaepnamnaaaa	TRUE
ligpngklkcaaaa	TRUE
liiibbnoohaaaa	TRUE
mcbcknkgpjaaaa	TRUE
mcbllfkljnaaaa	TRUE
mmckgdkacoaaaa	TRUE
mmdmphoaihaaaa	TRUE
nhapegejonaaaa	TRUE
nhbenjpgikaaaa	TRUE
obbeefijgmaaaa	TRUE
obbfoengahaaaa	TRUE
oljphdelbpaaaa	TRUE
olmldacimlaaaa	TRUE
pfbeiolfbiaaaa	TRUE
pfbomlpbnpaaaa	TRUE
aaafibalcjjbnf	FALSE
aaahpgpljgeele	FALSE
alacnlpapemmkd	FALSE
alakcgbdgeeplf	FALSE
bfgaeepacjcogp	FALSE
bfgcegkcaniaaf	FALSE
bphplekjeageih	FALSE
bpiajmjghlfamc	FALSE
cjjgokidebjjea	FALSE
cjjikegollbiem	FALSE
ddhikgellmkmgp	FALSE
ddhjkkoaaongdf	FALSE
dndodlkffgifcj	FALSE
dneflhilkgmdbe	FALSE
ehipnkbclmijdi	FALSE
ehjjcemgfojggo	FALSE
epkgnpmpanmhil	FALSE
epkndljpnlaekf	FALSE
fkihiefjmoofmh	FALSE
fkjcnkkpjhfngp	FALSE
gfiihblbdelnje	FALSE
gfikjpmlhmclkb	FALSE
haokoicgkbecoa	FALSE
hapocnaldnpemp	FALSE
hlkjbafobenajn	FALSE
hllbfjhnpmjaom	FALSE
ifhoobbmeaoifg	FALSE
ifjfjboifgfehl	FALSE
jaeoplabmibdlh	FALSE
jafbajcnibjdck	FALSE
jkgdglmoapmfgn	FALSE
jkghcahmmbenmi	FALSE
kekdllpmfcfihb	FALSE
kelggkapigjkjc	FALSE
kobklclodcgokc	FALSE
kocdhkaaclknpf	FALSE
lijfhbgpdggpol	FALSE
lijgbmecnipooe	FALSE
mcgchjbommmcfd	FALSE
mchnfnokicigin	FALSE
mmhmodfceloilj	FALSE
mmidkmbapcmegk	FALSE
ngegndphkfkdka	FALSE
ngenjhmiafkbal	FALSE
obgachedhcokac	FALSE
obgijeaplfcegi	FALSE
oknjgbdckcgcnm	FALSE
oknkhnehieggga	FALSE
pfhppchpcimjhe	FALSE
pfifbhbfcnfabb	FALSE
aaaajbofiaehkgg	TRUE
aaaoddlmdneamaa	TRUE
ajljmhkgpjfaaaa	TRUE
ajmdaohegefaaaa	TRUE
bffndaehahnaaaa	TRUE
bffpebjhhdlaaaa	TRUE
bpcllmcjadeaaaa	TRUE
bpdlodbedndaaaa	TRUE
cjjidpalabkaaaa	TRUE
cjjidpobepiaaaa	TRUE
ddccccmpkelaaaa	TRUE
dddenhndmjmaaaa	TRUE
dnbhkiddmjiaaaa	TRUE
dnecnomkjkfaaaa	TRUE
egmnnennkboaaaa	TRUE
egncobaddgiaaaa	TRUE
faocoholmghaaaa	TRUE
fapaodekjdaaeaa	TRUE
flmgaiaiilhaaaa	TRUE
flnpipmpgelaaaa	TRUE
gfeaohocnacaaaa	TRUE
gffdookdnokaaaa	TRUE
haempepmifaacaa	TRUE
hafcbliegkgaaaa	TRUE
hkmjedmdfbnaaaa	TRUE
hkncffdeikhaaaa	TRUE
iekbjimhaioaaaa	TRUE
ielegianoilaaaa	TRUE
ioegglccbkiaaaa	TRUE
iofblcpjhoiaaaa	TRUE
jickendgdeoaaaa	TRUE
jiclbhmiepgaaaa	TRUE
kbmnhfckdhlaaaa	TRUE
kbnhimhomgiaaaa	TRUE
kmkdeblohnfaaaa	TRUE
kmkfpoaoakbaaaa	TRUE
lhkigghibebaaaa	TRUE
lhnkjaddhooaaaa	TRUE
mcdfchjfcdfaaaa	TRUE
mceoefoiemdaaaa	TRUE
mmpbmnlebmkaaaa	TRUE
mmpehoelajaabaa	TRUE
ngnpdneghomaaaa	TRUE
ngockjohodfaaaa	TRUE
oaledmlbemoaaaa	TRUE
oalkkolcaalefaa	TRUE
oklnfmieigjaaaa	TRUE
okmmbianebmaaaa	TRUE
pfnppojfbpeaaaa	TRUE
pfogijcdgoiaaaa	TRUE
aaaajbofiadhkaa	FALSE
aaaoggddlmdnean	FALSE
ajnkpgdbkmoogbd	FALSE
ajoappbkanhhgif	FALSE
belmnkjpgfalphh	FALSE
bemebhodlnjcflg	FALSE
bopjmcmeppehgpa	FALSE
bpaejgeoffgflnn	FALSE
cjhlhfbdfdnfbbb	FALSE
cjiogamokehafna	FALSE
ddbefgdoejmebkc	FALSE
ddbhdebblohbeif	FALSE
dnhfebodkiiibpl	FALSE
dnhpkphlnnbekcg	FALSE
egdcnemcpejajlm	FALSE
egdeilhiopeeaeh	FALSE
fbcfbijfilbghnf	FALSE
fbdgjlkheoadadg	FALSE
fleeochgeallaoe	FALSE
flffgjecodlidkd	FALSE
ggfljnciipnahmc	FALSE
gggpocnocbahdfd	FALSE
hacphjalgnohago	FALSE
hadmfeglmdkmaal	FALSE
hkjipffkheejicb	FALSE
hkjlcjcaafdeeid	FALSE
ifehilocojkjmok	FALSE
ifenmokmohighgg	FALSE
iogpplilbapdknj	FALSE
ioiieijgjedphgg	FALSE
jhjlljlgpmdlfmn	FALSE
jhmnbfpnamponjj	FALSE
kcjnggohibbnngi	FALSE
kcknfcmafkbogbj	FALSE
kmnkimgofmpakcj	FALSE
kmogahfcblbfiap	FALSE
lhihjcdddflhiho	FALSE
lhkfbedepncgnon	FALSE
mchnghbegadieol	FALSE
mcibpndpdipmdll	FALSE
mmnakkihhbjnmab	FALSE
mmnjdmnhjlpnkho	FALSE
ngmimgknffhmcib	FALSE
ngoafnnagjeiagf	FALSE
obagnendpfgelnf	FALSE
obagnnjajheljop	FALSE
okmfkeiccdnnehb	FALSE
okmkbokaifimlpj	FALSE
pgbdkedjkgpkncg	FALSE
pgbkjkegleieihp	FALSE
aachahidfcpbbmaa	TRUE
aadfchgclkpnbkaa	TRUE
ajpinkfdaboeaaaa	TRUE
ajpjkilhdbhfaaaa	TRUE
bdnpbfmccgbhaaaa	TRUE
bdpnfbnnoikkaaaa	TRUE
boajeibicgciaaaa	TRUE
boaoobhlmgbmaaaa	TRUE
cjglknjfcpflaaaa	TRUE
cjhofofblifgaaaa	TRUE
ddgnlnhjpjipaaaa	TRUE
ddhghngdgcieaaaa	TRUE
dninnlkbkldlaaaa	TRUE
dnjgfifhechcaaaa	TRUE
ejhjlanhbbfgaaaa	TRUE
ejhmjhmjboaeaaaa	TRUE
febbmjcekblnaaaa	TRUE
fecppdbofcapaaaa	TRUE
fnfdkmpkbopaadaa	TRUE
fniioaclpcdpaaaa	TRUE
ghfoaiinjijgaaaa	TRUE
ghhhkjfifolcaaaa	TRUE
hbdfbnpeffecaaaa	TRUE
hbdijafookfgaaaa	TRUE
hleijalifeagaaaa	TRUE
hlelcdbmnappaaaa	TRUE
iehlahddcjilaaaa	TRUE
iejbilobmcmnaaaa	TRUE
imoijejefmodaaaa	TRUE
imonngjnedcmaaaa	TRUE
jgnoloknfophaaaa	TRUE
jgpifkhkeemlaaaa	TRUE
kaljiheihfckaaaa	TRUE
kbakbkbbddkfaaaa	TRUE
kkpmlalelnkjaaaa	TRUE
klaadjhbgjjlcjaa	TRUE
lhdemabgkmgjaaaa	TRUE
lhgokdklglkoaaaa	TRUE
mbhllojgnfjkaaaa	TRUE
mbjelniahkkmaaaa	TRUE
mmjdonjomoooaaaa	TRUE
mmkebonkfhhlaaaa	TRUE
ngejkhppliieaaaa	TRUE
ngekalgmncnnaaaa	TRUE
oajkhdcadndgaaaa	TRUE
oajpidmdnlamaaaa	TRUE
okfchefmbcobaaaa	TRUE
okgeakhcppeeaaaa	TRUE
pflbjleoflmpaaaa	TRUE
pflmeipepddbaaaa	TRUE
aaagakjafangmdbn	FALSE
aaapleblbahekckg	FALSE
akafineogepalimj	FALSE
akaplfdojlceflgh	FALSE
bdhnibbboingobma	FALSE
bdilfffjlekaamng	FALSE
bphppclnjkcihjnf	FALSE
bpjbgamnakjnbbah	FALSE
cinikddljlpcfiij	FALSE
cinpmiopaeekccdj	FALSE
debkpjjfanonmadn	FALSE
decokgdodnpfngog	FALSE
dpkhoojajmmpjenk	FALSE
dpkkhieikepgpnoi	FALSE
ejcdddblmgbinocg	FALSE
ejdkiogcgkjfkpab	FALSE
fcobeolpaoidgkmi	FALSE
fcpcfdpocdjebkdp	FALSE
fnabeapokknmnela	FALSE
fnamghhhgkkagdck	FALSE
ggemjmooclnahjin	FALSE
ggfhpniioncdanah	FALSE
hamejndebloeeobp	FALSE
hanakjlmoahndjoe	FALSE
hlhhfdpbccajlkgf	FALSE
hlhlmihjkfelhdim	FALSE
ifhlldljgejcjkoj	FALSE
ifidjamejoonfpbi	FALSE
ipilglhlhljoocgb	FALSE
ipkdbknffjbahpfj	FALSE
jkbildepocbffhba	FALSE
jkcejjiecldigkbm	FALSE
kendegkaecibpjph	FALSE
kfafpeopdgnnphhc	FALSE
kpdgnelpjkefpgaf	FALSE
kpdmajjecgiifona	FALSE
ljpmgipojkdmgcdp	FALSE
ljpnamadbogpjpio	FALSE
mchllaofnciaaffi	FALSE
mchnkpmpeanpkjnl	FALSE
mnlndbmlgpaibfem	FALSE
mnmbcgfjagimmjao	FALSE
nhdhfkolgedblgfb	FALSE
nhdlmkfhhpfmckco	FALSE
oaljdhefjhndaabm	FALSE
oamodiheomnoaaei	FALSE
okkkjagbhhcadkbk	FALSE
okmjieikgabndedj	FALSE
pgfancdmhcgogbkf	FALSE
pgfhfpdcecopbnfj	FALSE
aaagakjafangmdbaa	TRUE
aaapnleblbahekcaa	TRUE
akbdfpgphdkfiaaaa	TRUE
akbepcdoiogbcaaaa	TRUE
bemleadboceapaaaa	TRUE
benapfmkpadmaaoaa	TRUE
bpepljpmokhpiaaaa	TRUE
bpijclffhdkomaaaa	TRUE
cjipgifjefognaaaa	TRUE
cjlgnnlchkfpmaaaa	TRUE
deendfnniehjgaaaa	TRUE
defngijmfjfpdaaaa	TRUE
dpbhgnlakfocaacaa	TRUE
dpcckhpokmbjjaaaa	TRUE
eiolcajcggbfaadaa	TRUE
eipcleadnjmhlaaaa	TRUE
fcmjolcogpomjaaaa	TRUE
fcmpiplgmigllaaaa	TRUE
fncdgmlfokpbmaaaa	TRUE
fndhbkmpnkjmaakaa	TRUE
ggbmeinmfpglpaaaa	TRUE
ggcgnboeciddhaaaa	TRUE
hanokhekhdiplaaaa	TRUE
hapapndffocaoaaaa	TRUE
hmacmnmhadfloaaaa	TRUE
hmaflfomjkmgaakaa	TRUE
ifipbgcbfbcenaaaa	TRUE
ifjigopjnkopdaaaa	TRUE
ipjeonmjbbhhcaaaa	TRUE
ipjhkiogaakjcpoaa	TRUE
jkdbikbbinedfaaaa	TRUE
jkddhimdfhphiaaaa	TRUE
kfchjndabkbccaaaa	TRUE
kffnaclcnigajaaaa	TRUE
koopelfgghagkaaaa	TRUE
kopjdgjaadpmaflaa	TRUE
ljipfjnlghilaafaa	TRUE
ljjemoilobockaaaa	TRUE
mchdnloffalcpaaaa	TRUE
mchjkcfpllopaaeaa	TRUE
mmlfccihpnljnaaaa	TRUE
mmmbadpmmlghiaaaa	TRUE
ngjpddbjckfdoaaaa	TRUE
ngkgmbblemdnnaaaa	TRUE
oamkmhcnpikglaaaa	TRUE
oamohlbkpipojaaaa	TRUE
oliiilgheejnnaaaa	TRUE
olimlhdipdajfaaaa	TRUE
pghcephejepnbaaaa	TRUE
pgijphkofjiagaaaa	TRUE
aaaekmifobkpdiejf	FALSE
aacbljjkoaihkccpp	FALSE
alggipdgpbkhaplbl	FALSE
alheifhfpkbkdeddo	FALSE
bfbefhlgaccheafdh	FALSE
bfbhfffjmhncnpfcc	FALSE
bpdphihhdcedlokno	FALSE
bpeapbkjflbjccjbi	FALSE
ciopajcipoaimfbpk	FALSE
cipeecgmjnlocahdl	FALSE
dbophcmbjgdbhmpoc	FALSE
dbpahnjcookejeplm	FALSE
dmkliknhoimdaanha	FALSE
dmliaheecnhgkjleb	FALSE
ehnelhneghagfocok	FALSE
ehngcolembbmgekgb	FALSE
fdahiokabepjidejj	FALSE
fdbbhgdhlhdcefeol	FALSE
fmgckjpdgblodgdao	FALSE
fmheifidalflempel	FALSE
ggedopnlncnjhakgh	FALSE
ggfpaeacfjmkjanpi	FALSE
gpimkapfcnlnbahpc	FALSE
gpkpedoecmngfhhmd	FALSE
hjkoladclchfdfcmo	FALSE
hjoeaihnnbogfgkhp	FALSE
idekcpmblficppbna	FALSE
idgkobfdeeehokkfm	FALSE
ilnndlpdgiijfmile	FALSE
iloadhmheaiilonon	FALSE
jejdamdgifobiecff	FALSE
jelmhppgiaofmgfhp	FALSE
jplhablhlipmomiig	FALSE
jpmclmfhlhaomohli	FALSE
kkmdddnlkmipelbff	FALSE
kkmggpcdbbbmgheig	FALSE
lgdigodofmelfnicp	FALSE
lgdoiflclncaknfph	FALSE
mablnfiihbjaafkeo	FALSE
maclobaboilfjakfe	FALSE
mlbbndokjgklmkogn	FALSE
mlcennhaokolddphb	FALSE
nfgpkfjeplpbadjfj	FALSE
nfhpepkdijfkacklm	FALSE
nplchdmagflgmoaee	FALSE
npmaiimhkbhmdpdem	FALSE
omcaigippgnjolihn	FALSE
omcaphcofagchkblj	FALSE
pfibdhffbllpefcgo	FALSE
pfiedlfjjjhilpojb	FALSE
aaadklgbdkpnpiebaa	TRUE
aaagkbhaeecmcmjjaa	TRUE
akhdlfeknholhoaaaa	TRUE
akhihjkkkjabjpaaaa	TRUE
bdegjlbfkkohphaaaa	TRUE
bdfcojbjoedfijaaaa	TRUE
bocjpgekgnkkjlaaaa	TRUE
bodeelmiadbjleaaaa	TRUE
cimfnelcabnjbgaaaa	TRUE
cimmapjpnbjfdcaaaa	TRUE
dckdafgaddbifmaaaa	TRUE
dcncocfdbfahglaaaa	TRUE
dnklifnjcdonkoaaaa	TRUE
dnkokljjljaoipaaaa	TRUE
egngfejjblkcekaaaa	TRUE
egnidnddlckmhlaaaa	TRUE
fbeabnogkladkoaaaa	TRUE
fbficfbgaacnenjpaa	TRUE
flhefnmjjpdffgaaaa	TRUE
fligpaajemdbacglaa	TRUE
genhdoiappdnpdaaaa	TRUE
genlpfblfmfdgoaaaa	TRUE
haaanmcomhgohijiaa	TRUE
haaillihjgohaadfda	TRUE
hjlmahljehfeopaaaa	TRUE
hjpcnhhnannpnjaaaa	TRUE
iedohoccffgkcpaaaa	TRUE
iefnaipfgeabikaaaa	TRUE
iojpgnlhkfkcddaaaa	TRUE
iokgldfhalojanaaaa	TRUE
jhoaginldkhigeaaaa	TRUE
jhodlflijkakaiaaaa	TRUE
kcbcifhiegjhpcaaaa	TRUE
kcbhomkhmkjnmmaaaa	TRUE
knddaconcdhpinaaaa	TRUE
kndeennjdpdkppaaaa	TRUE
lidgpokhphbmcpaaaa	TRUE
lidkgnnjkkoanjaaaa	TRUE
mcjlaapikchmpmpiaa	TRUE
mckemlnhlfhpmkaaaa	TRUE
mlogjibapjjegfaaaa	TRUE
mmangahlphfnejaaaa	TRUE
nhhihbdgpibpinaaaa	TRUE
nhianmjoihmihkaaaa	TRUE
obnbedabdfpmnbaaaa	TRUE
obngoamofjnipbaaaa	TRUE
olnbdihaopbinbaaaa	TRUE
oloojcgfhappclaaaa	TRUE
pffmcillipjhknaaaa	TRUE
pfhfdelkimdbmnaaaa	TRUE
aaadklgbdkpnpiebkb	FALSE
aaaghaeecmcmjjhcik	FALSE
akhhcceinlhokalcee	FALSE
akikappogpfifjhfbd	FALSE
bdhiehaobadkpiiinm	FALSE
bdidpekdaanopgoeol	FALSE
bnjmlebegppcdcjeig	FALSE
bnndgkeiicobajbnjg	FALSE
cigjkhihicoenjacid	FALSE
cihgmkdldhpcibledh	FALSE
dclbimiflhaffhhagh	FALSE
dcmdinaclpgpenibae	FALSE
dmpgdfjleaafdgpbna	FALSE
dnaidhkpgigdeafakh	FALSE
egpkhbfmaipnnmabcl	FALSE
ehaephhpnejgjoblml	FALSE
fbbimaadgbmjcacmgm	FALSE
fbbmkcokmhjehcffpg	FALSE
flcejpclhlnloiglhm	FALSE
fleejaoagnapofkojo	FALSE
gfcccieilepmjfhnno	FALSE
gfelolkppkpfnnlofe	FALSE
haagjadmegoinocjmj	FALSE
hadampkbplclonflcl	FALSE
hjgacddibpkkpifhdf	FALSE
hjidanlhnffnagpdeo	FALSE
idhejckhmonpphacei	FALSE
idhlhohkmdegpdjoij	FALSE
iodfoioeaemhdhbmdc	FALSE
iofgllkendpelhcbbd	FALSE
jiakhphnkmealcdjfb	FALSE
jibmeckpddljahjmdk	FALSE
kcejipemldmffhibje	FALSE
kcejkgdahpmapiabal	FALSE
kmkhhkmlcajegdiiab	FALSE
kmlbemepfnaekkbehm	FALSE
lhleofhgelcfjehdol	FALSE
libbapojhfnklkkbij	FALSE
mclbhbomcijdeiegpl	FALSE
mclddnclngcnikigdd	FALSE
mmecjnpcbhhccpagpf	FALSE
mmecoofkhmmhjjaoej	FALSE
ngnjcmdkhcpijgemed	FALSE
nhaenlhnfdabhkjhkk	FALSE
obmbdmkpnfdkammclp	FALSE
obmoliiogijdnnpohl	FALSE
oljgcbnolejjmchohp	FALSE
oljgcncgghljipjfgo	FALSE
pfepehkddpfjfmoljd	FALSE
pfgcmhogggaflojjch	FALSE
aablklgmiafgeampeaa	TRUE
aachipkpjhifkdidiaa	TRUE
ajpondhpfcmhnfnaaaa	TRUE
akcnahdgjnijcfbaaaa	TRUE
bdopbceipeeoaijaaaa	TRUE
bdphjineonhinepaaaa	TRUE
boboplbiekbiihhaaaa	TRUE
bodmjpfconcbbohaaaa	TRUE
cidilcejfcakmnfaaaa	TRUE
ciedcpahcdlbpeaafaa	TRUE
dclcbnfmokhoehkaaaa	TRUE
dcmkjnnjjfkjjigaaaa	TRUE
dnfkepjpcgeglfcaaaa	TRUE
dngcfhhnghdjhahaaaa	TRUE
egoeekejkeoikbbaaaa	TRUE
ehadldfhkdonnnfaaaa	TRUE
fcabecjggfdogdiaaaa	TRUE
fcbcmlnloocmmggaaaa	TRUE
fklkcopeejbknmaalaa	TRUE
fkmfkjkcgknbcknaaaa	TRUE
gejmpnfnbfbbhilaaaa	TRUE
gemaglnloplmodfaaaa	TRUE
goijdpeafdloigiaaaa	TRUE
gojoaeiildianchaaaa	TRUE
hjgepmblhnbkcgoaaaa	TRUE
hjhfhliddhcnccfaaaa	TRUE
idkbanhdoenddgjaaaa	TRUE
idlikchgjpgdgpkaaaa	TRUE
ioialciblmooakoaaaa	TRUE
ioijppcjahpcaoeaaaa	TRUE
jiiehgpeonpljipaaaa	TRUE
jiiollnnhgkbnieaaaa	TRUE
kccpelmkabmcpbpaaaa	TRUE
kccpigleifdophmaaaa	TRUE
kmolchfdkgfknjaakaa	TRUE
kmpmdldgpgodjjhaaaa	TRUE
lhoalaflinkcogbaaaa	TRUE
lhohcgnjhagdiekaaaa	TRUE
mcehojladeeenbgaaaa	TRUE
mceiialjbgifmhkaaaa	TRUE
mmghmpmknpdibalaaaa	TRUE
mmhdodjajfhofkaagaa	TRUE
ngpbnjbhgcdchbhaaaa	TRUE
ngpcaimnogckkmiaaaa	TRUE
obmgpanjhogpdacaaaa	TRUE
obmibemfghjeljfaaaa	TRUE
olcbncammggjgpkaaaa	TRUE
olcejlngopldjdfaaaa	TRUE
pfpkafhgelpgllhaaaa	TRUE
pfplglmkhjoiodjaaaa	TRUE
aadabaebbpblcecnhdd	FALSE
aaebnbnbgmagdfcalde	FALSE
akmpaiondafcmoiimaf	FALSE
akndmgpaihlfndhcfgc	FALSE
bfnaaldhokklmhjmici	FALSE
bfndpelpdakiffgcaeb	FALSE
cabjiolepdkdhodcahp	FALSE
cabmkfdbobbfonggdio	FALSE
ckpbnblhnajdkpgalme	FALSE
ckpgonihmdipepiffoe	FALSE
dgipfpjgnkjdohmecod	FALSE
dglcdhdkmoglipmffpc	FALSE
eapnbjoebeahbbjgddo	FALSE
ebacgfpajchonmleamd	FALSE
emabgakljbgnlboalce	FALSE
emagnnebfgdhnjgkdig	FALSE
ffghhacaagemofimgjh	FALSE
ffhhfdcnejhohgfeken	FALSE
gadgkfmdogejcaadehh	FALSE
gaeklompdohakoibglc	FALSE
gkjcpecnoohhfoibipm	FALSE
gkjipocejhcbjcfihdl	FALSE
hgcdgejnolegcemcnge	FALSE
hgdbmmpeecpnflibaij	FALSE
hpojgfdoalheidcagbf	FALSE
hpokaocgjlcgahdoidp	FALSE
ijphkfhcpehdjggicim	FALSE
ijpnnbdikajpffoooef	FALSE
jdmpjmeggmneifohhpg	FALSE
jdohpjnihjinnakdclp	FALSE
jnhodlicfchpflpobda	FALSE
jnibmpageepmiibngak	FALSE
kiehflkdnlfbhfjdeca	FALSE
kieilmfmfgkopfplghe	FALSE
lapkoiobpgillpcobmk	FALSE
lbabgehofilkekiimpo	FALSE
llckcjbmncmdcmjoena	FALSE
lldmkdodopcobklokli	FALSE
mfbckjiaomgchfmnjlp	FALSE
mfbfgcpbjdnjgejcdog	FALSE
moldcnkjbopomndmepi	FALSE
momejdoonlhdelpnmnc	FALSE
nikillioikjfckhbmhe	FALSE
niljphebajhloffknbm	FALSE
ocpajglokfflgndgjhf	FALSE
odbeoddcnpcijgnaclj	FALSE
omaajdlffpajljoafna	FALSE
ombbghfpmobplgffalm	FALSE
pgflagmojpmpegblkag	FALSE
pggdejlbbaelcclgdmb	FALSE
