aaciabiajf	TRUE
aadociiiej	TRUE
akdhibhhmj	TRUE
akellikobh	TRUE
beeklljedf	TRUE
beelgnhfkk	TRUE
bomoifolin	TRUE
bomojicabd	TRUE
cjaaambokc	TRUE
cjajifmdhi	TRUE
dcmcfklopp	TRUE
dcmhobplbf	TRUE
doloiamgkd	TRUE
doodjblbep	TRUE
einfiiecbn	TRUE
einndkdkmm	TRUE
fcldenkihe	TRUE
fclimfolbh	TRUE
fmfdhihljj	TRUE
fmfdnmhodp	TRUE
gfmnofiejp	TRUE
gfneclgncc	TRUE
gpinnlemff	TRUE
gpjmjmmmcc	TRUE
hjeheaiece	TRUE
hjhbpphldj	TRUE
iepjbjagdf	TRUE
ifbnpddpcj	TRUE
jackegaiho	TRUE
jadgadicdm	TRUE
jiniaokipf	TRUE
jinmmfogga	TRUE
kdfceneahk	TRUE
kdflidejhj	TRUE
kohandppgc	TRUE
kohgkadapk	TRUE
lhhacimjlp	TRUE
lhkanpmobm	TRUE
mbcjgpofgb	TRUE
mbdccippoh	TRUE
mlgjcockhp	TRUE
mlhkkbbmod	TRUE
ngoijjeioi	TRUE
ngoikfomah	TRUE
oaoincdend	TRUE
oapcmifaka	TRUE
oldjmceodb	TRUE
olffjecnoh	TRUE
pemgmpjjaf	TRUE
pemhnibpoh	TRUE
aaajcmabab	FALSE
aabmdgeiab	FALSE
akpgpnabab	FALSE
akpiebabab	FALSE
bfdpfkabab	FALSE
bfeajgabab	FALSE
bpoeahabab	FALSE
bppegeabab	FALSE
ckdikcabab	FALSE
ckfgckabab	FALSE
dfeokgabab	FALSE
dfffmaabab	FALSE
dpgmegabab	FALSE
dphfbjabab	FALSE
ekklmbabab	FALSE
eklbmjabab	FALSE
fegiopabab	FALSE
fegjkjabab	FALSE
foamlgabab	FALSE
fobjgoabab	FALSE
ghlcgpabab	FALSE
ghljcmabab	FALSE
hblachabab	FALSE
hblbmoabab	FALSE
hllcjbabab	FALSE
hllifdabab	FALSE
igapepabab	FALSE
igaphhabab	FALSE
jambnlabab	FALSE
jampegabab	FALSE
jklkadabab	FALSE
jkmfcgabab	FALSE
kfnjmkabab	FALSE
kfpklnabab	FALSE
lajgfiabab	FALSE
lakjgnabab	FALSE
lkfacjabab	FALSE
lkgcaiabab	FALSE
mfeokhabab	FALSE
mffdheabab	FALSE
mpghmaabab	FALSE
mpidcdabab	FALSE
njdjkjabab	FALSE
njdmhhabab	FALSE
ockgogabab	FALSE
oclbemabab	FALSE
olpallabab	FALSE
olpeolabab	FALSE
pfjkbhabab	FALSE
pfjoedabab	FALSE
aaajcmmdgei	TRUE
aabmpcciipm	TRUE
akockicnmkm	TRUE
akpilkncgdi	TRUE
bfnfpfmmlmp	TRUE
bfnkoifiieh	TRUE
bpmpgandgci	TRUE
bponoiabphn	TRUE
clbbloflfjc	TRUE
cldmhkeljoe	TRUE
deohcobmndo	TRUE
depklangppn	TRUE
dpbdkgibone	TRUE
dpbmikjfmfo	TRUE
ejfpcbkjmjo	TRUE
ejgfnjpggam	TRUE
feidoopkkph	TRUE
feikikjcbij	TRUE
foebdbkiini	TRUE
foebgafcfpo	TRUE
ghkfhmhdmio	TRUE
ghknffloibg	TRUE
hbjpifkhdim	TRUE
hblaljneika	TRUE
hlpnijhmfke	TRUE
hmadigpbhbc	TRUE
igknommffan	TRUE
iglgbkcecgn	TRUE
jajlaadabll	TRUE
jajlkonmkjk	TRUE
jlahlkpjncb	TRUE
jlajfldgede	TRUE
kgcmlbefggl	TRUE
kgdbnmbpjfd	TRUE
lahdenpfmfi	TRUE
lahhmbdphnh	TRUE
lkninopbhci	TRUE
lkoenepcmbk	TRUE
mfdjnmbdpig	TRUE
mfelfbcenma	TRUE
mphihclnmho	TRUE
mpianhjaghc	TRUE
nidgcojjejj	TRUE
nidokkgfcee	TRUE
odalhminilb	TRUE
odbgfdhcmlk	TRUE
olkijplpank	TRUE
olkojeidmed	TRUE
pfccaggklpp	TRUE
pfciedinffb	TRUE
aaajcmmabab	FALSE
aabdgeimpab	FALSE
akpjebnabab	FALSE
akpkoleabab	FALSE
bfapkhcabab	FALSE
bfcfabdabga	FALSE
bpofnkkabab	FALSE
bppcocaabab	FALSE
ckiklllabab	FALSE
ckkdlaoabab	FALSE
deoikfhabab	FALSE
deoljlaabab	FALSE
dpbmkpbabab	FALSE
dpcpaflabab	FALSE
eipcomkabab	FALSE
eipeepoabab	FALSE
fechjhlabab	FALSE
fedgkbkabab	FALSE
fnnnlopabab	FALSE
fnnodcdabab	FALSE
ghfjmdnabab	FALSE
ghggmfablab	FALSE
hbfghbcabab	FALSE
hbfhdmpabab	FALSE
hlgmmknabab	FALSE
hljpbopabab	FALSE
igonafaabab	FALSE
igpbdmjabab	FALSE
jaohfbdabab	FALSE
japagkoabab	FALSE
jloabjnejab	FALSE
jlobmnjabab	FALSE
kfniomabpab	FALSE
kfnogmlabab	FALSE
lafbdioabab	FALSE
lafianjabab	FALSE
lliollcabab	FALSE
lljkpepabab	FALSE
mfjinnkabab	FALSE
mfjmbpfabab	FALSE
mpjgoikabab	FALSE
mpkblofabab	FALSE
njjdkagabab	FALSE
njjhacfabab	FALSE
odcafjlabab	FALSE
odccimgabab	FALSE
olpbnciabab	FALSE
olpkcihabab	FALSE
pfopmbfabab	FALSE
pfpdddmabab	FALSE
aabcekjcmgcl	TRUE
aacgejimbbpl	TRUE
akedpkhloplf	TRUE
akelinejlkbc	TRUE
bendaghndcja	TRUE
bfbikccjlhpb	TRUE
bomhghiekbcc	TRUE
bonbkdndinda	TRUE
cjpcibocbjbe	TRUE
cjpenobnfgac	TRUE
deceblgnccjc	TRUE
declegnkhiia	TRUE
dnligifnbmhm	TRUE
dnmoieomhioa	TRUE
eimeecacpick	TRUE
einheefbhcae	TRUE
fcnfjfiabdkj	TRUE
fcngapefcicj	TRUE
fnikmlimkhhl	TRUE
fnjikbkdnpbi	TRUE
ginkehacafgf	TRUE
giogbdbgffoj	TRUE
hcblkoggljpd	TRUE
hcbocckmgoje	TRUE
hlghboplnkka	TRUE
hlkiodfihmcn	TRUE
igchbijgphmi	TRUE
igdkecknjfoh	TRUE
jahlphjipdkc	TRUE
jakddbbbkoag	TRUE
jjogcknnllph	TRUE
jjpmgmhelhpf	TRUE
kdbkmnlpkeed	TRUE
kdcfhaeoipmc	TRUE
kmhbakjefjab	TRUE
kmkcjjphcpga	TRUE
lhgpbjpfjjie	TRUE
lhhkjibcpegh	TRUE
mcgccddobcka	TRUE
mcifkjneebmf	TRUE
mmghljgojdbf	TRUE
mmkoafndpdgk	TRUE
nhgjedefglna	TRUE
nhgljacknpej	TRUE
obijjdhnmkog	TRUE
obikhppcikle	TRUE
olhkbafalken	TRUE
olibcfnjgnph	TRUE
pfgbpkhnhfml	TRUE
pfgcllnooofa	TRUE
aabcekjcmgab	FALSE
aaccpjejabab	FALSE
akdkcbgcabab	FALSE
akdmmgopabab	FALSE
beilnkbnabab	FALSE
bejkbbbkabab	FALSE
bpacjbhbabab	FALSE
bpaplhojabab	FALSE
cjmckjpcabab	FALSE
cjmelaeabnab	FALSE
decbapjbabab	FALSE
dedlibgeabab	FALSE
dnomahpjabab	FALSE
dnpmbkiiabab	FALSE
ehnipbdcabab	FALSE
ehohjaleabab	FALSE
fcikpknfabab	FALSE
fclimlfdabab	FALSE
fnhjeeakabab	FALSE
fnlbgcogabab	FALSE
ghgnlnkkabab	FALSE
ghgofahiabab	FALSE
hceknohnabab	FALSE
hcfcmkbbabab	FALSE
hllhagmmabab	FALSE
hlmjmjgmabab	FALSE
ifnlanijabab	FALSE
ifpafdglabab	FALSE
jagcclmdabab	FALSE
jagndelfabab	FALSE
jjpbmpbcabab	FALSE
jjpglinmabab	FALSE
kchgikklabab	FALSE
kcipkgejabab	FALSE
knegpmcmabab	FALSE
knfhehlkabab	FALSE
lhdggmemabab	FALSE
lhemoheiabab	FALSE
mceemnijabab	FALSE
mcfckabokiab	FALSE
mlnhkapfabab	FALSE
mmaaegdoabab	FALSE
ngpkjldcabab	FALSE
nhbbbchhabab	FALSE
obdpnakabcab	FALSE
obenncocabab	FALSE
oledhhpaabab	FALSE
olefnbkiabab	FALSE
pfmnpgnfabab	FALSE
pfncjpajabab	FALSE
aaagiomgdogpi	TRUE
aaaipeikbimad	TRUE
ajoofnkboahch	TRUE
akaelmbpeoaeo	TRUE
bdnnpfghlliia	TRUE
bdobilkcidbif	TRUE
bmpioojjogamo	TRUE
bnfpddjifodbc	TRUE
chndlgkmjjnpg	TRUE
chnecnpomdgfc	TRUE
dbkjphefkknhg	TRUE
dbkkoipmohcbi	TRUE
dlalfdchlpglb	TRUE
dlbdacfiebofe	TRUE
efiabpdhcpnmh	TRUE
efjbhhnjlnmab	TRUE
epeihfjljafdi	TRUE
epeljcjiffgah	TRUE
fjonipkdldlme	TRUE
fkbnjciekpnke	TRUE
ggaheobhjabfo	TRUE
ggbacpmblenmm	TRUE
hamddhedglmha	TRUE
hananiheejoja	TRUE
hlalkeffocmij	TRUE
hlanjdfoegfkd	TRUE
ihbjgflocjikf	TRUE
ihccckpffinpp	TRUE
jadgofdcknihb	TRUE
jaeambbmfglcl	TRUE
jlellbicdkefd	TRUE
jlfbfchklinih	TRUE
kgaehfkihilei	TRUE
kgcjemlfmhcbb	TRUE
lalkhobpgkflc	TRUE
lamhgianojdpg	TRUE
lkbemjdnpjpac	TRUE
lkdhopccdagdg	TRUE
mdgbnjfomlpcn	TRUE
mdgemlbcloijm	TRUE
mndfnadaafhjb	TRUE
mndjicfiglfln	TRUE
nhhhgcglkbiob	TRUE
nhjbfahglodom	TRUE
obhmpflgklelb	TRUE
objobjcekgakp	TRUE
omcndmjehnlpi	TRUE
omdakohhfcnbh	TRUE
pfpfmbcianmbp	TRUE
pgdfdpienhmhh	TRUE
aaagiomgdabab	FALSE
aaaiogpipabab	FALSE
ajpjlojdgabab	FALSE
akafmgadbabab	FALSE
beadkhjhjabab	FALSE
beafkhhnjabab	FALSE
boaehegagabab	FALSE
bobloocohabab	FALSE
chlnojgdcabab	FALSE
chmkacbmcabab	FALSE
dcgkmfeelabab	FALSE
dcglgjckeabab	FALSE
dldncdpacabab	FALSE
dleffdcaoabab	FALSE
eeohnbbbhabab	FALSE
eeokhgfecabab	FALSE
epfoccemhabab	FALSE
epfpddebnabab	FALSE
fkgdkaociabab	FALSE
fkkaggmbjabab	FALSE
gfjgibkcbabab	FALSE
gfjhodpiabfab	FALSE
hahnojeagabab	FALSE
haibblmaeabab	FALSE
hlgpldmhdabab	FALSE
hlicciolhabab	FALSE
ighdknlebabab	FALSE
igheeojkpabab	FALSE
jaebjdpepabab	FALSE
jaelfaajoabab	FALSE
jljjnelmbabab	FALSE
jljnpgeaeabab	FALSE
kgfmnlpacabab	FALSE
kghcaibajabab	FALSE
lamdbodjiabab	FALSE
lamedeghdabab	FALSE
lkchaiplhabab	FALSE
lkcjnapeiabab	FALSE
mcpelhkbpabab	FALSE
mcpikapiaabab	FALSE
mmohgciphabab	FALSE
mmonniekiabab	FALSE
nhamcfogfabab	FALSE
nhanegeciabab	FALSE
obiinmncdabab	FALSE
objcipnkpabab	FALSE
olhnfnmikabab	FALSE
olhokokmfabab	FALSE
pfokloimnabab	FALSE
pfpchomhkabab	FALSE
aabddihdgcjgjc	TRUE
aaceajdnlekfhf	TRUE
akdnbniomoicdc	TRUE
akdojcddncjiof	TRUE
bdoaclnablcglo	TRUE
bdojjkidephnko	TRUE
bodfpbkabalklj	TRUE
boelhfjeohhpoj	TRUE
cjnffnbmolblac	TRUE
ckajabhefkmmob	TRUE
ddjmkmbdobjkgp	TRUE
ddkncaapipdimk	TRUE
dnifkjpoikibkh	TRUE
dnkaneomijjdmh	TRUE
ehdapobenbmopp	TRUE
ehdcomhoeombnb	TRUE
fbpmmlbijnlafj	TRUE
fbppgekkgnmobc	TRUE
flfjoiccabfhgc	TRUE
flfpekologkhij	TRUE
gejagfbcaglipl	TRUE
gekaakfhocglio	TRUE
goiohofphljmpc	TRUE
gojkjpfcbkeipd	TRUE
hjljionbnhojbh	TRUE
hjlkiohplkeecj	TRUE
iemjjnkjaopfpn	TRUE
ienobgcpoajkli	TRUE
ioehabehmmmokm	TRUE
ioeljciikbmbac	TRUE
jjhjpneegioofg	TRUE
jjhplojokebkog	TRUE
kdfafanapomfhm	TRUE
kdfijhafgnhlnn	TRUE
knplacmggpjnam	TRUE
koaanjihbekfok	TRUE
lifbbndgkflahj	TRUE
lifbcnebkmomlm	TRUE
mcjjiahjcgnbcp	TRUE
mckdmdficnfhco	TRUE
mnmnalpgogcpni	TRUE
mnndibigknponi	TRUE
nhcokpfieoaidp	TRUE
nhdaaojjndlmdg	TRUE
oakpkddimleble	TRUE
oaofkmldmajpip	TRUE
oljgonhbfkmfob	TRUE
olldkbgcmhkkbi	TRUE
pempgejidfcdfb	TRUE
peobphkkgcfcbn	TRUE
aabddihdgcjgab	FALSE
aaccpeajdnabab	FALSE
akidffkefbabab	FALSE
akifafgmcpabab	FALSE
bdnjnobljjabab	FALSE
bdogdflhfaabab	FALSE
bobbhaamfpabab	FALSE
bobdoancifabab	FALSE
cidodoigdbabab	FALSE
cidpjdkekabiab	FALSE
dddbmmhdmcabab	FALSE
dddeokajloabab	FALSE
dobmnlgpodabab	FALSE
dochgdfnaoabab	FALSE
ehppbaeagmabab	FALSE
eibfbcmfdgabab	FALSE
fcagpmkphlabab	FALSE
fcalcpjmciabab	FALSE
flhpmcklimabab	FALSE
fljcjgmnnbabab	FALSE
gfcimkofkmabab	FALSE
gffeaibkggabab	FALSE
goobjblhgmabab	FALSE
goohohnohjabab	FALSE
hjnfbobpnlabab	FALSE
hjpefchcgjabab	FALSE
iefndgnglcabab	FALSE
iehadnajooabab	FALSE
innkbhgjjgabab	FALSE
inonpcoiaiabab	FALSE
jiknhjfnblabab	FALSE
jilghpjhclabab	FALSE
kdglpgghbdabab	FALSE
kdhbknejfpabab	FALSE
knhlldjgkmabab	FALSE
knhpplfodeabab	FALSE
lijpffgjbgabab	FALSE
likfddpjodabab	FALSE
mcoflfkfkgabab	FALSE
mcokalfnndabab	FALSE
mnbfmmkibabfab	FALSE
mncdjfnldoabab	FALSE
ngmbnigdfmabab	FALSE
ngmdmbdogdabab	FALSE
obicffbbppabab	FALSE
obihhgldagabab	FALSE
olaodkfjkeabab	FALSE
olbmoklglmabab	FALSE
pfbfihofhiabab	FALSE
pfejhkkekfabab	FALSE
aaaaechflibpfdc	TRUE
aaalpiajidjnbdo	TRUE
akahjmlmkcfdomj	TRUE
akbamomfobabhml	TRUE
beeeadpinbelkik	TRUE
begkdppklfgalle	TRUE
bonnebhpncaeamh	TRUE
bpbbgbddikknmil	TRUE
cjibjnppmnahahi	TRUE
cjinmdmlchhiokf	TRUE
degdhahkclecohf	TRUE
degkdbbnandoecm	TRUE
dopojogfheipieh	TRUE
dpajmhlbjmfifli	TRUE
eijcdbaekelfeec	TRUE
eijcnhoheclnaeo	TRUE
fblbegajihnmdjn	TRUE
fbmeclagadlbeei	TRUE
fmdjnhpkocfeggo	TRUE
fmdmpjmmoccojle	TRUE
ggccabbckofggjn	TRUE
ggceplnpcefonhe	TRUE
hacdfffihkefpgm	TRUE
haeahcdonomijho	TRUE
hkfgafiifnhjmon	TRUE
hkfnlkndhmachkn	TRUE
iejaebkloinaogi	TRUE
iejmdbimldcfbpm	TRUE
ioiapdamklkpebd	TRUE
ioknlncenhldobc	TRUE
jihacfjgaokpemi	TRUE
jihgibfnkolcnmb	TRUE
kdccepglbhdmkdh	TRUE
kdcnfokikcaajej	TRUE
kmmfigljjjaaoea	TRUE
kmnalkggolhchah	TRUE
lhflimdjflkcghl	TRUE
lhgpdnefppbaegl	TRUE
mccoodpajhdngfg	TRUE
mcddgokoclcelie	TRUE
mmlffapekgollmn	TRUE
mmlffikpkncbpli	TRUE
nfkfeehcejcicge	TRUE
nfklkmmcdolkmlf	TRUE
oafmolnjkcgajmb	TRUE
oahckinijlnphcg	TRUE
okpidikfefdfadc	TRUE
olbdebdkjndpnmi	TRUE
pffcflbnidohama	TRUE
pffjgahcbgcllmg	TRUE
aaaaechflibabab	FALSE
aaalpfdcpiabiab	FALSE
akahhcncpbfabab	FALSE
akamfplpbdiabab	FALSE
beepmjjbikfabab	FALSE
beffpilhlhlabab	FALSE
boheldiamedabab	FALSE
bohmflncfdiabab	FALSE
cilllaepnioabab	FALSE
cilnaokaamnabab	FALSE
debdoonepfnabab	FALSE
deblhfdihkdabab	FALSE
dpamlnlgmjcabab	FALSE
dpbbjflcfdlabab	FALSE
eihlcgmagheabab	FALSE
eiigcpimbfpabab	FALSE
fbgbbgeplnkabab	FALSE
fbgjcfaaofgabab	FALSE
fmbipeidgaiabab	FALSE
fmbnhenilehabab	FALSE
ggkhlgmccdbabab	FALSE
ggkjbonclcmabab	FALSE
hachemabegajiab	FALSE
hadhmdjnencabab	FALSE
hlaflmmdjkeabab	FALSE
hlaipdgpmcgabab	FALSE
ieogpfkbkicabab	FALSE
ifaapilbgkpabab	FALSE
ioliomfcblfabab	FALSE
iolkhkfcoppabab	FALSE
jjagileeebcabab	FALSE
jjakglijkhfabab	FALSE
kdefbcejggdabab	FALSE
kdefhhohnniabab	FALSE
kncedgcjkbcabab	FALSE
kndceafabbkaabo	FALSE
lgohdladmonabab	FALSE
lgojboiomcgabab	FALSE
mbgjlmifhnoabab	FALSE
mbipbmlddfbabab	FALSE
mmdbonhhakeabab	FALSE
mmddpeefbddabab	FALSE
nggajpgajboabab	FALSE
nggbmedkkpkabab	FALSE
oafibapglbhabab	FALSE
oahdmkdhfokabab	FALSE
okoffbbajfnabab	FALSE
okohajgcloaabab	FALSE
pfplnaphiefabab	FALSE
pfpncannhpjabab	FALSE
aaaipaabppedhhlj	TRUE
aaapcohbihbfkapa	TRUE
ajgklaohanmailmc	TRUE
ajhcekmiglggoabk	TRUE
bdakbpkopkjegpbo	TRUE
bdalafhmfjgcopol	TRUE
bngpckajminagino	TRUE
bnhggcdbcdmjphje	TRUE
chgjkplkpidaocmj	TRUE
chgnnojeomafoghb	TRUE
dbggdgjejdjgkagj	TRUE
dbhngknagpnhkjlo	TRUE
dlkienojbmbkpfik	TRUE
dllgggjpkpfooeeg	TRUE
eghocfjlappnkpej	TRUE
egigakeljdhmekdp	TRUE
fammiaklbfiggebg	TRUE
famnmmlfiapmimip	TRUE
fkdlloinpjfmafih	TRUE
fkgiclbebhplbndi	TRUE
gdpcpgbcanhhjjki	TRUE
geagcdmhcjnhepgf	TRUE
gonnepiigbmjdake	TRUE
gpadocdcpkabnihl	TRUE
hjdkfipkpojfgedn	TRUE
hjfiepcapfldpbad	TRUE
iegcknpljkhbagbf	TRUE
iegelepmeabbcgpg	TRUE
ionejojdfeoeiggo	TRUE
iopjpoaecfnbaikh	TRUE
jjinkmbbmgkcbmgg	TRUE
jjkenopijnaionhf	TRUE
kdlmjbmomkkfbkgb	TRUE
kdlncogllepdlmpd	TRUE
knpabfciemkigkof	TRUE
knpkjomniepamhkn	TRUE
lhehgddcgdohjine	TRUE
lhenoadkelbkhdkm	TRUE
mbhbaiehcpahejid	TRUE
mbhbgnddblabcgja	TRUE
mklkljjmhpbafmlf	TRUE
mkmokbibfmfhokpg	TRUE
nglhojhcakodadpb	TRUE
ngmenphomdbfbbog	TRUE
oalijhkkbdffbkin	TRUE
oanokfjobkmkpakp	TRUE
oljeohgdehafhfjo	TRUE
oljkppknccogabpf	TRUE
pgfbklamealhjbjo	TRUE
pggpjlihhphhnghl	TRUE
aaaipaabppedhhab	FALSE
aaapljcohbihabab	FALSE
ajheegbgijepabab	FALSE
ajieihlcbimlabab	FALSE
bdjaapdpmjoabdab	FALSE
bdjmafgffccabcab	FALSE
bnjdpjbipdpoabab	FALSE
bnkbgopckejgabab	FALSE
cghpcjemgmdjabab	FALSE
cgijakobbbleabab	FALSE
dbbhmfdbhelkabab	FALSE
dbbiadfomnmpabab	FALSE
dlcibnjpnhahabab	FALSE
dlegeeeidghfabab	FALSE
egjbnofaifljabab	FALSE
egjhbkemfckhabab	FALSE
faihbgdiacjpabab	FALSE
fajhmikcceemabab	FALSE
fjmdepmhmddabfab	FALSE
fjmikfpbecpnabab	FALSE
gfbjfodafibiabab	FALSE
gfblebjahpbiabab	FALSE
gpgakabhnbbgibab	FALSE
gpghbobcelheabab	FALSE
hjbpdobbpgepabab	FALSE
hjcapegmhomeabab	FALSE
iebddanddpfpabab	FALSE
ieecfmohjhbaabab	FALSE
ioingjkknpdhabab	FALSE
iojcgaedpgpfabab	FALSE
jjpfmiejpijfabab	FALSE
jkaibepbijnaabab	FALSE
kdfmhhjfhccfabab	FALSE
kdfnfncaplpbabab	FALSE
kneihiibkafkabab	FALSE
knfkpfjkaneoabab	FALSE
lglifcdiknkoabab	FALSE
lgljjbceaapdabab	FALSE
mbfpopdadhknabab	FALSE
mbgdjdfbohcmabab	FALSE
mlmnbghgdamlabab	FALSE
mlmnnjljddjjabab	FALSE
nfpageahlomgabab	FALSE
nfpciooanmpjabab	FALSE
oajfmjobkihnabab	FALSE
oakcghodnabfmoab	FALSE
olkfphiljpphabab	FALSE
olomfpepfjbpabab	FALSE
pgapjjakdlcdabab	FALSE
pgbcbfogjidgabab	FALSE
aaacjganagfkbdpco	TRUE
aaakajppgcgkggakk	TRUE
ajngbodkmddhbdgib	TRUE
ajnjgnpbjdnhkmcfc	TRUE
bdgkdfpmogggflkdm	TRUE
bdhfajnibnclkkfbk	TRUE
bngbnnmahhaafcoaa	TRUE
bngdgjgblbiefklfk	TRUE
chdnfaclpfpioknea	TRUE
cheddlbcchadjlaco	TRUE
dalnjfmjnnapmbmfe	TRUE
damkekjjifkccnjhk	TRUE
dljkkkilcehacelhd	TRUE
dljmhfidjppcblcco	TRUE
egcfodmffcffiolim	TRUE
egcpjkkomgmcglceg	TRUE
fadagpocdibfjjjdj	TRUE
fadiligjmeloccfdh	TRUE
flebhodcegcmfhhji	TRUE
flgdeooghbdjjlaap	TRUE
gfjlfjcbploogefgm	TRUE
gfkdfjedjcpbagkbc	TRUE
hacnbbeeofebdadnk	TRUE
hacpeockblonjooek	TRUE
hjoklngjbnocnhcac	TRUE
hjookggkhljdaagfm	TRUE
ieakkjeedfkpjalfj	TRUE
iedflbpdfbfhlfkpk	TRUE
iojnghbjjobladfpi	TRUE
iokdflfiekphbeepb	TRUE
jjdnjbdijofalgfid	TRUE
jjgmigdcghdfjbcko	TRUE
kdmhoheejlnbmkmmd	TRUE
kdnbgifdlkaeafblh	TRUE
kofcmnecmcaghdelm	TRUE
koffoaiobjhmdogfd	TRUE
ligomfjdmekahahlh	TRUE
lihgjicimeolhejic	TRUE
mcbfjlglhncbnbgdj	TRUE
mccahiomoafppdkoj	TRUE
mnbjpoehhceacalnp	TRUE
mnbmpmkehhoicmgmd	TRUE
nfnilmloodopinnkm	TRUE
nfoanejommedclgkh	TRUE
nompmplilbaalikif	TRUE
nondbgpjkmpgbfmmm	TRUE
okeibmoingihceapi	TRUE
okeonkeaegheogkbm	TRUE
peflamffdedjpjdek	TRUE
pegagfgcegoecbjej	TRUE
aacpcpokkniciabab	FALSE
aadangnedfbpiabab	FALSE
akbghgbgpmabfmpab	FALSE
akbpgbplajchjabab	FALSE
bfabmimcaodmbobab	FALSE
bfbedcpimbffcabab	FALSE
bpclklgohphfcabab	FALSE
bpdiplamoeekfabab	FALSE
cjpklfllkmeddabab	FALSE
cjpojomnpldhmabab	FALSE
dfibhcmopodikabab	FALSE
dfihojajlgffgabab	FALSE
dpjnjpejcenhnabab	FALSE
dpmidgafbbkikabab	FALSE
ejokgfeoomhjjabab	FALSE
ejolnknldilfbabab	FALSE
fdllnonmabgojjoab	FALSE
fdlmeepgmcoicabab	FALSE
fogcfjdilabckmkab	FALSE
fohlcpocgjeodabab	FALSE
gjfkebklcnhhdabab	FALSE
gjfphkgmkgdipabab	FALSE
hdfldhddgoeclabab	FALSE
hdfndlgcdbcbiabab	FALSE
hngehheifekcabpab	FALSE
hngpejkggohcjabab	FALSE
ihnemmcabhdkholab	FALSE
ihnfpiigliaenabab	FALSE
jakdodhdhpolmabab	FALSE
jakkccaimagokabab	FALSE
jkhoodbmlmckgabab	FALSE
jkhpanodlkbhnabab	FALSE
kepmabfohojbnbkab	FALSE
kepnpebmiaocbabab	FALSE
knnjaimfdgdicabab	FALSE
knnjpnmkhpkkkabab	FALSE
ligooimhljolgabab	FALSE
liibhdlkijmlfabab	FALSE
mblaaiccbfpmaabab	FALSE
mblnejdbahfalabab	FALSE
mmdjcniobhbheabab	FALSE
mmdlnhjgpfpkeabab	FALSE
nglkmnadcodknabab	FALSE
ngmjejfjeggghabab	FALSE
obompjmdenejabfab	FALSE
ocaempchleifoabab	FALSE
omdkfmbkpcafbabab	FALSE
omdnggblhddonabab	FALSE
pffihkllhclnpabab	FALSE
pfgbdhghkpnbmabab	FALSE
aacpcpokkniciangne	TRUE
aaddfbpipijbfbclie	TRUE
akdomlmdilcgmabofj	TRUE
akebbcleeljjgfbekk	TRUE
benpldcefaobdegkjl	TRUE
beoimmhjfkkodpnpjm	TRUE
bopegncehimmppcpfl	TRUE
bopfckeapcdhalodnl	TRUE
ckjogaacdldgbjkdmb	TRUE
ckknimggnabcgjepeb	TRUE
dgaknbgfgmdpcclnlo	TRUE
dgankgfeoomhjjnknl	TRUE
dpiiddmdigfnmnmcln	TRUE
dpjcdbjmbaocbibiam	TRUE
ekefpfjpeooolhchdo	TRUE
ekfkiahninmodpbebn	TRUE
fedbammopjndancnoe	TRUE
fedpflnflbcfpnpglc	TRUE
fofljeiiogikclpgej	TRUE
fogklmcjlkcpickpef	TRUE
gjgakhnddoafhnbifp	TRUE
gjiagkakpipdlkbabk	TRUE
hdonigjaadclpkdplf	TRUE
hdpkgpjgmamccbmcbo	TRUE
hnhlnohdhghlfloobk	TRUE
hniblejmmjobjjpabo	TRUE
igkpdpgjbghnhhicoa	TRUE
igkpkplpofflkcbpnn	TRUE
japjohhjkdddhojgoe	TRUE
jbaddoajppkpchljbf	TRUE
jkkcnkpmpoedogeadg	TRUE
jklgffjfamiffjibob	TRUE
kebadfagcegddjknfm	TRUE
keebbncbcepbhpmnec	TRUE
kmoncdknfnmaagjpln	TRUE
kmpdpoglleepnglkef	TRUE
lhhengdmomggiihoik	TRUE
lhkbihkodahafpncaf	TRUE
mchefjiegobkamlcen	TRUE
mciigkdbmnbjpakdog	TRUE
mlphnljbghiahnmodh	TRUE
mmdnklhdgkajjlopjg	TRUE
nggoceomboioigalcb	TRUE
nghahiconpjhnnbjdo	TRUE
ocdcdnnkbdfidhhdhe	TRUE
ocemefkomcpdbhcgim	TRUE
ombdepkhaiepndafal	TRUE
omchaomnjjgjminbpk	TRUE
pfndonibjmdlknkcfm	TRUE
pfpdiopbfjninkkcdg	TRUE
aaagchonlojopbabab	FALSE
aadbofcjehphbhabab	FALSE
aklpiffjkjdlplabab	FALSE
akmkchliemafdhabab	FALSE
bfaoggljigenpiabab	FALSE
bfcmpiflfhanmdabab	FALSE
boimnldellkobeabab	FALSE
bojigmamkncbloabab	FALSE
cioajabinkjjabfkng	FALSE
ciobdnkpckijheabab	FALSE
dcomlfadnicbmfabab	FALSE
ddadojecoemhnmabab	FALSE
dnlebklopgefeaabab	FALSE
dnlfkdcfgniggnabab	FALSE
ehkimmbdllckkpabab	FALSE
ehkmcmdpbghangabab	FALSE
fbhienfechjokfabab	FALSE
fbiclldglbajekabab	FALSE
fnaajelhgafnpnabab	FALSE
fnbiphdpembokcabab	FALSE
ghnbdkmddfgpjjabab	FALSE
ghoadjflmhmbbkabab	FALSE
hblphniaddlllabmab	FALSE
hbmppmlhnhaeokabab	FALSE
hkkdhagbpnoldjabab	FALSE
hkmkcliimifhpdabab	FALSE
iechkjohomiceoabab	FALSE
iecidoilinbeikabab	FALSE
iofajmghhennjiabab	FALSE
iohabmifhdjmidcabo	FALSE
jjgampecjgjlhjabab	FALSE
jjhadappkmhkmlabab	FALSE
kdmeflgljcpdebabab	FALSE
kdngjilbohnaicabab	FALSE
kopkkadfibbilnabab	FALSE
kpaldjnaffipfabkab	FALSE
ljpdhoppchalknabab	FALSE
ljpfboknjgogbmabab	FALSE
mdjniaolhcaedaabab	FALSE
mdkffkfamomipaabab	FALSE
mmelkkhbplkoimabab	FALSE
mmemicoabjpijemaab	FALSE
ngengidhhmhhepabab	FALSE
ngfcmcnafknofaabab	FALSE
oaepjjpdngmmghabab	FALSE
oaheocppbdopdbabab	FALSE
olepcpbcmodopaabab	FALSE
olfbdiepoifmhoabab	FALSE
pfggbipojgkcfcabab	FALSE
pfheomkamabdfildab	FALSE
aaahoohbgkagaplkoin	TRUE
aabfcmbkpidhmmkkiek	TRUE
ajepbpjabkjfamnhodn	TRUE
ajgoojgikekjomfpdef	TRUE
bdgbldonmkionaplboe	TRUE
bdidfmbekjmhhnnfnco	TRUE
bodcollpacfdpejjfgc	TRUE
boedakceodljcgmlpac	TRUE
cjaapccacbeilpliboa	TRUE
cjailokkplifomggdpl	TRUE
ddbbomahflkchagmlll	TRUE
ddbceookjbokbeekmoa	TRUE
dmplogoehjmcdocghli	TRUE
dnaafmecepadclgddgl	TRUE
egolgjbmnffkhejafai	TRUE
egolgklpiiaanckclal	TRUE
fbbjmfoilpdmkekgpdp	TRUE
fbdbclkffbgnmhhfojj	TRUE
fjplnnocfiknbhpcbgm	TRUE
fkaiimbhdpaonplgiba	TRUE
gehldjkhblncagopajo	TRUE
geifebknofhibcjbano	TRUE
gndcdfpokcijgnfkpim	TRUE
gnfkplemckjaikiadkb	TRUE
hhifmdgbihnnklbhfok	TRUE
hhjnfiekddblencnefe	TRUE
ibodbohffeopoabdkcl	TRUE
icbadgpnhignljaabce	TRUE
inbhekdfmglnjoifacf	TRUE
inbkhlhklnegbeckppc	TRUE
jhfkejjjbcjjkinfckd	TRUE
jhgbleilgkjjgcmimde	TRUE
kbjmojgbkpfpmpabjko	TRUE
kbjohcfdmiaomnagdch	TRUE
klgdkgfnbhmfjfimfkm	TRUE
klglgikbgdohjbhbfja	TRUE
lhelkmijnjfmcabinmi	TRUE
lhfeiffogaolmaekndc	TRUE
mbdfgnekifgipdggiim	TRUE
mbdkcfnbijjkghcpnjl	TRUE
mliaiibbpilclhchaog	TRUE
mlikommocnkdpmcdgie	TRUE
ngbihdbmpblipoccomi	TRUE
ngckalihgkcpgpmgeog	TRUE
oafapkljlpaijnoghji	TRUE
oajannflndnpgpcnbpn	TRUE
okcpnfjblgidohmaoif	TRUE
okegkmbacjkgeknfkaf	TRUE
peinbkaonjnfppkhkdp	TRUE
pelmgnapdflgjddgebc	TRUE
aaacoecipblnmiiabab	FALSE
aabbcdikphbppkcpgab	FALSE
aklhhaaimfmlccpabab	FALSE
akmeehooolbhjmeabab	FALSE
bdkgdlhpcpggkinabab	FALSE
bdknoofmkaodmgiabab	FALSE
bnfopppljbkaaolabab	FALSE
bngijbgbgeaabjbhjab	FALSE
chgnbkheaikahciabab	FALSE
chgpglkaajambmlabab	FALSE
danadddfpidfkhmabab	FALSE
danaggbdkclooldabab	FALSE
dlbnflnccbabihbniab	FALSE
dlclpkidgpffjnmabab	FALSE
egkhkocfjmhdmmgabab	FALSE
egkjbhdbhlmaaccabab	FALSE
fbiaobmhhhgkhcabiab	FALSE
fbinckifaibfapeabab	FALSE
flaohceljmpjffgabab	FALSE
flapnllaklnemlpabab	FALSE
ggpfcngniedbjpoabab	FALSE
ggpfpjhepoajahmabab	FALSE
hanehdkbecallhkabab	FALSE
haoapacdeihdbjbabab	FALSE
hldnkhgakpbbigeabab	FALSE
hlecfibnjcbnkdfabab	FALSE
ifhnkgmkbdhnhhoabab	FALSE
ififafnbkggljcdabab	FALSE
ipbkmmakcjelblgabab	FALSE
ipchejekhejodekabab	FALSE
jjafmcpjpbeladeabab	FALSE
jjdanpnhfaofppeabab	FALSE
kecemcoiilpkeonabab	FALSE
keckkidelefmlddabab	FALSE
kobhninlllbeamlabab	FALSE
kociholcbcokjhhabab	FALSE
ljapaefekojfiddabab	FALSE
ljbdjkflopheaffabab	FALSE
mdgmlcmgieapgelabab	FALSE
mdhooeeinecfljjabab	FALSE
moolbgbilhbdipiabab	FALSE
moonkifmkjlffgoabab	FALSE
njgfaiankngjagkabab	FALSE
njgghabhoenlndnciab	FALSE
odkninkdddbakdjabab	FALSE
odlbjelpnlfijdiabab	FALSE
onfcigdfcoolbhjabab	FALSE
onflakjhakjfogiabab	FALSE
pggbbapfdpaiejjabab	FALSE
pggjfgpdomibhbnabab	FALSE
