aaajgghhmb	TRUE
aacicjdknb	TRUE
ajoegfejpl	TRUE
ajoghjheoj	TRUE
bdgpfmpimc	TRUE
bdhggclogi	TRUE
bnhnnomeff	TRUE
bnjaldbjge	TRUE
chfcjmjbgl	TRUE
chghjaegoe	TRUE
dbkhfnmdep	TRUE
dblkdcpehm	TRUE
dmkdbpmhdd	TRUE
dmknfmaemb	TRUE
eibgdikiaf	TRUE
eiebpaphnn	TRUE
fcdkionngl	TRUE
fcebhenlcd	TRUE
fmhlkodkll	TRUE
fmidmhloek	TRUE
gglkfblgkj	TRUE
ggnoppgood	TRUE
hbeflpjcog	TRUE
hbfhflilhc	TRUE
hkffionmjd	TRUE
hkgimepmbc	TRUE
idnekfkenl	TRUE
idnmhpogdc	TRUE
iohajncjfn	TRUE
ioiglnabgm	TRUE
jijhohcdmg	TRUE
jijlialchd	TRUE
kekmmonkge	TRUE
kekpmfmnoj	TRUE
koogkopeaj	TRUE
kooknkeagg	TRUE
liaigocgbh	TRUE
liamndhgmo	TRUE
mdglelbohl	TRUE
mdhkllhnae	TRUE
mngbfeeedc	TRUE
mngjmpjblj	TRUE
nhkngiehje	TRUE
nhlfmfiihi	TRUE
objmeepnai	TRUE
obkhiihmjl	TRUE
onddhaejde	TRUE
ongdaeepbg	TRUE
pfpobmlhja	TRUE
pgadjndlmg	TRUE
aaajgghhmj	FALSE
aaccjdkndi	FALSE
ajkmigaoma	FALSE
ajlifkidan	FALSE
bdchfmhhob	FALSE
bddclndefb	FALSE
bnengjdjib	FALSE
bnfomeljlb	FALSE
cgjefglgbb	FALSE
cgjlaipbjb	FALSE
dbjemmlcbb	FALSE
dbjmhpfggb	FALSE
dnfbokebfa	FALSE
dnfceddbpb	FALSE
ehojebcnhb	FALSE
ehonamooea	FALSE
fcfnhofobb	FALSE
fcgakmoefa	FALSE
fmnfmkbcmb	FALSE
fmoilnllaa	FALSE
gheioddoaa	FALSE
ghemcdhama	FALSE
hbbacmahfm	FALSE
hbbalkpfeo	FALSE
hkbpcfomeb	FALSE
hkdgepbaja	FALSE
iecomlpcaa	FALSE
iedplcgbaa	FALSE
inkglobfcb	FALSE
inmbhpdlbl	FALSE
jiobpnkhfb	FALSE
jionglhdbb	FALSE
kfbeddjaja	FALSE
kfbkebgido	FALSE
kocoefjhbb	FALSE
kodaaogbdb	FALSE
ljcgoimlaa	FALSE
ljdbfababb	FALSE
mdlfommama	FALSE
mdlmeakmfa	FALSE
mnfgamnbib	FALSE
mngfplpnbb	FALSE
ngnioighaa	FALSE
ngoamhlkca	FALSE
ocadokocca	FALSE
ocafifhdea	FALSE
omhhlenkbb	FALSE
omilliifbb	FALSE
phhlkncmbb	FALSE
phkingkpaa	FALSE
aaajgghhmib	TRUE
aaccjdkndhb	TRUE
ajnpemggfpp	TRUE
ajocckegdgp	TRUE
befljmafaib	TRUE
befmgaigmje	TRUE
bmpfimcicgm	TRUE
bmpocakgijk	TRUE
cglcnkmppdf	TRUE
cgnadnidhng	TRUE
dbjjpdihlai	TRUE
dbjmaajgohb	TRUE
dmlcomblaei	TRUE
dmleejmmfpb	TRUE
ehickgamccl	TRUE
ehidonbapko	TRUE
fcfdfjmafnm	TRUE
fcgcbopfllf	TRUE
fnmaoigollh	TRUE
fnoiiboogkg	TRUE
ggmdenciini	TRUE
ggmnbpofdoh	TRUE
hbhpgooidah	TRUE
hbhpldpfalg	TRUE
hkkabkdegfh	TRUE
hklakjibpmo	TRUE
ieogjeaciof	TRUE
iepglbncddc	TRUE
ioajbghcfno	TRUE
iobgnnelpkg	TRUE
jjiamkpecpn	TRUE
jjileagbadl	TRUE
kdmmcdehjch	TRUE
kdmndolpbjn	TRUE
komcobndgpi	TRUE
komghihmfli	TRUE
lkfdmjmhnhf	TRUE
lkfimjfjiim	TRUE
mdlhmfjodjb	TRUE
mdljjmiopgp	TRUE
mmmhfgepmdi	TRUE
mmnhhpoicam	TRUE
nhndijanego	TRUE
nhohbmkkcpo	TRUE
ocklcfdbcjh	TRUE
ocmjngeeghi	TRUE
ombgjjelimf	TRUE
omcjhehhngh	TRUE
pgkjlbpkoff	TRUE
pgkoikgjgpe	TRUE
aaamnckekce	FALSE
aacdjbinemb	FALSE
akhehoebnbh	FALSE
akhmkgclmda	FALSE
bdcfekdakea	FALSE
bddiijahapc	FALSE
bnoibbicgpk	FALSE
bnokeannoea	FALSE
cjagkdkpbob	FALSE
cjbmnijfana	FALSE
ddmcfepahai	FALSE
ddmpmnhghaa	FALSE
dnidjbooieb	FALSE
dnigdhaejda	FALSE
ehjnoejnada	FALSE
ehlofjgojaa	FALSE
fchbipojmeb	FALSE
fcibhmialga	FALSE
fnafhgkkjga	FALSE
fnbbcgdogmk	FALSE
ggpickjeobb	FALSE
ghacjodajcg	FALSE
gppkoljjebb	FALSE
gppmokfldbb	FALSE
hjnmlndigaa	FALSE
hjolfnfggaa	FALSE
ienffapebob	FALSE
ienppmiojaa	FALSE
iohdondelaa	FALSE
iohekpobglb	FALSE
jiejdainpja	FALSE
jifnkangcfa	FALSE
kcbbcpbbiji	FALSE
kcbnneindob	FALSE
klmdiadidja	FALSE
klmdooldeaa	FALSE
lgcmkgidpbb	FALSE
lgcoaohkhla	FALSE
macmfemkkja	FALSE
mahbpeagbhb	FALSE
mlfpfccfdbb	FALSE
mlhijhfdlbb	FALSE
nfohhboaoda	FALSE
ngbbgdpkdln	FALSE
oahgecibljb	FALSE
oahlgonfena	FALSE
okobmfjlnpb	FALSE
okppmamklpa	FALSE
pgbniikfcjb	FALSE
pgcjhdfokbb	FALSE
aaamnckekcdb	TRUE
aacdjbjofmmn	TRUE
akfknoknglee	TRUE
akfpahhbmdha	TRUE
bealmoekpnpk	TRUE
becfemkfhink	TRUE
bogmciiikgpd	TRUE
bogmeegjhcai	TRUE
cjdhbghnjofc	TRUE
cjghaobopajf	TRUE
ddkkpmcbddha	TRUE
ddknkpmhgcec	TRUE
dnmongbnlghp	TRUE
dnofklpaoanb	TRUE
egnakdmbgfjf	TRUE
egomicidjjlh	TRUE
fcfjdhidjpih	TRUE
fcgpbncpabna	TRUE
fnbcapkkoamb	TRUE
fnbmfmnkhham	TRUE
ggbfooejefhe	TRUE
ggbkfmagnfdi	TRUE
gpmhbpinkjnj	TRUE
gpoflncbhimc	TRUE
hkciicedkcjd	TRUE
hkfblkkjpfpe	TRUE
iegmfffnnklg	TRUE
iekghdocoplm	TRUE
ipckhmaeddcg	TRUE
ipcnbppmonoo	TRUE
jidhpflecacj	TRUE
jiebecalgcjo	TRUE
kcclijhoigch	TRUE
kcenofnjbnlm	TRUE
kliidmggmfec	TRUE
kljfojnnlnje	TRUE
lfodbilkdlpd	TRUE
lfoigjapbfch	TRUE
maaihmhepcgb	TRUE
maakpghgncob	TRUE
mlfilhfhfjja	TRUE
mlfjdkcdokff	TRUE
nfobpcikgnch	TRUE
nfoogbkjfieg	TRUE
oallehbfffnd	TRUE
oaofeechjhnc	TRUE
oknhhenecmpj	TRUE
okohbfkekfeo	TRUE
pelpjoojagnc	TRUE
pemaonkicifc	TRUE
aaaeegmnajbb	FALSE
aabakpnknkbb	FALSE
ajnchikgkdla	FALSE
ajnjnjoongda	FALSE
beafmppbblki	FALSE
becfaemghbgb	FALSE
bnnopofbffjh	FALSE
bocbefondopj	FALSE
cihpdmkmjgaa	FALSE
ciihaadkggip	FALSE
dccceihgijaa	FALSE
dccgeabhpmhb	FALSE
dmaeiaeiadek	FALSE
dmaepoahokfn	FALSE
ehddfhbpghdb	FALSE
ehfbgknpkjfb	FALSE
fcbgmjbpmgai	FALSE
fcbjhgeciilb	FALSE
fmaijfkhmeha	FALSE
fmanabbfchaj	FALSE
ggmddhgkibaa	FALSE
ggmhnppdpeaa	FALSE
hbcnnodlnnpb	FALSE
hbeajgapdihp	FALSE
hljpoemndcaa	FALSE
hlkcccdodaca	FALSE
igbiplbkdpnb	FALSE
igcnnainfkda	FALSE
iphhhlhmmibb	FALSE
ipjnmdejfmbb	FALSE
jjmejnibanga	FALSE
jjnilkodjfaa	FALSE
kcmddhhgchaa	FALSE
kcnlmhpjojaa	FALSE
kmmnbgleaobb	FALSE
kmnfjfbcbidc	FALSE
lhibklffknkb	FALSE
lhifmgofgobb	FALSE
mciigffbmhbe	FALSE
mcikjilajbob	FALSE
mobieijahjpa	FALSE
mobofimnabnb	FALSE
nhjbnhoaeoma	FALSE
nhkmkbfokmbl	FALSE
occofiphflbb	FALSE
ocefkinjfaah	FALSE
olpcbfmgmonb	FALSE
olpclnicdgaa	FALSE
pgedenkfekbb	FALSE
pgekkaniabeb	FALSE
aaaeegmnajbak	TRUE
aabololdecilk	TRUE
ajmejkhkbkmap	TRUE
ajmgfgahopgbe	TRUE
bfefglppjnonf	TRUE
bfgekmlmjegig	TRUE
bocgfolkgfmeh	TRUE
bocggjpkhepae	TRUE
cieamjbidkogg	TRUE
ciecfjcnmleea	TRUE
dbjlohpgioljd	TRUE
dbmnknanagccb	TRUE
dmdekjmnmkdck	TRUE
dmdpoccnbmlfg	TRUE
eidljpgddnedh	TRUE
eigbmkdcfnkdp	TRUE
fcchfjhhmenle	TRUE
fcebpifdoncic	TRUE
fmfnbknnabklm	TRUE
fmgaphcageobl	TRUE
ggdmanellieej	TRUE
ggenanigbdmje	TRUE
hbadpgebjejcl	TRUE
hbaehlkpimoni	TRUE
hlifdongppdfh	TRUE
hlilnjhngijhk	TRUE
igdiacdgmjbee	TRUE
igecmlgjmabmc	TRUE
ipfafaejombhd	TRUE
ipjkelklceidk	TRUE
jinfeokbggeco	TRUE
jiomncomefnab	TRUE
kdlebnicfkjma	TRUE
kdmbldojgjikk	TRUE
knacgcinbfdai	TRUE
knadgdmlmopmf	TRUE
lhmhiaoaoilcb	TRUE
lhmhjmhjecdmf	TRUE
mdanhkkamcdhb	TRUE
mdckblmjccmaj	TRUE
mobokkgmepcgi	TRUE
modalkhlomcnb	TRUE
nijkpacgiajnb	TRUE
nikaeodmkelec	TRUE
ocgkdngkpkige	TRUE
ocicboimdcjje	TRUE
olhjbcemdjfgc	TRUE
olimpeffdakde	TRUE
pfnklgfpkdcfj	TRUE
pfnlebjjdolcn	TRUE
aaaeaafnahhdo	FALSE
aacfhdleodnhd	FALSE
ajpdhejdkofka	FALSE
ajpgfkopidgpa	FALSE
bepmoedplafda	FALSE
bfadkigidlnia	FALSE
bphhllfliibod	FALSE
bpieidfbdbijb	FALSE
ckdaimabmcnpb	FALSE
ckfhkjijdegbb	FALSE
dfebgnomjfjeb	FALSE
dfejbhmjpnkgb	FALSE
dolniocekpibb	FALSE
domdcdlkbipeb	FALSE
ehllicjhknoaa	FALSE
ehlmbfbbcfckh	FALSE
fbfffdidigfdb	FALSE
fbfnngclaajcd	FALSE
flabmbfinoocm	FALSE
flhecanldbcnb	FALSE
gfpllbgmcikmb	FALSE
ggafejlafblcb	FALSE
gppbkpmfimeaa	FALSE
gppcgidblicdb	FALSE
hkecbmahgogka	FALSE
hkgilgbhhhkib	FALSE
ienohljcjjdbb	FALSE
ieogfjgieeibb	FALSE
jahingfkohdja	FALSE
jahofhhpindla	FALSE
jlnmkcoplifaa	FALSE
jlpggnmfdkpbb	FALSE
kgadkgjbbnblp	FALSE
kgbcgpnldnkdb	FALSE
lagelnfeobieb	FALSE
laipcnpoojlea	FALSE
lknifhhidmlaa	FALSE
lknjjiplfopbb	FALSE
mdnlhcnmhjpaa	FALSE
mdoghdljmidaa	FALSE
mnbihmnfjeibf	FALSE
mncmphnkajkfa	FALSE
nhedhedikjgbb	FALSE
nheklbiadipha	FALSE
oblmmnajfgabb	FALSE
obmdpooacdjha	FALSE
oligjhinenobb	FALSE
oliifcilmikaa	FALSE
pfllopmjolpbb	FALSE
pfnjlpobfjmfb	FALSE
aaaeaafnahhdnb	TRUE
aacfhdleodnhcb	TRUE
ajnjmlpgcklhon	TRUE
ajohjkmecanfdb	TRUE
bfglgamlfbmooh	TRUE
bfhgfghmnklami	TRUE
bpkoajhokeieid	TRUE
bpkplfjplajokn	TRUE
cjpmfohfmpmmng	TRUE
ckaamiokglnmeb	TRUE
ddpipbdnofgkkc	TRUE
dedheplckgncen	TRUE
dohhhhmdlehjkf	TRUE
dojlcaomkgkldf	TRUE
ehnpdbephkklfe	TRUE
ehokgkaobjfcgc	TRUE
fbjflkcadkgekn	TRUE
fbmmnepabnhaab	TRUE
fldphmeepphinf	TRUE
flfllidhhgjlck	TRUE
gfllbifnpfakep	TRUE
gflmckpkindkch	TRUE
gpoohemlmmomeo	TRUE
gppcljgbkmgffj	TRUE
hkmbhkoofjmhak	TRUE
hkockefdacafab	TRUE
igcgjckdicpbkn	TRUE
igdnmnjllfckhf	TRUE
jahiflnbjcdmlk	TRUE
jaiggiaeaccjmb	TRUE
jllkbdhijjjgki	TRUE
jlmmpdkagcmglg	TRUE
kgkjgkehadfngh	TRUE
kgkpojneckekfp	TRUE
lahgacbcjcjdld	TRUE
lahlfiaalmjoab	TRUE
ljojmgcommhfkn	TRUE
ljpjdnihjmilgk	TRUE
mebefcgdldenka	TRUE
mebfcnjmoncill	TRUE
mncnpjfnakhcec	TRUE
mndpcfhbcadleo	TRUE
nhpfljodopjifg	TRUE
nhplcgbldjlnha	TRUE
obhpljoapogjjo	TRUE
obikjpfhlpjeej	TRUE
oknmkchgocbiif	TRUE
okpieplpfdbkkp	TRUE
pfbcpilmlgepdl	TRUE
pfbgijeglhceak	TRUE
aacmilghfgkfln	FALSE
aacpphccahgplk	FALSE
ajlejioomddima	FALSE
ajnehhkdbimkkb	FALSE
bdmbfpdmlojncl	FALSE
bdmmhkldiggdgb	FALSE
bofpenfmbfeoel	FALSE
bogmhljcpgdoib	FALSE
cignlaemhboecb	FALSE
cihinlbjmeknaa	FALSE
dclgiadgcpmjea	FALSE
dclhienedaakoo	FALSE
dmpcbdpchimljb	FALSE
dnacpkpejhpdbb	FALSE
egmapdckmkojbb	FALSE
egmhcmpfjjfpbb	FALSE
fcbmdohnaboipb	FALSE
fcdajgaamookpp	FALSE
fmolmemmibjglb	FALSE
fmomgnifmhhhbb	FALSE
gglnpbgfopgecb	FALSE
gglpllcdodbigb	FALSE
hailhjaeaedhbb	FALSE
halgmnpinpngia	FALSE
hkhjdmbdlckbbd	FALSE
hkjibjofnjplmb	FALSE
iedigolckoicbb	FALSE
iedjidhbjjkana	FALSE
iokjdaojmgekae	FALSE
iomibjidojmjdb	FALSE
jjhppogkjfpkaa	FALSE
jjiepncpfeacbb	FALSE
kdmgdpfcpjdlbb	FALSE
kdmglmgiiijoaa	FALSE
knblfdomanelae	FALSE
kncfbehcejcnmb	FALSE
lgmjplicbllflb	FALSE
lgpahgnhgemika	FALSE
manhofidjbaibb	FALSE
manidcmadeiclc	FALSE
mlbcbjdoepjodf	FALSE
mlbfjenhjfopfb	FALSE
neochpelpmhnbb	FALSE
nfbjjegldggolb	FALSE
oalekknkbceplb	FALSE
oambicnfabjneb	FALSE
okmjhbhhggdopb	FALSE
okmlbcginihpaa	FALSE
pfapigojmakgnm	FALSE
pfbebfbaiipecl	FALSE
aacmilghfgkflmb	TRUE
aacpphccahgpljb	TRUE
ajmdchoioebpipf	TRUE
ajnaldefnbkfnop	TRUE
beipfchnpfheing	TRUE
bejdieldcdlegko	TRUE
boapijgkgokicci	TRUE
bocggjaoalpbnhh	TRUE
cjbdppfeeehmfjp	TRUE
cjbjckhjoiehigj	TRUE
dcpekedlbnadlab	TRUE
ddbioidfcijjplf	TRUE
dnglgaakhgfcgab	TRUE
dngopmpbmfjgabk	TRUE
ehokabpjpikanoj	TRUE
ehpgaamookpokcb	TRUE
fcdofnghacjhbeo	TRUE
fcgfnibahcfpnll	TRUE
fnackpciilfacnb	TRUE
fnappbkhgnnkmal	TRUE
ghjgnhklngnjjon	TRUE
ghjjeileeekppmh	TRUE
haijfnmmailmapb	TRUE
haikifmnkoaldlb	TRUE
hkgclallhpgcjci	TRUE
hkhfecgajlclije	TRUE
ifocaemkeomhjip	TRUE
ifolfadompmkiop	TRUE
ipdahpcjdmdfhab	TRUE
ipdifceabmfmkkh	TRUE
jjbalfddenehndk	TRUE
jjdmbmkkamjibgh	TRUE
kealioegfpnlhlp	TRUE
kecclafnheglinb	TRUE
kmnhgaaeoomdjbg	TRUE
kmnjccddkcngkeb	TRUE
lhopanhijpclcke	TRUE
lhpgmgncibnopdd	TRUE
mbfmfllfkjgoeha	TRUE
mbihcflcdekfioe	TRUE
mlfkepifbigpimm	TRUE
mliaojmdfhpdmfl	TRUE
nfbdadcgljajhlb	TRUE
nfbehmjkpcjelkf	TRUE
oalllhepnbcncff	TRUE
oamdbkdahmlhlic	TRUE
olgoofdikocmgba	TRUE
olhhiioakpoobim	TRUE
pfkehilnnkappld	TRUE
pfkhbghlpfkieak	TRUE
aaajaiffjopkhid	FALSE
aabjjkkdipjncpb	FALSE
aldibljadaajjbb	FALSE
aldmmdgdhabmgfb	FALSE
bfhhoaokakkpdkc	FALSE
bfiagldpemeiiea	FALSE
caajjmjfnpecibb	FALSE
cabammbocliiiib	FALSE
cjpmallkcbljghb	FALSE
cjppkpdgcfnidbb	FALSE
deljknedefmania	FALSE
demcaakcboipabb	FALSE
dpnefjjdhhokobb	FALSE
dpnpgojnninhbdb	FALSE
ekdmchjcjfaeeac	FALSE
ekephghpfhnegaa	FALSE
feelpgfehiejoaa	FALSE
fehbfdnkoedcabb	FALSE
fnheladiobdfbib	FALSE
fniaomidmpjjfla	FALSE
ggnbpcocgfofjib	FALSE
ggnfinocpdmfbob	FALSE
hachghpfalkmkco	FALSE
haecmpbbkdopfnp	FALSE
hlicgaejbilbfcf	FALSE
hliemcneefeniaa	FALSE
ifinmaigkfihbnb	FALSE
ifjlbjbholncohp	FALSE
iobciblifpnknck	FALSE
iobhcokbnlpgpbi	FALSE
jkabkdflejgokhb	FALSE
jkcldjehojaacaa	FALSE
kchklemlamlanfa	FALSE
kchpccnfpbippjb	FALSE
knahbaoegcojgbb	FALSE
knapmleblnkjlob	FALSE
lhmpdekhhbjbgmf	FALSE
lhpahnjdkfbkkmb	FALSE
mccgllgfiamnona	FALSE
mcffdfdobejbnfl	FALSE
mlmpcdegpojhnaa	FALSE
mlnboajademenmd	FALSE
nfikffbmokmomnb	FALSE
nfjphggemlghgaa	FALSE
npoaoeaceefgaca	FALSE
npojepmejimhfaa	FALSE
okbfhkfifknadca	FALSE
okdbebbpmdlcajb	FALSE
pfclneeeopgplaa	FALSE
pfeegeoeckkgdaa	FALSE
aacgoebglogijojg	TRUE
aacmojhinophglob	TRUE
akighanpmhjagddb	TRUE
akjfbnpaaijjgbhp	TRUE
bgcfedmadakbmiig	TRUE
bgcflljepmkleiom	TRUE
bnpjhehaoikdnkie	TRUE
bnpncgkadenpponb	TRUE
ciacnmgaoofhlbmm	TRUE
cibfifcddaigibmd	TRUE
ddimhopghciciabg	TRUE
ddjcoclmcdajdbod	TRUE
dnpmcjnclidecdjl	TRUE
dnpmelckgcbjhdio	TRUE
eifoakkgpnnmahpb	TRUE
eigmhgobnccdaiik	TRUE
fbippopfmklmdiek	TRUE
fbjfaaackfcglkhb	TRUE
flogoijmnkhihfpb	TRUE
flohfpgnndcmckhl	TRUE
gfgjmagbmlfniimg	TRUE
gfgpgkbhmoakncoj	TRUE
gpoiloeanpemomab	TRUE
haahlkblndlkdlfm	TRUE
hkgkpglbhagpikfe	TRUE
hkiiogmkdilkbmhe	TRUE
ifbifneeamabkmoe	TRUE
ifbpeaeolkhfeffh	TRUE
ipeliiincelbigpm	TRUE
ipgaaimlbmfofmch	TRUE
jjhbeifecfkffiem	TRUE
jjihjedoffakkefm	TRUE
kcbpmghckfipnmhc	TRUE
kcchfggmknpnofif	TRUE
kmimabfeceklllgf	TRUE
kmimdpckafnojpgj	TRUE
lgfbjngoahegbaci	TRUE
lgfiaamfgeopijcb	TRUE
mbkfhjedfabjjaoa	TRUE
mbkghkcpdomknmhe	TRUE
mlmfjkafanpnafdb	TRUE
mlmlmgmhplicodpa	TRUE
ngfhbdfomldpkdlc	TRUE
nggfkannlaaoaiob	TRUE
oagidmdijgbicomh	TRUE
oaglklagcpnhaggb	TRUE
okbinddommagbljj	TRUE
okccdfegcfcnmlnl	TRUE
penjmempbgnddgdm	TRUE
pfaapliagificlhb	TRUE
aacgoebfknfhinjb	FALSE
aacmfojhinophglp	FALSE
akjdbbacmgnoddpl	FALSE
akjgciipmennfadk	FALSE
behfmfiocidcoebn	FALSE
bejldmimekomlpmb	FALSE
bnoklfkfhbghnpcn	FALSE
bnpmpflkikbikclm	FALSE
cihngbmbhflhcend	FALSE
ciibfpodeoimopjb	FALSE
ddmebleppdckgonb	FALSE
ddmgbfkiangfmhap	FALSE
dnoogkboeggegeaa	FALSE
dnpffalgelnagdcl	FALSE
eiacncgfgpibocpb	FALSE
eiamoaffnkmmpfbb	FALSE
fbhbhealbmgecgla	FALSE
fbhiggeejanonlia	FALSE
fmdijddpeegcnebb	FALSE
fmebpfjcipkcfnmb	FALSE
gfiakgenlhbfcinb	FALSE
gfiklohmgdmkagea	FALSE
gppknonlfkodebcb	FALSE
haablnalogngcmbb	FALSE
hknidcbipmigpaoa	FALSE
hkopkbldfnbchlij	FALSE
ienldoflkinnplaa	FALSE
ienmdhochimeneaa	FALSE
ipgnbkbkfmhiodmi	FALSE
iphfkfalobdkkcbc	FALSE
jilaekppmnigjija	FALSE
jimipkpieppdloaa	FALSE
kcfmlbpiccnlhikb	FALSE
kcgejmiacgljlnia	FALSE
kligglokafnhnola	FALSE
kljlfnmakbnjakbb	FALSE
lgfmpmllkcfinlaa	FALSE
lgghgmppkaadcode	FALSE
mbbgclchlhneinfi	FALSE
mbbheepidnmffcne	FALSE
mlmgjdpkmgknffaa	FALSE
mlmmegacmlmoeiha	FALSE
ngbjeegjihhblocc	FALSE
ngbkndillnphkenb	FALSE
oahoamfjghehikik	FALSE
oaijfhlemdlecjia	FALSE
okhgihefmlggoibb	FALSE
okhhhoeflhacnona	FALSE
peoggpfpjehcmeaa	FALSE
pepkapghhhkidhpa	FALSE
aaankabionjpmimcg	TRUE
aaboepejhampmaajh	TRUE
ajolnijbaoienfipc	TRUE
ajomdoabipodfdikg	TRUE
bfmlnmccjpgghgikh	TRUE
bfnehankaddfckpgb	TRUE
bpaeefffkpbhfcfma	TRUE
bpaiipmfmflbffnmf	TRUE
cjckjgnfdgebhopij	TRUE
cjclflpgglfdfcojh	TRUE
ddbolapmdmbmdllgf	TRUE
ddcamghdoakdemlmb	TRUE
dmknhpbdjcjcncdag	TRUE
dmlaknbfncfloignn	TRUE
egceaogllpnaecpab	TRUE
egckghoodmfaomdbl	TRUE
fafejdfgelhoahnhb	TRUE
fafekehikcihfmhab	TRUE
fipgdmifijofhppbo	TRUE
fipjbcamkkicldcom	TRUE
gecciihhajeijgakb	TRUE
gedhmlhjicpdjhhnf	TRUE
gojanfkapalmbkjnn	TRUE
gojejgdapikcadklb	TRUE
hilkicpoceikgofic	TRUE
hilkjmleehngibkgh	TRUE
idcoelbcipkjgenmn	TRUE
idcpggolhobmaanfb	TRUE
imgobdnkokioaalob	TRUE
imikdlbfadfhbkmlf	TRUE
jifjoomcflanboacf	TRUE
jihgnccjlefdgeebe	TRUE
kcgjnmjebleeofpdp	TRUE
kcjnmbhmkndeliafb	TRUE
kngbhchhieehfgnea	TRUE
kniaegbkdinpflmmi	TRUE
likhabacnenbmhama	TRUE
lilkmjpkmcfilkhoj	TRUE
mdcocccldjmblcjgc	TRUE
mddjgngfpkmodpahp	TRUE
mmpnfhkhiejeiffpp	TRUE
mnaegonaleapaebfc	TRUE
ngnchekicmjimnppc	TRUE
ngngjeghdjbpjoilo	TRUE
obgnfklpmmjjaboca	TRUE
obhmknoidjacnmnbh	TRUE
omjffpennacncfjkf	TRUE
omkggmgeindgepjck	TRUE
pgmfbikcfijfhhjkh	TRUE
pgmlfgceaagdapeeb	TRUE
aaadanknaaghfmjjp	FALSE
aablmmonjpoflmpgb	FALSE
akieneifljgkjoiga	FALSE
akihobaldocijcmbb	FALSE
bekikibbchnpclhjj	FALSE
belkoobpoapageade	FALSE
boklhhmkoidalbfmb	FALSE
bolojpfdnpjkohbpc	FALSE
cinlmdjgkpbhfcnkb	FALSE
cioalghjdapmifhdf	FALSE
dcmmogiafggmjgfla	FALSE
dcnddmgepejaknlga	FALSE
dmkicncfkolhkngbb	FALSE
dmkkddjniejcadika	FALSE
ehnbbabigbiapkace	FALSE
ehpjkmjkfhladmlma	FALSE
fdkiinbllmemcjfbd	FALSE
fdlakfdfbebdjjfhk	FALSE
foehmlmhelijljaga	FALSE
foejkehabiebdpcbe	FALSE
glbjjhipfjkgapnia	FALSE
glceoflfkfigmimaa	FALSE
hedjlkhmanmlggioa	FALSE
hedkkeinadbgbkjoe	FALSE
hoopkboaeljgejdja	FALSE
hopigeahljehpnoka	FALSE
ijiicljlfcbelhgkb	FALSE
ijjaimbcodcjkbkpc	FALSE
jdlhidkcobeaeehma	FALSE
jdljdphdiebnignkb	FALSE
jobekeijglejcjpob	FALSE
jobfkccgkoimeegob	FALSE
khdlkfogombjpklcb	FALSE
khdmgbjajffjdkkla	FALSE
lajpiedlhgoaigile	FALSE
lakbbojjijblpgpia	FALSE
lkjnkcbnkilmmjidb	FALSE
lkkiogodpbdgodnfb	FALSE
menhfcmkinioaemla	FALSE
menjdchhgmjaehmoa	FALSE
mohddljdnboolejgb	FALSE
mohhcegelgkmcpibb	FALSE
niaopenlkmdighcfa	FALSE
nibiobffnenpgekjc	FALSE
ockgplelnobllmfkb	FALSE
ockjadkmcpajogobb	FALSE
omhbnbcenhlhbpfll	FALSE
omhdkcaembhkdiabb	FALSE
pgdfhipfgilfhocaa	FALSE
pgdmjkjanpcohneca	FALSE
aaadanknaaghfmjjob	TRUE
aabmnpokpgmngmjele	TRUE
aknelpgdpploephemj	TRUE
aknicoeccokmllnhdf	TRUE
bempjpacfehhkdoihp	TRUE
beniojfdjaiofbadnk	TRUE
bopoijpakekecaohib	TRUE
bpaaigebcmgoephglg	TRUE
cinlnibnpfknpkagdc	TRUE
cinnkilhkfnhjbnjci	TRUE
dcmmgdkofbkckipjap	TRUE
dcnkmgaekjccieahcb	TRUE
dnciggejgnglgfocbi	TRUE
dndpimgnedhdakpdjk	TRUE
ehpelnldoodhbemlmc	TRUE
ehpjckogimdlecbkgp	TRUE
fcpndkleadbhgmjdip	TRUE
fdbacnihcnpiinjefi	TRUE
fofnanamokgfknjahb	TRUE
fogppjdhpalapacinb	TRUE
gjlihandbkmkpldhaa	TRUE
gjloiemichjncahmcm	TRUE
hefkcackfjglnnleli	TRUE
hehgbohhelhgnddgei	TRUE
hoehgcionlimolckhd	TRUE
hofbipaandiaeclmcb	TRUE
ijibalkbeonldhanjn	TRUE
ijjkobgiihchhalefh	TRUE
jdgmogmodncegphmgg	TRUE
jdhealmaakkpjagakb	TRUE
joaeaeckekpkbckdjc	TRUE
joahobinhgnglhpigd	TRUE
khllppjcacbpdemcgk	TRUE
khngabjnohimjfklgj	TRUE
lakbkhkmnijchegkfm	TRUE
lakopcmepnkhhebmdh	TRUE
lkgjmkpmcaaejeonbl	TRUE
lkgnckifmhgncjcbda	TRUE
mekgallleonklhocoh	TRUE
meknnblodnanigocfg	TRUE
moeiadjpkgdobnholm	TRUE
mohcfgldbjikfmjemf	TRUE
nicdekeigdfedaidil	TRUE
nicdilcpdjnkcmjdoa	TRUE
obepicdmpfamgfiapb	TRUE
obhcagcelimmlepdno	TRUE
olpacgpbjigcfolcpl	TRUE
omajknadbgcmganphd	TRUE
pfialdecoledeomjfi	TRUE
pfjhbfaojccmbogipi	TRUE
aabllkmmbccfhlicab	FALSE
aabmbebdcifekeikfb	FALSE
aknkhnnjijhbignokb	FALSE
aknobfipmjnidngceb	FALSE
bfkoohlfekhakpojda	FALSE
bflkgihacmahmaemig	FALSE
cafmobodigibgchlpk	FALSE
cafphdnnjfondpepha	FALSE
cjmoboecgelkfancbb	FALSE
cjnanhohmdkhgeokpa	FALSE
deiljhneoeibmgehib	FALSE
dejbhgmhpdmolpokpb	FALSE
dojnkdehacfmplhhma	FALSE
dooknjjbfghkpdfogb	FALSE
ejhjilackppncnjmbb	FALSE
ejibmoojmkdodagmja	FALSE
fepapokhfdjkbgkemb	FALSE
fepnhjhicjgjpdabhb	FALSE
fopkgngnfjpfmjfbmb	FALSE
fpaacjeplbjifibkan	FALSE
ghpfcgdbbilecmeepl	FALSE
ghphpcleihnfcaaikn	FALSE
hcnkpkncgiloebgglb	FALSE
hcoaaajnkighmjnjpd	FALSE
hmmfiaidgccbdhgifb	FALSE
hmnoohjmlkcpnehoaa	FALSE
igkimmphfigljhpnaa	FALSE
igkppcjkonnginilaa	FALSE
jbdahnckomljpjmhfa	FALSE
jbdlappepffnjniena	FALSE
jlojglebcdbofbonfj	FALSE
jloognfphjempcmmbb	FALSE
kfhgbnnklelclcdflb	FALSE
kfjeobgpdnkiikfiib	FALSE
lbfhhanjpjpgpheija	FALSE
lbgeogpmdickhbfidn	FALSE
lldefmnapamlhnkinn	FALSE
llffapmmbhbmlcpfck	FALSE
meohjjhajbfkalkdbb	FALSE
mepjojjbabdfonpbod	FALSE
molkohbbegholjmbjp	FALSE
molokgkedjjjbmahfa	FALSE
niimebccifhpdlonfb	FALSE
nilgkcfdgblhmemgfb	FALSE
oblbkcpfhopkjmabcp	FALSE
oblccjcipidonaloja	FALSE
ombhbbbmanklcgphnn	FALSE
omcdoaehpmklffgdha	FALSE
pgbihiikgagcmkmioa	FALSE
pgblenoigjedmhingb	FALSE
aaaaalidfeklopopolb	TRUE
aacagmabjmndclfhmil	TRUE
akliocmbiioimielmjc	TRUE
akmihoejhbcengkoied	TRUE
bfpmofjijflmhflfchg	TRUE
bfpnjndmdhdknjfmkcg	TRUE
bpgdajnnalcdaeafbkc	TRUE
bpgkongldaoinjhahbe	TRUE
cjhcaakglegedlnofcb	TRUE
cjhckpnmfhikkhmomnj	TRUE
ddlphonmpdcefohhkkl	TRUE
ddmanknmllfaabmmfmg	TRUE
dnjfdobfelpehpifkhh	TRUE
dnkgfnalbmddhdciaoa	TRUE
egdifahjogmojmhnili	TRUE
egdlfblngajcfeekokj	TRUE
famhmcdgedlfdbhmfec	TRUE
famkabfchplhakllnki	TRUE
flehlhckigpghacheab	TRUE
flekflkhfldofafbhio	TRUE
geklfphalfbhpgogeon	TRUE
gekohffgkfnbpamlfab	TRUE
gnpmmjgfjhelbheodag	TRUE
goafjopbccalkgobjkf	TRUE
hjdnabhhaoahjabgdon	TRUE
hjdndfndadcflagkhmb	TRUE
ieeaclnlgopcalkgcbn	TRUE
ieeojaenanjclinijgb	TRUE
ioflckpfafgdphnafhb	TRUE
iogicdmeenmaoheifnn	TRUE
jiemanaflcolhkahknb	TRUE
jigpkfigfbidmhmjeoj	TRUE
kdahkdachkdeljkpifb	TRUE
kdbaccaehefhjndbpnl	TRUE
kmlfnhhploiljnlljmg	TRUE
kmmjdjcekelpgimojhp	TRUE
lhcjgaacgekgmfdjmib	TRUE
lhcmdeeidmbladnmipc	TRUE
mbgjeldencnlcfajfoi	TRUE
mbhjiknenejhedllgep	TRUE
mlppjdhdlfnniikmgfo	TRUE
mlppochleidhemnaggg	TRUE
nghicnfgcpbknmphfdj	TRUE
nghkadgdadmofgpjdnb	TRUE
ocjedkdmelcbgloiphn	TRUE
ocjemliekceaookjphd	TRUE
omlffmebmoimehiggke	TRUE
omndcfhbojohdnokeao	TRUE
pgjiljppfbdanhmcdko	TRUE
pgjkenhfgnmceldiaff	TRUE
aabcmpgpdflblmijcoo	FALSE
aacdkmlfokkfmgfikah	FALSE
akpmkgecfmadlkimfmc	FALSE
alaonpealiikfciogoj	FALSE
bfeceiijdnanjnnbkdb	FALSE
bfendiieohcdeajilea	FALSE
bohjkpbhgfhebmehljf	FALSE
bohldjkamclgnhfambb	FALSE
cknjdnipehdipmfbonb	FALSE
ckpffodhflkmcleohaa	FALSE
denoglmkibifjcknpeb	FALSE
deodkdadbfbihnmejhd	FALSE
dpgiknphmiahghflnoa	FALSE
dpgpkjlhmehfjapilla	FALSE
ejhdkamodgbdnlfjjbi	FALSE
ejhkihgmoomahmkpcna	FALSE
fdbnokoikajjkjodcha	FALSE
fdbpnkccigppiiadfpa	FALSE
fmhkabenfbiibcelamb	FALSE
fmhlokjbbfjljcldilo	FALSE
gglegegmjcpeecjfdbb	FALSE
gglghbhpkloadiphcna	FALSE
hahgbfhbonhniljhcam	FALSE
haighkflknokchokhbb	FALSE
hkfcjmohbipmnlookcb	FALSE
hkfpedbamdihffdabeb	FALSE
ifflhaagkloochkkobb	FALSE
ifgcadfegammjdphmcj	FALSE
jajkojcfnbnijjipomb	FALSE
jaknoipblldhaapkgbb	FALSE
jkphladiicopibbigml	FALSE
jkpkbjafopejkjpndia	FALSE
kfcggnlakapeckoclhj	FALSE
kfcggohmmidbnigdkaa	FALSE
kojgbknphdofdhbkjep	FALSE
kojglhjkheefpjejlbb	FALSE
ljbpbpdijcbeacilnch	FALSE
ljbpganjhdfomanljod	FALSE
mdmcakobklgpnefplnb	FALSE
mdmpgogcdagnlmlpbeb	FALSE
mnpfffgilildgpomeaa	FALSE
moaaibibgkiipokaelh	FALSE
nhnhcppejfokgnbdlcb	FALSE
nhnllegommlahfkmkpa	FALSE
obcbhaabjnkeglhhhdj	FALSE
obcielkamnamolajojm	FALSE
olbcaipdkjjkiifmfia	FALSE
olbhmfcdefhomcajjpa	FALSE
peneaejbpimkaemmabb	FALSE
pepnmkclifladfefmka	FALSE
