aaaanoleeb	TRUE
aaaoebojda	TRUE
ajfogiolih	TRUE
ajhllpmcnd	TRUE
bcpggbijel	TRUE
bdbacfpnhg	TRUE
bmpenhiikl	TRUE
bmpijlegfd	TRUE
cipmmbfccc	TRUE
cjandfmcmk	TRUE
ddkooegfab	TRUE
ddlbdgihho	TRUE
dofdiadokd	TRUE
dogdpkldhl	TRUE
einihbamkh	TRUE
einkbeajog	TRUE
fcfohnagcf	TRUE
fcihcigpdp	TRUE
fnedkkampl	TRUE
fnfedonenl	TRUE
ghmppcehnb	TRUE
ghncbjpgkp	TRUE
hcholfgbdj	TRUE
hcjanjkofk	TRUE
hkpbklakmo	TRUE
hkpmbdhnno	TRUE
ielcpgbaoj	TRUE
iellihcedl	TRUE
ipmlpdlclo	TRUE
ipooipljne	TRUE
jjjclblbac	TRUE
jjjlajnmcb	TRUE
kdihbmcmfa	TRUE
kdjenjajln	TRUE
koedbgoild	TRUE
koedgcajki	TRUE
lijhbokeib	TRUE
lilmbiiegm	TRUE
mdjcjnnooi	TRUE
mdkloipepd	TRUE
mndhidcmni	TRUE
mnegfiaiej	TRUE
ngedpjjcpd	TRUE
ngefhanmbp	TRUE
obcnbkpdag	TRUE
obffglobmn	TRUE
omjkfkbhej	TRUE
omkgeoimlg	TRUE
pfjcpcjdoe	TRUE
pfjiadeejl	TRUE
aaaanomfff	FALSE
aaaoboabab	FALSE
ajgpfoceca	FALSE
ajhnjimpia	FALSE
bdbphkdaha	FALSE
bdcjfoheaa	FALSE
bndlpgdama	FALSE
bnemoglbaa	FALSE
cjknjpgbaa	FALSE
cjlablgdab	FALSE
ddgmmnidaa	FALSE
ddhnoljkaa	FALSE
doakbbabab	FALSE
dobicgfgaa	FALSE
eiekhecpaa	FALSE
eiepjneeaa	FALSE
fcjbnheoaa	FALSE
fcliokjkaa	FALSE
fmmpmclnaa	FALSE
fmoahhhofa	FALSE
gigbhdclaa	FALSE
gigeglhlaa	FALSE
hbdollicaa	FALSE
hbekdcgoaa	FALSE
hkpchnlfaa	FALSE
hkpefgaoga	FALSE
ifncmhhhaa	FALSE
ifnkhcjdaa	FALSE
ippieeieaa	FALSE
ippindknaa	FALSE
jjmkflmpaa	FALSE
jjoibloiaa	FALSE
kdgdbgnmaa	FALSE
kdgndgbdaa	FALSE
kofiokiiaa	FALSE
kofjlfciaa	FALSE
liibkfmafa	FALSE
liighmefaa	FALSE
mdekckmaca	FALSE
mdelpknama	FALSE
mneifaimga	FALSE
mngaaimmki	FALSE
nglgmahcga	FALSE
nglmlcnala	FALSE
oajhbeabab	FALSE
oakaicnlcd	FALSE
olhilahjma	FALSE
olhjocggaa	FALSE
pgejhjefaa	FALSE
pgffnehnaa	FALSE
aabaejgphnm	TRUE
aabffpakffd	TRUE
ajnfickbeej	TRUE
ajojdoekmob	TRUE
bdnakjpdcgf	TRUE
bdphlknefje	TRUE
bpfecohdeok	TRUE
bphbdnhccpp	TRUE
cjfjbecppol	TRUE
cjhjbclbdjp	TRUE
dcinipnfdfa	TRUE
dcjaiaihofb	TRUE
dmpjoojlnfn	TRUE
dmpkpbiamoo	TRUE
eheehhfblhd	TRUE
eheigegphka	TRUE
fbimbndblpk	TRUE
fbjbopipole	TRUE
flhgjjaajmb	TRUE
flhmaofmghi	TRUE
gfldaeahcdb	TRUE
gflemlkhmoj	TRUE
hacfmapmceb	TRUE
hachogjkgjm	TRUE
hjgicnabcad	TRUE
hjgmfeonkpk	TRUE
idkhnigegno	TRUE
idmmkhcmpkm	TRUE
iofgnoilede	TRUE
iofinbbmffc	TRUE
jjebicgcehi	TRUE
jjfbhgcelpb	TRUE
keaipafjamb	TRUE
kecchfbceha	TRUE
knehadlppbi	TRUE
kngibiljipl	TRUE
ljmechjgflm	TRUE
ljmgbechnig	TRUE
mebekfdbijb	TRUE
mecdafaoaeb	TRUE
moncphaeooe	TRUE
monmgfohpdl	TRUE
njmdlmpiffm	TRUE
njmflgpehif	TRUE
odccgnejggn	TRUE
oddeipgfhip	TRUE
omeekhgiapi	TRUE
omekakafclb	TRUE
pglamkglmeg	TRUE
pgndklcenao	TRUE
aabadjgphab	FALSE
aabfmofpabf	FALSE
ajofnbfabab	FALSE
ajomfnhncma	FALSE
bdldkmbipaa	FALSE
bdlhokbmdaa	FALSE
boonknbbcaa	FALSE
bpbiebmicaa	FALSE
cjcglbcolaa	FALSE
cjckhkaegha	FALSE
dchaoiomila	FALSE
dchfbifnala	FALSE
dncphgbeapa	FALSE
dndflcacgha	FALSE
ehodjmbhgaa	FALSE
ehodllkkfaa	FALSE
fbeifollbaa	FALSE
fbfiogbmmaa	FALSE
flkogjgpmaa	FALSE
fllenammnfa	FALSE
gfijkglacpa	FALSE
gflfckcnkaa	FALSE
haccniiedpa	FALSE
hacfoameemp	FALSE
hjgflgcmlaa	FALSE
hjgkifgdgaa	FALSE
idjdnboenaa	FALSE
idjgpaieeca	FALSE
inkibadgmha	FALSE
inlapfjlhga	FALSE
jjkkjbkloaa	FALSE
jjncleojlaa	FALSE
keakmmodcha	FALSE
kebgbpgfhaa	FALSE
knfpanjpkda	FALSE
knggmdmamda	FALSE
liomiaalmen	FALSE
lipmelfeiaa	FALSE
mennklgafea	FALSE
mepafcnhaen	FALSE
mphicoakgca	FALSE
mpidmjpekaa	FALSE
njekmobfiaa	FALSE
njfoolpdgaa	FALSE
odeabkgckab	FALSE
odeaggjdfao	FALSE
omieomdnfaa	FALSE
omilopckcaa	FALSE
pgclcpoadda	FALSE
pgdfpdihgaa	FALSE
aaadgjdbaopl	TRUE
aacpmflpjmib	TRUE
akfdkgiomidh	TRUE
akgdnghcdiab	TRUE
bdkddlolahdn	TRUE
bdkejhbgdion	TRUE
bmmficjljbde	TRUE
bmmikmadjahb	TRUE
cgpkgkkpmdop	TRUE
chbaaejamlib	TRUE
dbcepebljcpd	TRUE
dbcioobobgoc	TRUE
dkdnonhbicbp	TRUE
dkffacelmaib	TRUE
eefohemnjdeh	TRUE
eegmllmmhpha	TRUE
enloppaljdcf	TRUE
enmoncddlokb	TRUE
fgiljjlkikbl	TRUE
fgjfdocidjda	TRUE
gbkkonhacccg	TRUE
gbmgdkfpdnfm	TRUE
glmbjillempm	TRUE
glmfkngealgd	TRUE
hgbiagebidfj	TRUE
hgbmmalpokab	TRUE
iblcdnpkeodk	TRUE
iblhhbonhjco	TRUE
ilpcoapoalhb	TRUE
ilphabdfkhjl	TRUE
jgknlpjfojae	TRUE
jgoippefpgfe	TRUE
kcmmjopkpjin	TRUE
kcncpjajfnpg	TRUE
knlkipopnodc	TRUE
knmcbfecdplc	TRUE
lhabejfapgld	TRUE
lhadfbjlhnhn	TRUE
mcafgplfejab	TRUE
mcapfcjiclog	TRUE
mmddcfoochpe	TRUE
mmdlpmljkmjo	TRUE
ngmkenhlcnbm	TRUE
ngnekalhcgcd	TRUE
obefalbjpdin	TRUE
obeihndicmoj	TRUE
olpfmgdgfcfj	TRUE
olphmemandnc	TRUE
pgdkcdfahege	TRUE
pgenepfgfcom	TRUE
aaadgjdbabab	FALSE
aacaoplpngmk	FALSE
akckepkgljha	FALSE
akckldpmacnp	FALSE
bclgnbddkpaa	FALSE
bclkejcnnkaa	FALSE
bmlfbaobabab	FALSE
bmllmjpogoaa	FALSE
cgdbkcgmagca	FALSE
cgdcfaaepaog	FALSE
dbhnmkadhpla	FALSE
dbihifnjjhaa	FALSE
dkaehpgnkhca	FALSE
dkccaobdabab	FALSE
edikbanafneo	FALSE
edjgfcjdcnaa	FALSE
eoakgjdaodpl	FALSE
eobcepedfbaa	FALSE
fhfokflahiaa	FALSE
fhhiglgcofaa	FALSE
gbndhdechfaa	FALSE
gbngciifhlaa	FALSE
gmafajnfnkie	FALSE
gmbeefdcmpaa	FALSE
hhbmjpjhlkaa	FALSE
hhcmbioocfaa	FALSE
ibcfncpabnab	FALSE
ibebjcdpjgaa	FALSE
ileemcgomhaa	FALSE
ilgmjeedioaa	FALSE
jhpehnidbkaa	FALSE
jibcoehoebaa	FALSE
kdcapoaliace	FALSE
kddfhjlnipaa	FALSE
knciinhkfdaa	FALSE
knckdmlammla	FALSE
liekahfcfmah	FALSE
lifapgnmppca	FALSE
mccpnjcnhlaa	FALSE
mcddehhljkaa	FALSE
mndghnopjlaa	FALSE
mndlhngnipaa	FALSE
nhiehonkjcaa	FALSE
nhjnekjijfaa	FALSE
oakpanaiooap	FALSE
oalbhgdnabab	FALSE
oldfddlcfoaa	FALSE
oldhochpepaa	FALSE
pfeckdifhnaa	FALSE
pfegkhjkmmaa	FALSE
aaadgjdbaoplp	TRUE
aacmflpjmiijb	TRUE
akdhcapgdbnbb	TRUE
akepaibndaiai	TRUE
bdknnmkfhfnjp	TRUE
bdlccpddahcgk	TRUE
bngfhmjkmmpnl	TRUE
bngjhgppoajod	TRUE
cgfmlhhhfnkmg	TRUE
cggogcpbbndca	TRUE
dbkjdghpbckjp	TRUE
dbkjjknjjampf	TRUE
dlblnjocghnoo	TRUE
dldpnopkefgol	TRUE
eeeipmajdkkbk	TRUE
eeemjjcnjfooh	TRUE
endojoaidbdoc	TRUE
eneklbmnlfkbf	TRUE
fhbjdplgddhji	TRUE
fhcbpgoaciajb	TRUE
gblmllempmkng	TRUE
gbnalgcohhodd	TRUE
gmjoonlpakacb	TRUE
gmkinfdcdkcjj	TRUE
hghpdieenbpgk	TRUE
hgimkmilgockf	TRUE
ibfcdhjpbegnm	TRUE
ibgejhphcbdka	TRUE
ilmlhdfhhclcc	TRUE
ilmpggdlnenhm	TRUE
jhhfgifggidkh	TRUE
jhifbeoiddomb	TRUE
kchphbehkihem	TRUE
kckfemfnfabkn	TRUE
knkemafinpifk	TRUE
knlicohonnhod	TRUE
lhaghfaikiejb	TRUE
lhaoejldjldab	TRUE
mbjhocdopijbg	TRUE
mbjnjnpgekean	TRUE
mnlhmlimkjbpc	TRUE
mnmfiopcllamc	TRUE
nidemnijdckkf	TRUE
nieoaoakngjcb	TRUE
oamlnhkdmkcjj	TRUE
oanakpoegblib	TRUE
oknkopfgommdh	TRUE
oknocdkikehek	TRUE
pffbnhoococfp	TRUE
pffkpfnkfkino	TRUE
aaebhfganabab	FALSE
aagfjnibmabab	FALSE
akcahbmbbabab	FALSE
akcpgjkknoffa	FALSE
bdolhkeajnpma	FALSE
bdominecajima	FALSE
bnfgkmdaacfam	FALSE
bnfmhllgkneaa	FALSE
chbepkefmjhaa	FALSE
chfmnngngpoaa	FALSE
dbeeopmpmbiaa	FALSE
dbefjogepfjaa	FALSE
dkdcikddmaaof	FALSE
dkdjlgngdanla	FALSE
eepnnadpdpmap	FALSE
efbhnihfkcpaa	FALSE
eoegmdbdlfkaa	FALSE
eoepndmhiobaa	FALSE
fhnfjlplmgpaa	FALSE
fhpiglenhmiaa	FALSE
gcichlepghaga	FALSE
gckchanbkabab	FALSE
gmcnafnendmka	FALSE
gmdalabhlogab	FALSE
hggnfohgekbaa	FALSE
hghhkjommehaa	FALSE
iangipgobabab	FALSE
ianpfaampjcon	FALSE
iljoachfgdlla	FALSE
ilkefliinomaa	FALSE
jfkecohhcpjaa	FALSE
jfkohnfkffmaa	FALSE
jpnkddegdjbaa	FALSE
jpoopgikoliaa	FALSE
kjlnddjcjbhaa	FALSE
kjmanecifamep	FALSE
legmhdjbfoiaa	FALSE
leiebmednlfaa	FALSE
lomdigcdiipaa	FALSE
lonfhngpinbaa	FALSE
mjjagigijmfka	FALSE
mjjhohpbockaa	FALSE
neanhfndjmfpa	FALSE
necccfldjojaa	FALSE
npilefhknkeaa	FALSE
npjhnonmbhjaa	FALSE
ojocbpdhfjlaa	FALSE
ojpcccamjdjla	FALSE
peppfbbmdlbaa	FALSE
pfaalfmhgfpha	FALSE
aaebhfganjfojn	TRUE
aagbbaedakfpac	TRUE
akcogmmcdhldcg	TRUE
akddbkmhmjjpmh	TRUE
bdidchbidefean	TRUE
bdipbihefilbjn	TRUE
bodneibhckahjg	TRUE
boejjbbjbpkdjo	TRUE
chcmklbfjoecdc	TRUE
chdbfigjahmcmc	TRUE
dbjnkfppbefjmi	TRUE
dbkbginelhibdh	TRUE
dldlmbhpbkdmbf	TRUE
dlefbabbnoilnh	TRUE
eedapjodgloeab	TRUE
eednhclfnehdcl	TRUE
eodobgikimaafb	TRUE
eoedechalpiipf	TRUE
fhjiimdolldgik	TRUE
fhkannaocihfnb	TRUE
gblikndbcejblg	TRUE
gbnefjhhecjako	TRUE
gmamibnbbldipk	TRUE
gmdjkijeliioki	TRUE
hgpldncmcpgaeb	TRUE
hhbbeglbbimhaf	TRUE
iainjkpebelgpo	TRUE
iajdpknhkfmmmj	TRUE
ilmgekobligfmi	TRUE
ilofkelimccoja	TRUE
jflpmcakfgmjne	TRUE
jfpdlafpldocih	TRUE
jpjinkeigiafeb	TRUE
jpnbmnaimffiab	TRUE
kjihpangnpbonn	TRUE
kjihppmddlgcog	TRUE
lebkoejdepoghd	TRUE
ledlkjkafemkic	TRUE
lojncecelnajec	TRUE
lojohdppckggde	TRUE
mkbklkmcponlkg	TRUE
mkcfacpjeglnml	TRUE
nekcgbimmlpopg	TRUE
nekgpkkcimojlk	TRUE
npcooijfpjlflj	TRUE
npcpdgbgaibifb	TRUE
okbhpbdlnbdgjl	TRUE
okcklnlapgkicc	TRUE
peiofjdfccmjol	TRUE
pejkhiidgijale	TRUE
aaakeilhenopcc	FALSE
aabphcglclfgab	FALSE
ajjpgmlcmpdpla	FALSE
ajkkppfeaeiajn	FALSE
bdfflnimgehaka	FALSE
bdhkhkadmghcfa	FALSE
bnlbdghhdochaa	FALSE
bnlefeilkfpdaa	FALSE
chjfmapongjacc	FALSE
chkeilogbgiaal	FALSE
dbjaefijcbabab	FALSE
dbjdfkpnccmnaa	FALSE
dlifioiecljkaa	FALSE
dlikiakfeeaopa	FALSE
egakchfohemgga	FALSE
egamkblckhabab	FALSE
eophbaibbcabab	FALSE
eopjllhmepooaa	FALSE
fjkfnicmbhcmaa	FALSE
fjldkamclmecla	FALSE
gdkdpdeblilpaa	FALSE
gdkgcollcnffaa	FALSE
gmldfoepipfgaa	FALSE
gmlibbdgbofmaa	FALSE
hghcdckhhjcoaa	FALSE
hghndmfgbfffaa	FALSE
ibmmmlhfpckpaa	FALSE
ibmpnbagmjigfa	FALSE
imkeonnegmklaa	FALSE
imkoiaobooabab	FALSE
jgjlepdbnjkjaa	FALSE
jglibckccmdama	FALSE
kbpeeppmjiffaa	FALSE
kcbfhnkngcfbaa	FALSE
kmocjffoncccaa	FALSE
kmpbjfjolbaina	FALSE
lgjgbhkjldmjaa	FALSE
lgmcobeioljcaa	FALSE
mbjljebcjelnaa	FALSE
mbmiaagnnjkafg	FALSE
mljadhimpfncka	FALSE
mljjifkbinjdaa	FALSE
nfoimoadknemma	FALSE
nfpglfhkhideaa	FALSE
npkklcgpkfhoaa	FALSE
nplgilmcggamea	FALSE
olflaceapdffkf	FALSE
olfmhmobbgdfaa	FALSE
pfjfekpdnandja	FALSE
pfjhmjpkfgpbaa	FALSE
aaakeilhennobbp	TRUE
aabhcglclfghhcc	TRUE
ajkkibncfdljjah	TRUE
ajlcmfhnojonajb	TRUE
bcenbmdgpjmanio	TRUE
bcenobhibpjdcmk	TRUE
bncplgncmlcnojg	TRUE
bndmbbnehgpfdgp	TRUE
chjljmjppdmdgjj	TRUE
chkhlgicoldbngf	TRUE
dbnofdmmeleaomd	TRUE
dbphbfehpfhlnge	TRUE
dmcljomknflkkbf	TRUE
dmdjcncglfdigdk	TRUE
efjedbfdcaoogdj	TRUE
efkfchgefdnhkgl	TRUE
eolidegoojcfpal	TRUE
eomacjddhineflf	TRUE
fipiddccniolnfk	TRUE
fjbgflcldifjpjd	TRUE
gdkolodaapfldib	TRUE
gdlncldpldbfema	TRUE
gmndnebjgachmkp	TRUE
gmnfjlefkdfdeej	TRUE
hgngiednpmlcicb	TRUE
hgnjkofakiaekpb	TRUE
icdahbcnfgiaegi	TRUE
icddgihgkmkekpj	TRUE
imfeemfddhnamfb	TRUE
imffmjaaacognbd	TRUE
jgnnanglbeknbel	TRUE
jgpdgifnfipkkgh	TRUE
kcfbljplbclghbn	TRUE
kcfcfmkijnegbnj	TRUE
kmfdkidgenmdccb	TRUE
kmfkkjkbhchcjlj	TRUE
lgjcdpadokealhb	TRUE
lgjhlfldkodceob	TRUE
mbibohpkofbeadb	TRUE
mbjdoapadblendg	TRUE
mkjpnnkpmedlpil	TRUE
mklmipgfdkoidei	TRUE
nfelpakfmlhkakb	TRUE
nffndcpcgiojgbp	TRUE
npjkbnjbhfonogg	TRUE
npkadlhcnaopilb	TRUE
oklokdjielonhpo	TRUE
okmbngpkeipcpgf	TRUE
pfgnddokjgobmlf	TRUE
pfhamigbfoppbdo	TRUE
aaafimgghbbabab	FALSE
aacachmojfogaga	FALSE
aipcfeclhhbabab	FALSE
aiplclcjfghnmpa	FALSE
bcnfekkocbaahkm	FALSE
bconfepnoleafda	FALSE
bmjboncajlkjkka	FALSE
bmjfcbnkfoeimaa	FALSE
cgjmkcfeajmnmja	FALSE
cgkdhdgbnefieaa	FALSE
daffmiahldhkcdn	FALSE
dafkbpfkeiabhab	FALSE
dkdpgckokihfgaa	FALSE
dkefpgabmedoabc	FALSE
eebjcdgheoicbaa	FALSE
eecohinbndmafka	FALSE
epblpnlnhannoha	FALSE
epegkpjilnoloaa	FALSE
fjomachobigabab	FALSE
fjpdiijklkdpjaa	FALSE
gefcledecaihafe	FALSE
gefedmghiailcma	FALSE
gpbmabmcokbifab	FALSE
gpbohfhjopkhcaa	FALSE
hjiimfhbfbfkeaa	FALSE
hjjclekndhpnjaa	FALSE
idfikjpdfhcdgaa	FALSE
idfpkcbjmgpemaa	FALSE
indenhjlfahajad	FALSE
indepnodlgeeoaa	FALSE
jhmhodkgpmabeab	FALSE
jhmpmcpomhpolaa	FALSE
kbihammobkmabab	FALSE
kbiipnjnifceama	FALSE
kmcjimjcbidfpaa	FALSE
kmdegmiailkjnpa	FALSE
liecifgnabbnaab	FALSE
liedbobgjkndjaa	FALSE
mccodhaffacikea	FALSE
mcfmmllhhmlaida	FALSE
mmkeloelccmapda	FALSE
mmkollnfnehjcaa	FALSE
ngblpkpnfkafpam	FALSE
ngcjaionmpghjia	FALSE
oaelnkaifbhabab	FALSE
oafjfdbdfajabab	FALSE
okcjhpdkfhikhaa	FALSE
okdikelhajokcea	FALSE
peobpalegkhkfea	FALSE
peoflfalgfcnpla	FALSE
aaabpljhaeifgokh	TRUE
aaadbghgcecffgmg	TRUE
ajfciphjafnbbfkg	TRUE
ajfjhjemaogbnjmm	TRUE
bcheogcdaofiicgj	TRUE
bcicbbfmnnfeeecf	TRUE
bodogjiengfodlek	TRUE
boekaoidlbfmedfh	TRUE
cighekablhflmeee	TRUE
cihcmnfippjdadcp	TRUE
dclbnpcdaoodjgkp	TRUE
dclfmmgpbnjlhlbn	TRUE
dmhgbiddejdfkkgj	TRUE
dmjdflkpbaeidpke	TRUE
ehjjcejodpkknhbf	TRUE
ehkgaicgmbpigppe	TRUE
fbkghiadmjgicnbk	TRUE
fblmnnehgbcbbdgl	TRUE
flpokplolmglpkhn	TRUE
fmbhikhmppnkbmce	TRUE
ggifjnlhfmmcmhjm	TRUE
ggjpiccbkidfhdbj	TRUE
hbaofkalhdbaajjn	TRUE
hbbggkigllpjcjfp	TRUE
hlpgkcopchkopdkb	TRUE
hmachncbompffmkm	TRUE
ifnfmhendfmlpjpb	TRUE
ifpbdfgfjcfbcpnn	TRUE
jbafagmhjeolfnab	TRUE
jbagfdkljdgmhohf	TRUE
jlajgeclihgihgch	TRUE
jlbkdcpmdlifgpdp	TRUE
kggmihjomiaokmbd	TRUE
kggnhehoapnapmbp	TRUE
laphodagfinecemb	TRUE
lbanheadkjmmnefb	TRUE
ljkefppckmdfoiek	TRUE
ljlbpacakdgihahb	TRUE
meaajjiahicfijob	TRUE
mealkfnjbidddmgk	TRUE
mphggkmjihldhldp	TRUE
mpiaphcidoegidjc	TRUE
njlmgnbdlkppkjii	TRUE
njmbobgeifniofkp	TRUE
odalmdhngogcpdgk	TRUE
oddbdonpmbecalkj	TRUE
ondhcpmfgjhlkhgh	TRUE
onfopegengomclkk	TRUE
pggjnfojgjfdbokp	TRUE
pghkfnkopegfccnk	TRUE
aaabpljhadifgoab	FALSE
aaadkhbghgceabab	FALSE
ajengfecakbjabab	FALSE
ajfalnlanbgdabab	FALSE
beadkddgihcocipa	FALSE
bechlnkkhnflceaa	FALSE
bohjppkclhbaflka	FALSE
bohnfjjjbimkgpaa	FALSE
cieoklonfcdkcnaa	FALSE
ciffmkdpplmomcaa	FALSE
dciedljghnkmflaa	FALSE
dcijhfjihkhggjaa	FALSE
dmcmgfaapmcklolk	FALSE
dmfcnkdolfjijfaa	FALSE
egnilljhamfohepa	FALSE
egnoojcjkgijafka	FALSE
fbofiplhnlnkmoaa	FALSE
fbohfbhohcgkgoaa	FALSE
fmbhpdhphlecadga	FALSE
fmeolfomkgdcpfaa	FALSE
ghffgcanphodpgda	FALSE
ghgigmagbfhlabab	FALSE
hbelokeaafipkgld	FALSE
hbfjdimjohaabgab	FALSE
hlnhcemlfgcmphaa	FALSE
hlnjmheibieblnaa	FALSE
ifmjbdbdelpjogaa	FALSE
ifmledhmjifdmfaa	FALSE
jalbikpfhehabnab	FALSE
jalimjjjepfkdmma	FALSE
jkbjmfhimdkbdoaa	FALSE
jkbnfbaijcehneja	FALSE
kfmipjapeankkack	FALSE
kfmokakgmhhmpcda	FALSE
lajpmjjamljgfmfe	FALSE
lakcfnjbdfpbabab	FALSE
lkegdlinpnkpadja	FALSE
lkgafmdhgkjccnha	FALSE
mebkfcnnfclpcmaa	FALSE
mecifcnihohgnoaa	FALSE
mpjmfajgogadfink	FALSE
mpkbcngnfinhclaa	FALSE
njcechollfamknfa	FALSE
njcgdbihmheplala	FALSE
oddnhncfhklpniaa	FALSE
odekkcfecegcknaa	FALSE
ommihdkmoimbemaa	FALSE
omndgoflkpjlmeaa	FALSE
pgmhiocchnhidmaa	FALSE
pgmlmlknbdgmfgaa	FALSE
aaebaeabpgkljemje	TRUE
aaedelichloadnaib	TRUE
akakbbjmofglndend	TRUE
akambhdopoaoekeke	TRUE
bffmjpiieifdbomdg	TRUE
bfgnbjcgodlilkjnd	TRUE
bpomoedibiocmiaoc	TRUE
bppedichbclfpmcin	TRUE
clamocihgpmaplcdb	TRUE
clanpghnakdnfhbam	TRUE
ddmfeghnpnogpfoii	TRUE
ddnnmefpfbddkkkfe	TRUE
dnkbnhpomhaiiajnb	TRUE
dnkfcnohhkkipileg	TRUE
eibepohdhjbipbnhl	TRUE
eidpnpodeinmahpfh	TRUE
fdcalbhnpgbplpjph	TRUE
fddldeldajocfhajb	TRUE
fnmkklkobnjoofiob	TRUE
fnpegagjecblnedpa	TRUE
ghlelngkibbgefmhf	TRUE
ghlpdhpfibmcphdgc	TRUE
hbcgenblcfmbeoici	TRUE
hbecnaiibdlkbelbh	TRUE
hkpfbchlkmnkiicie	TRUE
hkpgckfnpiimhhihi	TRUE
ignakopmjkmfapacb	TRUE
igndglcdfdkdagcbn	TRUE
jackgkjlglfmmodik	TRUE
jadajkpchnnnldmab	TRUE
jjfcpkmknnmajfmkn	TRUE
jjfncdikenlcldmca	TRUE
kcneemeohdfpcbdig	TRUE
kcnigcjckpenipeag	TRUE
kmoclkdgiinjcbebl	TRUE
kmoepinecagfolggo	TRUE
lgiceckkkpaflhcpl	TRUE
lgjcimoodeefjbinl	TRUE
mbmacaollhfloeklb	TRUE
mbmbfojmkpopfkgno	TRUE
mlbemfkeoemcameic	TRUE
mlbofjcokamjiiaob	TRUE
nflffeocgdeagknme	TRUE
nfmklebmaplcpadab	TRUE
oaoapnhaejoclmmdb	TRUE
oaoehgkdbilkangib	TRUE
oklhaipjcllookpkk	TRUE
okllfablocjffjahb	TRUE
peephaicaiegbcknd	TRUE
pefbckgdihkafnimf	TRUE
aaaahlklfbooeabab	FALSE
aabfklpkmdajelbab	FALSE
ajljpmmdlapcjlkal	FALSE
ajnngkfmplafmlmgf	FALSE
bdkppfigmcjeegoaa	FALSE
bdlamcogonjdfkgja	FALSE
bnbnfakbnndipabab	FALSE
bnclgfnkdhlnoehaa	FALSE
cikpcpicadclciall	FALSE
cilpnnhafkgopabab	FALSE
ddclpnefbgjodglaa	FALSE
ddconooibjfiemcaa	FALSE
dmkandfnahpnacikm	FALSE
dmkmboaadckldhmoh	FALSE
ehamhmfpocdefphpa	FALSE
ehbbjoaigdaokkjfh	FALSE
falikljegabjdolab	FALSE
falpijofnanffmheh	FALSE
fjlnpjgkfccfihmaa	FALSE
fjlpjkmpflihlcpaa	FALSE
gdifieljmbcbfhjaa	FALSE
gdkjcjpglhpapdffa	FALSE
gnjpgefnimfallcia	FALSE
gnkgdlhofmcpdkoaa	FALSE
hhmaijlohnmpbabab	FALSE
hhmfambdijoljabab	FALSE
ickjdjcdgakjedpla	FALSE
iclgganhpfhffojoa	FALSE
ingjjccadhkhmagif	FALSE
inibegambeblhabab	FALSE
jgjlgnhdpjjcmelaa	FALSE
jgkcblnnfklajicoa	FALSE
kanhojdifahgpnmcn	FALSE
kanpmpkljedgfmdam	FALSE
kkpchlhkeecjncpaa	FALSE
kkppoiiejkbogpbaa	FALSE
lfjnconjcedpghmaa	FALSE
lfjnihckidbkbikaa	FALSE
lppjamhmofemlehpa	FALSE
lppnhhogofekkffaa	FALSE
mkfohcnainknohdea	FALSE
mkhepiimjcfbbappa	FALSE
ngbhfnclbiggobgaa	FALSE
ngccbhlnppginmoaa	FALSE
noelokicnocmfleaa	FALSE
nohdepcbkjlnhjpaa	FALSE
ojjpbliikpmmlldaa	FALSE
ojkgmochfipeippaa	FALSE
pelkbnklhcglkgiaa	FALSE
pelklkkfojhbojkaa	FALSE
aaaahlklfbooehfgkl	TRUE
aabkdakelbagfkdmao	TRUE
ajkhmflfjgjhbkaehl	TRUE
ajllbpbcbjddfhkjch	TRUE
bedkeoaefjmapglflb	TRUE
beenkeompjlhnngdjg	TRUE
bnbblhcacgdpnfhlbc	TRUE
bnbdfbmebigkibkmof	TRUE
cibkeeblfikfnblmdf	TRUE
cicdloplifkfcadlde	TRUE
dddnfgnnfokcnpopgb	TRUE
ddehjcpploenohigjn	TRUE
dnaebeoogpihkiakkk	TRUE
dnanlafbepjdojanco	TRUE
eggdabkmkokmdnggpl	TRUE
egghphhakafioappib	TRUE
faknddpdpabejekifp	TRUE
faoaajmlfeajecplab	TRUE
fkccimkhlkbdlpgkgo	TRUE
fkcloaanlegmkcoieb	TRUE
gdihdfhbhdfdghnknc	TRUE
gdilfpbomfmckfhlok	TRUE
gnllabdelahoojkdhn	TRUE
gnmodpepmldmjpkafg	TRUE
hibpmdjpgjpbhjhaof	TRUE
hichmoicimnafidbod	TRUE
icfckknkipcgfdhhem	TRUE
icgkmmnfkdnidjefhj	TRUE
ingmaimmmejendfgci	TRUE
inhdbdlnebgpcgpmnd	TRUE
jifnjjhhjggpjifcna	TRUE
jihlofohbfeeplldce	TRUE
kahpeobiakblipldlf	TRUE
kaiaacjgeefgaanckb	TRUE
kkbponchmbomkfejil	TRUE
kkdaoohfhoanfpndcb	TRUE
lgfligbagfpopmbkpc	TRUE
lgfpkjkekjagoblapd	TRUE
lppemploncpcdnoppc	TRUE
lpphgabppgbofdokop	TRUE
mklfhfgbigiplkpmio	TRUE
mklojmcffhefakkboe	TRUE
nffipjaldmiagdnfnb	TRUE
nffnhondkfgljkcohk	TRUE
noeohfcjcijdbpanji	TRUE
noepfdaaffmfkdeaob	TRUE
ojciokcemmagjeajab	TRUE
ojecoijebollgfiphm	TRUE
pdmogjkijmobldejfa	TRUE
pdpaihmkhholbgopjg	TRUE
aabbaobjllbpenabab	FALSE
aadbeebbkkkpahabab	FALSE
akkimkkojnijnagcgl	FALSE
aklkcmkmgdflpmofna	FALSE
bejnjdpmcljicpabab	FALSE
bekjnlmclkhfikhnaa	FALSE
bpahiladnnilajoldd	FALSE
bpbgmpiofeanjkckka	FALSE
ciongjpilokfjaoeda	FALSE
cipbnbjdobnchlpaia	FALSE
deedehkhfgidobeaea	FALSE
deggogooloplibnmaa	FALSE
dnpgmoocdflfmcdlaa	FALSE
dnpkcckjfmpkebbdaa	FALSE
eiagpgepfbkdifabab	FALSE
eiaollhojjknajgjal	FALSE
fcjcmhkfgpmefllkaa	FALSE
fcjhlnhiihockieoaa	FALSE
fmpbgnbbakjphgepla	FALSE
fmplbhkoipkjfddcaa	FALSE
ggjkoifnchefmnicaa	FALSE
ggjpnphcogcbgefbaa	FALSE
gpmoghpgldkkbogpaa	FALSE
gpnjplpkhijgdllnaa	FALSE
hiokpfnkdehpgecpaa	FALSE
hioppmmmggaobfabab	FALSE
iclhhkfaoogebbabab	FALSE
iclpopdpdojaofabab	FALSE
imbojaobjmccohabab	FALSE
imbojcjelahfnbabab	FALSE
jfmeamdmmfbjjkabab	FALSE
jfmnekkoilmngdkcaa	FALSE
jpmdjjgaojnkkakfgk	FALSE
jpnnblilbmpgabeeab	FALSE
kkfbmekimkjjdkmmaa	FALSE
kkfhlmhgmcicabfoab	FALSE
lfpbbknahoagimihmm	FALSE
lgaddjoiaebdnnabab	FALSE
mbjodeicciejcdjjaa	FALSE
mbkjlndnbnkgnbpeaa	FALSE
mmhjkbbdlneedjlnaa	FALSE
mmjeibkpfpdipahloa	FALSE
nffhddofobgplaldna	FALSE
nfgaefdkfgbpjpabab	FALSE
oafkfpiokidplnhfma	FALSE
oaheghaelaiegdmjaa	FALSE
olnojajkbknbodabab	FALSE
olonmhhfpicblaeeha	FALSE
pfhfggjcgkenedmkaa	FALSE
pfhlhnhcbeanphojka	FALSE
aaaideeglnaocdnkbje	TRUE
aaanlpjbbckjamdpfoa	TRUE
ajpojkalcdhpeejeegb	TRUE
akabipblbkjbcebeglh	TRUE
benfjddbgocoiedbean	TRUE
beobodkffljpjiookfb	TRUE
bokkgofjhebkmcindgg	TRUE
boldnnifkoggkmmflne	TRUE
ciklkelkcegmmanfhko	TRUE
cilcjikhgblobpkddkf	TRUE
dbofjigakcggajlkoob	TRUE
dbolljebomgfhpdgadf	TRUE
dmpkfigahglkpefeajb	TRUE
dmpopcdggcgehcppcpg	TRUE
ehphkfjeocohgoeahpe	TRUE
ehpmibjfakcmgpjbjdn	TRUE
fbplncieccefjmgpmoj	TRUE
fcbbeefobmghllbcoml	TRUE
flmchngaknpgbmbpfil	TRUE
flmdccdemakbljopmhe	TRUE
gfnlpcjmmopdppcameg	TRUE
gfnnlofdjeljmeflkcf	TRUE
gppgopojgbmanaehlmb	TRUE
gpplaeldbhjpmgjfegl	TRUE
hkhedkohickgkhdofki	TRUE
hkhhmnfnbmoaikcbpan	TRUE
ifiiojfhfinlfhcomgf	TRUE
ifkdpadhkjkckmnhcoe	TRUE
jafbleijnbpclmnpjem	TRUE
jagbpphneobkbaogfhh	TRUE
jjkdifemadlkebopeok	TRUE
jjldhpkngmkgclbogmk	TRUE
kcpkgfchbhkkkopjdgg	TRUE
kdbopfbdkccbofacnof	TRUE
kndalipphpbmcabgebn	TRUE
knebkgbmacoladaihfb	TRUE
lhnijfcbnocjlloilfb	TRUE
lhodgjafhddlkgmcdle	TRUE
mckhbjikmjilmabkgnj	TRUE
mckkhchdejmgffefoma	TRUE
mmifepbjndlmjfbbffj	TRUE
mmijfajkgbjigffacob	TRUE
nhbifepapfdgongocab	TRUE
nhcbnbgpejdigmaeacb	TRUE
oaegmhhdffflnmgppel	TRUE
oaeopijaikdjjdbcjjm	TRUE
olimbkdaikjkmciigij	TRUE
olipjgcnldakmelippb	TRUE
pgfngmbjnkdfgchedkj	TRUE
pggioifdgmmjenfjdki	TRUE
aaabgnmpfnebajdabab	FALSE
aaaehkibnpghifkabab	FALSE
ajljpicgmoeadkolkpe	FALSE
ajpbamnfjlbljedabab	FALSE
bekfbjopmdenphcgdaa	FALSE
belipieogdaodkfgdka	FALSE
bpjekpacpcigimmgfna	FALSE
bpjhbmbjhhefaebabab	FALSE
cjidnhhbicheiphgcaa	FALSE
cjjfhdjdaojcfaefall	FALSE
dehmdmnkiciloifoiaa	FALSE
dehmflfiieomcgfbiaa	FALSE
dpckfakjkdifpkhlina	FALSE
dpcodleogkmofkofkaa	FALSE
eigghhiclecacaneppc	FALSE
eilcelpgeemahfgcoja	FALSE
fcgkhacppoghddhpnga	FALSE
fciccoknbikgnlddmaa	FALSE
fmnfiagpcpmnopjlida	FALSE
fmnjeeoplcnffmfphaa	FALSE
ghgoikbbmokiedlhbaa	FALSE
ghiambhbgliciimabab	FALSE
haigjeibdjmdkimabab	FALSE
hajieoecbhpiljcabab	FALSE
hlagiplpklbmmpbabab	FALSE
hlahlbhpipbliloabab	FALSE
ifofkjapfhjebodabab	FALSE
igagigfnpkgjdcfpgoa	FALSE
jainpngipfplgmhpiga	FALSE
jajeagohepkmndhjhkl	FALSE
jkmckpinjcbojmellaa	FALSE
jkmcmfijlhlofkjhfaa	FALSE
kdjbphlopmealoalhpa	FALSE
kdklhbhpenpamnbabab	FALSE
kmoopiigfklfplkbiaa	FALSE
kmpcbknkgdpcakimila	FALSE
libmaghlclmpkgfhdia	FALSE
lidmdolnhepbodnjcaa	FALSE
mchkalepdpkddbiabab	FALSE
mchlfcbhanhkpnohpda	FALSE
mmgibgafklbcddlabab	FALSE
mmginjkbibehgifgbaa	FALSE
nhaglapibinpjnoabab	FALSE
nhbfgoejfemfkpaeiha	FALSE
obloainnpogkcgloiga	FALSE
obmlpheokaaanhhodpm	FALSE
olajlknfcdgppceegda	FALSE
olapjfeoolokhaechij	FALSE
pfogimalhbjoopabkab	FALSE
pgalkijgonakbolabab	FALSE
