aaaabilefi	TRUE
aaafoenmek	TRUE
ajlkjphjhd	TRUE
ajmbjmnink	TRUE
beocggkoap	TRUE
beoefkiaaa	TRUE
bofikgmkhc	TRUE
bofppgkpho	TRUE
cjjlcijmoo	TRUE
cjkdfjjeca	TRUE
ddbmkdcahi	TRUE
ddcclgifhp	TRUE
dnpdhknmjc	TRUE
dnphjomklj	TRUE
eglceheehd	TRUE
egmjkehfop	TRUE
fcconklmke	TRUE
fcdcpiolbd	TRUE
fmngkmpdbh	TRUE
fmonpfkmnf	TRUE
gflmkohhlc	TRUE
gfpafgjeoc	TRUE
hbcldnofgg	TRUE
hbcpglliii	TRUE
hlbnjldjhk	TRUE
hlcacdbmki	TRUE
ielkmbofpg	TRUE
ienliabgli	TRUE
ipfdjlilcc	TRUE
ipghclfgjp	TRUE
jkaobffmic	TRUE
jkcnjofiek	TRUE
keijjinlne	TRUE
kejabhdlfg	TRUE
kolnlngpjp	TRUE
konpmidimo	TRUE
lipkpbejgf	TRUE
ljacmhmepg	TRUE
mdadobekpp	TRUE
mdaiddncnn	TRUE
mnihilbkkd	TRUE
mnkmlkgjmm	TRUE
nglagjgblg	TRUE
ngoahacfce	TRUE
objjooekkk	TRUE
objnlfajnd	TRUE
okmcmmajgi	TRUE
oknakicnbf	TRUE
pfdibpeomo	TRUE
pfeahndleh	TRUE
aaaabhpkeb	FALSE
aaafehoebb	FALSE
ajldegdgbb	FALSE
ajmanlolbb	FALSE
bdjiglejgb	FALSE
bdjijaknbb	FALSE
bnnhnckojb	FALSE
bnpbkbbeji	FALSE
cjcfdojlbb	FALSE
cjdliipjbb	FALSE
ddcfhpfkbb	FALSE
dddapfdabb	FALSE
dnlfadbgob	FALSE
dnlkncnmbb	FALSE
eibjppaobb	FALSE
eidlegdlbb	FALSE
fcjijbekfb	FALSE
fcjoaegkbb	FALSE
fmgngllebb	FALSE
fmgpbhgmfb	FALSE
ggkjdehkbb	FALSE
ggkjpedibb	FALSE
hakcmnejbb	FALSE
hanhhpbkmb	FALSE
hladhjkfbb	FALSE
hlafbffoba	FALSE
ifhfbmbkke	FALSE
ifiakmhgbb	FALSE
ipimjbjhcb	FALSE
ipinebhnfb	FALSE
jjbbljmcal	FALSE
jjdapconbb	FALSE
keglfdldbb	FALSE
kehdnjnibb	FALSE
kohpglndbb	FALSE
koikilaibb	FALSE
lilbmlkabb	FALSE
lilddeonbb	FALSE
mdeiajfpbb	FALSE
mdeineglbb	FALSE
mmnjjfmcbb	FALSE
mmnnjnkbdb	FALSE
nglhkljgbb	FALSE
ngmggbbiao	FALSE
obgaoaafbb	FALSE
obhfomccdb	FALSE
olmnngifbb	FALSE
olodilclbb	FALSE
pejgjjjkbb	FALSE
pejpgdoebb	FALSE
aaadefpliaj	TRUE
aabdlegjnma	TRUE
ajodpgdelgc	TRUE
ajpeeaapofh	TRUE
bdnilafiecp	TRUE
bdogpmfkido	TRUE
bmpglenihpa	TRUE
bmphhlannbi	TRUE
chfckfjpfih	TRUE
chhgjglbagc	TRUE
dbnhcaangbl	TRUE
dboeapcbcff	TRUE
dlnmbfekmon	TRUE
dloelaagdmg	TRUE
egcjbfonipn	TRUE
egddaeebjng	TRUE
fadhnljicbc	TRUE
fadnnpamkag	TRUE
fkgckolehod	TRUE
fkhngbhlnaa	TRUE
gfnbaloegfe	TRUE
gfncngbomng	TRUE
gpomnjkljcf	TRUE
gpphfpcpnkf	TRUE
hkbnhkdcahd	TRUE
hkcofaneggm	TRUE
ieolegccjgi	TRUE
ifaldjmjhhi	TRUE
ipkpgmoagcd	TRUE
ipldaihaiem	TRUE
jignpelimai	TRUE
jiikakjjdbi	TRUE
kckgdeipdal	TRUE
kckjmijnbcm	TRUE
kmbgefflimi	TRUE
kmegaaahmja	TRUE
lhoblmdhdpe	TRUE
lholombjkmi	TRUE
mcblmjoigck	TRUE
mccbemmhpii	TRUE
mlndjgjkbnm	TRUE
mlngaglcphg	TRUE
nfhfambkpca	TRUE
nfhhneafpfi	TRUE
npfkgblekmg	TRUE
npflkekleem	TRUE
okodamimgok	TRUE
okokdkdgimn	TRUE
pfkmbmhgehj	TRUE
pfknipfbjpm	TRUE
aaadefplibb	FALSE
aabajpckdbb	FALSE
ajnianghfbb	FALSE
ajooocmnkbb	FALSE
bcjakkfofbb	FALSE
bcjejoainbb	FALSE
bmgblflcbbl	FALSE
bmgiaijbmfb	FALSE
cglpmjmhpbb	FALSE
cgoccfhfkbb	FALSE
dchehlnedbb	FALSE
dchlnhcbhmb	FALSE
dmmpnndnebb	FALSE
dmongoocnbb	FALSE
efpgolmhgbb	FALSE
egbkglidmgb	FALSE
facanifjhbb	FALSE
fadodbkbdko	FALSE
fkkloeggpbb	FALSE
fklhcegddbb	FALSE
gfdifabmjhb	FALSE
gfebopokdfb	FALSE
gplmnccnebb	FALSE
gpnonbiionb	FALSE
hkcldmbhipb	FALSE
hkdeilppmbb	FALSE
iecmmnjklbb	FALSE
iefcpfpcpbb	FALSE
ipkfnlgijbb	FALSE
iplnpejelbb	FALSE
jiofikbclbm	FALSE
jioopackmbb	FALSE
kdbmgldoibl	FALSE
kddcjbjpkib	FALSE
kmpcpfjdcbb	FALSE
kmpdfkmnnbb	FALSE
lhjgjaiekbb	FALSE
lhkncinafbb	FALSE
mccijdeoebb	FALSE
mcdecjdmkbb	FALSE
mlglealanbb	FALSE
mlhghjajpbb	FALSE
nfcobmfjpjb	FALSE
nfddalcgpbb	FALSE
npgolljjibb	FALSE
npjffhcphbb	FALSE
olffohhgobb	FALSE
olgbfpmhcfb	FALSE
pfddlphgkbb	FALSE
pffafndoabb	FALSE
aaahljokiagp	TRUE
aabhmpgligop	TRUE
akefjmddjdag	TRUE
akejebcojaab	TRUE
bdkiddmnplei	TRUE
bdlldaakceip	TRUE
bnjdpnggmnmm	TRUE
bnjhjhjecpih	TRUE
cipgmphnnfdb	TRUE
cjaghbnaapjb	TRUE
dcnemfcabgfd	TRUE
dcnoiegbkhek	TRUE
dnpfolbnnddk	TRUE
dodoflalhdil	TRUE
ejcohhgenihj	TRUE
ejecjpagmkck	TRUE
fdigccbemeed	TRUE
fdjfghnbclni	TRUE
foahmdmkbdon	TRUE
foajgllnepff	TRUE
gikjgkjkkjpj	TRUE
giknegjahepl	TRUE
hbokmjoommpi	TRUE
hbolppcmhhhl	TRUE
hmdbgplkfoeo	TRUE
hmeoidpegpdg	TRUE
ifolhfjlidbd	TRUE
ifpenliinhpc	TRUE
ipjmnkmkmlne	TRUE
ipjnhdienldp	TRUE
jjhdhdgfklpc	TRUE
jjhipbhfgmij	TRUE
keaochaafjni	TRUE
kebcngfopnpe	TRUE
laaffoneocld	TRUE
laafojdiabmj	TRUE
ljongmfinhkp	TRUE
ljpkkbgaepbj	TRUE
mdiipnnmejhc	TRUE
mdjbofjfmmpn	TRUE
mojjpmbecijk	TRUE
mojmeaddbigj	TRUE
nhdhhjappccp	TRUE
nhfbmccjkkdi	TRUE
oamehheopkph	TRUE
oandkdjemagb	TRUE
okmgabhppgdh	TRUE
okpkmjdbfljj	TRUE
pemhlcljbkkm	TRUE
pemldfapkkhf	TRUE
aaahljokiabb	FALSE
aabggilofkib	FALSE
akdmolgiebhb	FALSE
akejbojemknb	FALSE
bdjomiibhncf	FALSE
bdkfdimceidb	FALSE
bofbfbaphkec	FALSE
boflipapknbb	FALSE
cifleljhoobb	FALSE
cifndddhnbfb	FALSE
dcmdnfoppcbb	FALSE
dcmgdiinkpbb	FALSE
dohpmhlmmebb	FALSE
domeinoifpbb	FALSE
eipiooeigdbb	FALSE
eipjfehagpbb	FALSE
fdmnoonkmobb	FALSE
fdokkaindfbb	FALSE
fnpglcpkhkbb	FALSE
fnpogcciombb	FALSE
ghmohbinbhif	FALSE
ghndnioidbdb	FALSE
hbepfodopojb	FALSE
hbfckpjlflgb	FALSE
hljilihimpbb	FALSE
hljpoahimnbb	FALSE
igbjgbfoommi	FALSE
igbkejmjholb	FALSE
iphjfbffinnb	FALSE
ipinkghmndbb	FALSE
jkbngjpdabmb	FALSE
jkcibmcjiopb	FALSE
kedhflanpdbb	FALSE
kedjdgjkkfbb	FALSE
laabafmilhbb	FALSE
lablfbhckabb	FALSE
ljkendkenpbb	FALSE
ljkhgonoiibb	FALSE
mekbadoacebb	FALSE
menangbffpfb	FALSE
moiebecjlkeb	FALSE
mojpooemjebb	FALSE
nhnfdbganhbb	FALSE
nhnjpamgdbkb	FALSE
oajebchkkpcb	FALSE
oamoakppclbb	FALSE
oklkdeilahbb	FALSE
okmkjkkjmobb	FALSE
pedbmpjmpmhb	FALSE
pefgmiojgdbb	FALSE
aaahljokiagpg	TRUE
aabjpgligopek	TRUE
akbpocolliieo	TRUE
akggngeoempjo	TRUE
beoldicnihpoi	TRUE
bephmpdflpfdp	TRUE
bodadildihllk	TRUE
boeaeopgjeomn	TRUE
ciaflhjmkahfn	TRUE
ciboaniijphgp	TRUE
ddccochkmfnfm	TRUE
ddelgnhbajhjb	TRUE
dogmdilfbmlla	TRUE
dolempeimpflj	TRUE
ejgakfneekchf	TRUE
ejgijhdnkndja	TRUE
febdjfajbeknn	TRUE
feclkdaeaagbh	TRUE
fojicjcbapken	TRUE
fojmijikonmhg	TRUE
ghnmmgnpcddgl	TRUE
ghnogjifbapkm	TRUE
hbnijdnkjgiih	TRUE
hbodoippmkpab	TRUE
hmenjffdiaoim	TRUE
hmflfnmdmhfck	TRUE
ifopdmelpldjp	TRUE
ifpcfpipmgmla	TRUE
ipihhelnpadil	TRUE
ipiiabmjemeab	TRUE
jjolhoodfmdma	TRUE
jkanegobkkapi	TRUE
kekecnabnmcld	TRUE
kemadedpojepo	TRUE
laahaeheloioi	TRUE
laalnglmjgcin	TRUE
lkeeffhicnbge	TRUE
lkgahfhjpicnm	TRUE
mdnobdoeagobe	TRUE
mdpjmckicbffj	TRUE
mokcdfhaelgmp	TRUE
mokklokfhnbkd	TRUE
nhhjncnhfkhdi	TRUE
nhhmncacjplij	TRUE
obegdnffccmfk	TRUE
obeggocejhkhi	TRUE
olaaoeiodfibi	TRUE
olajhkoepnmgd	TRUE
pehpekaflnmfl	TRUE
peickdpnnplnc	TRUE
aaabpmkpcmoib	FALSE
aaaokaindpdbb	FALSE
ajfjepffafebb	FALSE
ajggickfafgbb	FALSE
bdiinaipcehbb	FALSE
bdjikdejehfeb	FALSE
bnpkefmmikdkb	FALSE
boafakjdemnbb	FALSE
cildhjkmbgofb	FALSE
ciljolikghgbb	FALSE
ddckpeamhimbb	FALSE
dddcabjhdonmb	FALSE
dmpmppbohhmfb	FALSE
dnabhghhgbfpb	FALSE
eiihkblhkclkb	FALSE
eiikojcgnjcbb	FALSE
fcgachhbbgane	FALSE
fcgngpokcmhbb	FALSE
fmceaannhclbb	FALSE
fmcfaiicfhnbb	FALSE
gfpfbmmibkjkf	FALSE
gfpgemjjebfib	FALSE
haloljagmhfbb	FALSE
hamlbehomdpeb	FALSE
hjnfjbhgeaebb	FALSE
hjnokbmnachbb	FALSE
iedjfjneohabb	FALSE
iegjkbpkpfkgb	FALSE
ioghjheepjkbb	FALSE
iohhpjhikmmbb	FALSE
jiimghkcflebb	FALSE
jijgggoojenbb	FALSE
kdncljbaipcbb	FALSE
kdngillpmcjbb	FALSE
knlgmlodficbb	FALSE
knmdpicipegbb	FALSE
lhmlnpjnmdmbb	FALSE
lhnanepdemdbb	FALSE
mbcflfdmlplmb	FALSE
mbcjhahmhbljb	FALSE
mlpjncdoiaobb	FALSE
mlplcfdpcgnbb	FALSE
nfeldojncfbib	FALSE
nfgmimpomgpbb	FALSE
npgmgafajajbb	FALSE
npinghmnpplbb	FALSE
ojkocepbifldb	FALSE
ojlgncfgikbpb	FALSE
pekjaeleginbb	FALSE
pekoidgeicnbb	FALSE
aaabnldnpilain	TRUE
aaaodpdfhbdknl	TRUE
ajlggjfikdeono	TRUE
ajljggajlfphmn	TRUE
befflgpnnacgac	TRUE
befphepgckgkkp	TRUE
boakaklbekammf	TRUE
boceanpcoeaeci	TRUE
cihpchhgfpgnoi	TRUE
cijhalbkgikmpe	TRUE
dcmkdiecogcooc	TRUE
dcmlpkihgjfnhd	TRUE
dndecndldciddf	TRUE
dnfihpkpkbpkol	TRUE
ejdkckoinhppha	TRUE
ejdnnclojdgolg	TRUE
fciodjbnooelca	TRUE
fcncamigecijke	TRUE
flobijcglahlke	TRUE
flolojllpckjla	TRUE
gfiakbkfjmdeof	TRUE
gfijhicgpobhnl	TRUE
halnjodmhgbngd	TRUE
hanlbechkllkog	TRUE
hkdlcfpenailci	TRUE
hkemkbehipknle	TRUE
ifgjhccoilojgl	TRUE
ifianhjfnohamc	TRUE
iolgkcliigeoik	TRUE
iolibhhkekhfgo	TRUE
jjdoohkmmoedem	TRUE
jjeknjjhidebam	TRUE
kdepcncdjodhno	TRUE
kdfacigndhdbmi	TRUE
kngjkbljcamiob	TRUE
kngmgnmilhlidc	TRUE
lhccnlceogglej	TRUE
lhcncdcfokaiok	TRUE
mbncnnaojhgcga	TRUE
mcancjdglgclec	TRUE
mmadbmkjiahofc	TRUE
mmafbndljolomj	TRUE
nfbafjpfcpiapk	TRUE
nfbajhengoklop	TRUE
npglnbjccnnaab	TRUE
npiopmdcimeoim	TRUE
ojknehdogdpkdh	TRUE
ojlfpdhfbdgngc	TRUE
penjpeiklpihib	TRUE
penlhaehdofkbg	TRUE
aaacmblonmahbb	FALSE
aaafhafabnhdkb	FALSE
akgffpiapkdabb	FALSE
akgokkheknppbb	FALSE
bdbddcbnbogihm	FALSE
bdblkhjimogllg	FALSE
bnanedckifcabb	FALSE
bnankfekjiepbb	FALSE
cggbbgmkamhdcc	FALSE
cghaihlkghbocb	FALSE
dbchidojhmekeb	FALSE
dbdgadbcbcojib	FALSE
dkbblfimanhdna	FALSE
dkbjfenjeokabb	FALSE
eejbapnapdjhbb	FALSE
eekbcgbllebiod	FALSE
eogffghnmeohbb	FALSE
eogkhkdcagnhbb	FALSE
fkiohimbjlgoib	FALSE
fkjbeabocdfkkb	FALSE
gfbbalhanmnach	FALSE
gfcijobjacofbb	FALSE
gonjgedgdncebb	FALSE
gonljcaglmecbb	FALSE
hjahefbcdjmjdb	FALSE
hjapcedijmnhbb	FALSE
iclgighecpjabb	FALSE
icmeejjcndambb	FALSE
inkdkbbpnkodkk	FALSE
inkfggidckknbb	FALSE
jipbdfcccimcfb	FALSE
jjanadobfpkggb	FALSE
kcndlkdpenpabb	FALSE
kcochchbjhlneb	FALSE
kmeljaepkpmcbb	FALSE
kmfhgpofpiegbb	FALSE
lhgeeebhfmegbe	FALSE
lhgkeefkidkibb	FALSE
mbmobdlgheohec	FALSE
mbpbmmonafcaim	FALSE
mlpkcnobgdmddb	FALSE
mmabjfiknglcpb	FALSE
ngccnbmfbebpgl	FALSE
ngclablicdhncb	FALSE
obckkgakldaibb	FALSE
obeaabjjjppbij	FALSE
omjpidfljgpdbb	FALSE
omlikohhdedbeb	FALSE
pgfoncjpobkkgb	FALSE
pgfpbkjmbncifd	FALSE
aaacmbmponahhaf	TRUE
aaafaboieknnnhj	TRUE
akchpgkocgbmfog	TRUE
akcnmefnebdlpil	TRUE
bdphffjofoplgij	TRUE
beaajdmipigoljh	TRUE
bmmlcdealkgmiag	TRUE
bmpigkhjhgcmlhp	TRUE
cgebmmggkjjddpe	TRUE
cgecdnpgdjkbhkd	TRUE
damlbjajbhphocd	TRUE
danepaeaddldkhf	TRUE
dknlhcpadjiblim	TRUE
dlakoepljofepbm	TRUE
eeoidijiindgdib	TRUE
eeoieenljelcapn	TRUE
eonekkmdnhmfblg	TRUE
eongmldapjihkpg	TRUE
fkcfjaalhphchkm	TRUE
fkegjpefocaegif	TRUE
gejhbdnngiepipg	TRUE
gejjajoedggihbf	TRUE
gpejkmhmhjkklci	TRUE
gpfijnlpimfkdpm	TRUE
hjhinhlpnhhfkof	TRUE
hjhnpogojajhfab	TRUE
idcdnapkbpggicc	TRUE
idclkafphbeopho	TRUE
iobkkjfkeajbife	TRUE
iodcepkdeooijoi	TRUE
jjdbnfaebdfenpm	TRUE
jjehnlcnahjhdnn	TRUE
kcncfhoekgkmmno	TRUE
kcnopgnflhojipl	TRUE
kmccmbcegehladi	TRUE
kmcfeacpncokkab	TRUE
lglaafejihdaeae	TRUE
lgldlaoooobafag	TRUE
mbhnjneoljanpjp	TRUE
mbifnhpnlemfaho	TRUE
mlgakggpoknklbg	TRUE
mlgllcioebmfhga	TRUE
ngagbeecnldodep	TRUE
ngbgenglaledphg	TRUE
obcjkedenecklep	TRUE
obdfjmackldando	TRUE
olfhnnkochhmnij	TRUE
olgcfkabaigahjd	TRUE
pgopijdafgdbjoh	TRUE
pgphniibdpoempg	TRUE
aaccicdamnkhkbb	FALSE
aaciaccjooeekbb	FALSE
alaceahmggbpmfb	FALSE
alaijihnedfhlbb	FALSE
beldlgkoglcdfnb	FALSE
beljfncdpjegomb	FALSE
bobkaiemkdhcgga	FALSE
boblboplimphmcp	FALSE
ciiddhbfjpppglb	FALSE
ciiefaacjmoiibb	FALSE
dbncccijnpkggfb	FALSE
dbocdgefjaibgpb	FALSE
dlnjeimajfnkhbb	FALSE
dlogoiikcmmncbb	FALSE
egdpobkfmgikekb	FALSE
egennkapiodppbb	FALSE
epoibfmacdlebgb	FALSE
epoihagknojeabb	FALSE
fkmiokopnijoabb	FALSE
fkmkimifghcbcib	FALSE
gdhkfomnimicnbb	FALSE
gdibhjlimklchhb	FALSE
gnnamkdfjaecmbb	FALSE
gnnigmnfipijhbb	FALSE
hhlpiogfabimdkb	FALSE
hhlpmbinddbipbh	FALSE
iefibijcnagabdb	FALSE
iehmbdfahogadbb	FALSE
indjalbkmgchgbf	FALSE
indoonjbkejbgkj	FALSE
jhbmlmgaflgccbb	FALSE
jhbopmemgkbfjon	FALSE
kbkegjdkfelbhjn	FALSE
kbkgpciemglkhlb	FALSE
knfhjcbcjoklefb	FALSE
knfngbelocfbamo	FALSE
lfmlmncoaklnobb	FALSE
lfnmhidbbdpgedp	FALSE
mahplalcpbdnnnb	FALSE
malmimeeidihpbb	FALSE
mmipmaajbkjflgb	FALSE
mmjaijpbcdfljlb	FALSE
nhjaealimjeidbb	FALSE
nhjbfcmpeponhjb	FALSE
oamcepkffhcakbb	FALSE
oamjacjdppidnbb	FALSE
okpjbnojnlhbflg	FALSE
olaahgeenognblb	FALSE
pfaoeelakakakbb	FALSE
pfbbjbkhdggkemd	FALSE
aaafkhbjnfjkadhp	TRUE
aabkpdnooknmhgln	TRUE
ajooacmiipfammnj	TRUE
ajopncpbljjcgpne	TRUE
beclphfgcfdpckcf	TRUE
becoladiidadbahh	TRUE
bognegpngmdapena	TRUE
bohehkdmhijholdh	TRUE
cikaoiojhlnnmeho	TRUE
cikbkokdacmgomii	TRUE
ddmebapdapjcpplk	TRUE
ddmmeejdiblchlph	TRUE
dodmlandjjlalnhb	TRUE
doeibjakglefabce	TRUE
eibhfcnpdlfcmogp	TRUE
eibjelkommodjeop	TRUE
fcodpgcceilbilhi	TRUE
fdabdaaplkkhhpho	TRUE
fmkpckgeaeeaoead	TRUE
fmlbipokamlinhfm	TRUE
gigpkkkgpehcpmcb	TRUE
gihabnjijchfpjac	TRUE
hcbpilofalnbllmm	TRUE
hcchjmnbpmljcpal	TRUE
hlppalcdjjljneof	TRUE
hmaacjlokbcdgfdi	TRUE
igfpbinocfpmfcje	TRUE
iggkhilolpdigpca	TRUE
jafckhollngldhlm	TRUE
jafgodemjahdkonh	TRUE
jlbigdjalcgdkicm	TRUE
jlccomlddfhelega	TRUE
kfijfolehgkmgdnk	TRUE
kfjompgkhfdpgdcf	TRUE
kpfepdnabgamidob	TRUE
kphfhkgdegifoifn	TRUE
ljgageieofkobhjo	TRUE
ljgjgiecejilhjak	TRUE
mcjpimoofkonfbim	TRUE
mckahnfanmlcokhd	TRUE
moakljkpgnghpioi	TRUE
moalkegffgnpeoll	TRUE
nhkkdecemeeiobdn	TRUE
nhmbacbpcjcggdel	TRUE
obilpgcaoojpnmba	TRUE
obipgcnnkfgnelpj	TRUE
omeippoplmdofegf	TRUE
omfabmepkcckkfpk	TRUE
pgaeajlcehodkogo	TRUE
pgangkgldiigicfo	TRUE
aaafkhbimeijadbb	FALSE
aabhpjocmnnjmlhb	FALSE
ajogjaaglpekfcbb	FALSE
ajpbelcfghogpccb	FALSE
befphdammkopipbb	FALSE
behbipjjlbpehkjj	FALSE
bnndkflhonakncbb	FALSE
bnodilbaaaegkioc	FALSE
cippefamdmicchbb	FALSE
cjdnjiogcipnigbb	FALSE
ddjkpgebinikoffb	FALSE
ddlfeofdoojkbngb	FALSE
doboclgmbblfanoi	FALSE
docecikmafoggdbb	FALSE
eieeffngfplmkfbb	FALSE
eiejenbjhobpnjpg	FALSE
fciopdggppmjlmbb	FALSE
fcjbooifhgdpmenb	FALSE
fmjoikjdilmpdnbb	FALSE
fmlldagclojljkbb	FALSE
ghgpdffpfnhjmhbb	FALSE
ghidfgnokghgecbb	FALSE
hcflfcaanpdffhbb	FALSE
hcgdefhapmnkolbb	FALSE
hmakhkaebhhbibcm	FALSE
hmcdkhgpmmlnaebb	FALSE
igpiefcdggaihgbb	FALSE
igpmmpdbikogfbkm	FALSE
jafnnickeoljnbnb	FALSE
jagblbdodjlpnfma	FALSE
jkomlmpligoflgbb	FALSE
jkpaccjkalompobb	FALSE
kfpmedggelohcbmb	FALSE
kgaldakhahalhabb	FALSE
kpiipkdgahkiejbb	FALSE
kpipgphpimeegabb	FALSE
liikmjikeejfikbb	FALSE
likcmkpkblddichb	FALSE
mcckegkklhmoogbb	FALSE
mcekbcfhfdlmakbb	FALSE
mndkgnodgijeahbb	FALSE
mngkkhbcnhflfiib	FALSE
nialdfjiiadpocbb	FALSE
niblgmajfhmpdpbb	FALSE
ocabmfjakbcokllb	FALSE
ocboipjincmlefib	FALSE
omfhokgjigcjfibb	FALSE
omgagggogknlenbb	FALSE
pgacoggkfklmmkbb	FALSE
pgaleaapebbnlpeb	FALSE
aaancfmlplggapnil	TRUE
aabcpifhnonipfdfo	TRUE
akcifimedigkoilmo	TRUE
akecnhcamfflajgad	TRUE
bfkhnojnamgjbiefp	TRUE
bflhhmfhiiijfccka	TRUE
canbhepjhcpenmpgk	TRUE
caoahcolibnjiifnj	TRUE
cjgomikiococgemec	TRUE
cjhkflogepabnkmlj	TRUE
dcogejbjcehidalhj	TRUE
dcomofdfkgngkmanj	TRUE
dmkkcgkgpkndhpjog	TRUE
dmlfmnoolboncgkci	TRUE
egkaofhpllgepeedo	TRUE
egkbnfipldfkcohmk	TRUE
fbcmjhmapdcpdalfe	TRUE
fbcphaigpfjljapbi	TRUE
fkcaljnfeolfiehmm	TRUE
fkcfhilbollpokgpa	TRUE
geilfakeedhjfddbk	TRUE
gelaihoichplehieg	TRUE
gpacfbaeiekpfoagf	TRUE
gpagmbcipngnekioi	TRUE
hipgmkdjkagmcpgkd	TRUE
hjahiaegfakggobjf	TRUE
ibfnpgohiegmghnhf	TRUE
ibgeiigkilhkpeakp	TRUE
inlimnhnnhkhpklin	TRUE
inljbdogpnhpeanfm	TRUE
jilomlhphimlmbnfo	TRUE
jimafkbmpeaokdcll	TRUE
kbhlhijdomlemgpdf	TRUE
kbhpcpcgpeocgddhl	TRUE
kmkejinfegahjjpde	TRUE
kmknklebhdjldoehf	TRUE
lgpphgckgghpnjdlk	TRUE
lhahplipiaaedkbgn	TRUE
mbfgcmokejaokegnl	TRUE
mbhiaklodepjjblpl	TRUE
mmckpafbljikijglf	TRUE
mmdbnnjngoijiahgd	TRUE
nfleohgocihfcojmf	TRUE
nflkaoeaajingemfh	TRUE
obgalgejbfpgnmdlp	TRUE
obgjiihnjceghlgcl	TRUE
olhggkflnaljfalpe	TRUE
olimnhnoonafldelk	TRUE
pginbakbpckadjdjk	TRUE
pgjhodapjijmcdkom	TRUE
aacmfbgacdiibihjb	FALSE
aaeiobjeecolceleb	FALSE
akjghfnpojaelfibb	FALSE
akklnioalkfdiejbb	FALSE
beolfdmalhgpfflbb	FALSE
bephmiaebngeeecmb	FALSE
bpkeepgjkkikmhfob	FALSE
bplmamjbbmajgjpnn	FALSE
ckcagjmdibaejpgbb	FALSE
ckcgiagcadejofdbb	FALSE
ddkjkamcjgembeklb	FALSE
ddlnigfkjhbkkabfb	FALSE
dmomneanbgegfiipb	FALSE
dmphapbokpahijmbb	FALSE
egoafebpaplpgghbb	FALSE
egojnpjoffiijnnbb	FALSE
fblemdbigkgfhneem	FALSE
fblimgikhoppihclb	FALSE
fmoafpmememcflobb	FALSE
fmpdcekoiiemhnebb	FALSE
ggamgioenblekdoeb	FALSE
ggbjoegfpkgbfokhp	FALSE
haphpgjnahgppgdbb	FALSE
hapinmmmllnnclpbb	FALSE
hkmmleiflaaglkobb	FALSE
hknjalmeomcklgcbb	FALSE
ifpngbipejohfaebb	FALSE
igaahnekefifbijkb	FALSE
ipkkbjjddbgopkbkd	FALSE
iplnhcpdkhnfhfpbb	FALSE
jjmklfngcclbendob	FALSE
jjnpffhnkdbcjanbb	FALSE
kcpoeiopkomiaofbb	FALSE
kdaolmghinplodlbb	FALSE
knmpbgfjngobbbnna	FALSE
knmpdmnpeehijigbb	FALSE
lhlbhfmlagkdomgbb	FALSE
lhlcpnoommbflkikb	FALSE
mamddcbhbjfbjmaio	FALSE
mangfcicemcdfdgbb	FALSE
mkokkmcdancagombb	FALSE
mlagkellbjkmdlnnb	FALSE
nfgkdacncdilnedbb	FALSE
nfhdiaofbjeenjoeb	FALSE
npfeiacpiijeojkbb	FALSE
npfjdihpnjidefkbb	FALSE
ojgicjoggficlbcgb	FALSE
ojhjjhkoakbaigabb	FALSE
pepjlcompokolhmbb	FALSE
pfcbkbcmeoonojbjc	FALSE
aacmfbhacdiibjijjp	TRUE
aaebkffdpmdfmejjad	TRUE
akjcdadphphcjeoppc	TRUE
akkjgfbiaclpebfpaj	TRUE
bfhhodlfiaapkmiemj	TRUE
bfhmgmnfmdekfnadcg	TRUE
bpllfmjlpdgcpghnek	TRUE
bpmdnckhdmiceleccg	TRUE
cjeedgnoekkomkednk	TRUE
cjgchbhhmfeaedbgig	TRUE
ddolkchfkmacdgdehm	TRUE
ddpkpdhbiknmecfgco	TRUE
dncbjoemkhnfamaach	TRUE
dnedghfmkhbmednhdh	TRUE
ehdogkmjgiacepofea	TRUE
eheegkdgjinibfdhak	TRUE
fbeialgcaeiphfklfl	TRUE
fbfeadnlnepkjnlmce	TRUE
flmkghkeinkgnodbfm	TRUE
flnnhpkjonhkihphfa	TRUE
ggakenplngobneedol	TRUE
ggamccpkhfddlbjanj	TRUE
halfnkjlgnapamoahe	TRUE
hamdcpnfapinbjjjji	TRUE
hklnpbplgpaebnpkdp	TRUE
hkmhajmbhpdimpddak	TRUE
ifbmcikdlkoejimapg	TRUE
ifbmndgneakpckliee	TRUE
iplkdjdkileknlbenm	TRUE
ipmnioedbjoedanfjc	TRUE
jigpmfofbkjhjoiidd	TRUE
jijdibabhdnkoojjma	TRUE
kdciikhhldlbhclenm	TRUE
kddgnoflneicgdabjc	TRUE
knelfkbieoemglmngp	TRUE
knfflcbghkkkeekmio	TRUE
liebkcokalkehaipok	TRUE
liechonmigacdoiine	TRUE
mbegaekigiadleadng	TRUE
mbelddiommghecgmpk	TRUE
mklajcekjngnmbiafc	TRUE
mkmhblpnfghkoeniak	TRUE
nepoeaiobfelpcodkj	TRUE
nfaacejekencbocdon	TRUE
nphgligfcjolapicjf	TRUE
nphldipjgncmldkchk	TRUE
ojlbipdkgcdhcgofik	TRUE
ojlcmbinmhlhidhcll	TRUE
peibfdlogicggagaac	TRUE
peledgkimpnelfompp	TRUE
aaadakmcokcijfebcb	FALSE
aababdcheabjhgkklb	FALSE
akpbognbmhhlflgjga	FALSE
albakhcbfjedaokkbb	FALSE
bgaemldpegjokgphbb	FALSE
bgbaendeohijdjmilg	FALSE
cbanfmjpbmpbldlcla	FALSE
cbbmfdnofncbhgndoc	FALSE
cligpebjonjnobkppi	FALSE
clihmnejcohicjafbb	FALSE
dfalmljmobdcgodkmb	FALSE
dfapegkgidknnjgmbb	FALSE
eadjdhdoibkefdlfmb	FALSE
eagkhkmjjdienegabb	FALSE
ejompbimhmfchkhbfh	FALSE
ekaloijiopjagapfbb	FALSE
fegkikcjhbccchfieb	FALSE
fehebhgncimcieelmb	FALSE
fpabcpfeobkkgalfnh	FALSE
fpceaafohinlklbknb	FALSE
gieodmoehmjcdcgkbb	FALSE
giepjakahlifbinlpb	FALSE
hcdagamdfnnpeignbb	FALSE
hcdbeodoaolledcbdb	FALSE
hmpbbhjdpcbbhjdpep	FALSE
hnakmcacbddjncepkb	FALSE
ihfdhhiddaenhhkobb	FALSE
ihfljhibhhkangfjbb	FALSE
jbkkpdffagannhccbb	FALSE
jblcmclimmpglkaebb	FALSE
jkkmkmdbdpbdlnmghl	FALSE
jklkemefjbkpgmlpgb	FALSE
kdmgfcafaidmmhnnbb	FALSE
kdmimggbdoambdfijb	FALSE
kniigfaoanpiikkfbb	FALSE
kniioghipajgonmabb	FALSE
lhnleldapdfklgfobb	FALSE
lhoafpeohiajjoohbb	FALSE
mbleccnphilkfiogjb	FALSE
mbljdnekcifaebjknb	FALSE
mmiohclkglimljihbb	FALSE
mmjcjimgdfibgapjbb	FALSE
nhdcgaiknljpeaakbb	FALSE
nhdmdgijacmjekgjbb	FALSE
oacdpcbbibdhmagfnf	FALSE
oafhgkhdohkeoejbib	FALSE
olaklmdfficahnkibb	FALSE
olamlkbpbdoakmngmc	FALSE
pgenkpflcjlcmgkjbb	FALSE
pgfachbkmdhfbhdnpf	FALSE
aaabpjlpcfhknjladbc	TRUE
aaapmnicfnkpkkdhnao	TRUE
alblmekgahalcbfgmfc	TRUE
alchciobhpgdmoehlfg	TRUE
bghmlnabafnnfonikkf	TRUE
bgjjfldcgjjmkiidhhl	TRUE
cajlfppfnkojhdnbhli	TRUE
calcgplmfiliaochkjb	TRUE
cldplkenoaooahjjpff	TRUE
clfppenjmnghpgijaai	TRUE
dfjfladebianobngich	TRUE
dfkdhjkjikajgiboglh	TRUE
eabcehlfodndadpomjf	TRUE
eackbgcgogkikahhick	TRUE
ekilhehbnjlmphpogch	TRUE
ekjnncdeelmhmgkihbm	TRUE
fehnnifincjmljjlpli	TRUE
feifmbmhledahikchgk	TRUE
folccjhejapjefnedjp	TRUE
foljnpdbofpecggdedf	TRUE
gibidfikhliomabmgde	TRUE
gibijjghmjaailpmfke	TRUE
hcoienacmldebccgkhh	TRUE
hdaibpnipomngmfiicp	TRUE
hmdclnnhhmkhcjlmhma	TRUE
hmfhnhpolnoiplepikd	TRUE
igdjgnfibpadjbenghd	TRUE
igdolanbpcejggcdapf	TRUE
jalffkcbpakoepibnlf	TRUE
jamdhoeccnbfddeojil	TRUE
jljalbmkokcjfpnaooa	TRUE
jljibekkjicljadchfo	TRUE
kfpkkbijkdagoechine	TRUE
kgcbfclkpigocdaagnd	TRUE
kpcbeemkjhnfopjklpk	TRUE
kpcfoelgdfidgiicmbo	TRUE
ljjimegkekmnpjmngal	TRUE
ljkmffoogjmflndncen	TRUE
mefpdkcfepcdjjmmlkh	TRUE
mehhfiphpdaofapnfol	TRUE
mohgbkpjahacifpmede	TRUE
mohggohgoipboocfadd	TRUE
nhdcmiambadhoifeacm	TRUE
nhdmaafggkojgcgldgh	TRUE
obepkhkplmnlhpljklc	TRUE
obgjegfhgkaefankjpk	TRUE
oldkcdhjcaceppejinm	TRUE
oleflboidlhpajhekjf	TRUE
pfnkjimjlgaofkahajb	TRUE
pfnlhlaeadmgkglffco	TRUE
aafckpjpgckecaijjbb	FALSE
aafildlcolifgpjecbb	FALSE
akflkkmhnhpempkbmkb	FALSE
akhdanolpnngbcbgiie	FALSE
beeajejolnompfibojb	FALSE
beebmpbfngmbmlkjpca	FALSE
bnkndphdlikebhdkdng	FALSE
bnlbehfndalmjaagnha	FALSE
ciamclldpagkicdjdbb	FALSE
cibbgbkoohihiifckjj	FALSE
dcebiimncgnpmicejhb	FALSE
dcecckfhibooookjphb	FALSE
dlhaacdmhbglipfmdnb	FALSE
dlhakbjbedfkaahgpdi	FALSE
egbmkbmjiblnfcjcedb	FALSE
egdofcapebjbomhnjck	FALSE
epeghhakhohjcddgmbb	FALSE
epfjdapiffecmkjepbb	FALSE
fjdjeenkkfedkhcafbb	FALSE
fjdleijmpefjaglchbb	FALSE
gdklfnaheijjokoihbb	FALSE
gdlbnakfldgbakghibb	FALSE
godecfljhdlcbhiemmb	FALSE
goeojkgdkdfaogbnbmm	FALSE
hjfgglbabopemhalmbb	FALSE
hjfjheicdfihagdkhbb	FALSE
idoihamlpcglmhigkbb	FALSE
ieakmibcaldelnnmgbb	FALSE
ioanpklhaeddklpefbb	FALSE
ioapjkpgaofcmccfbhb	FALSE
jicdnbmgokdklfopncb	FALSE
jicopmbcahfddechmbb	FALSE
kcefpbcolhaibababnb	FALSE
kcelhdcbhdpcokbeeli	FALSE
klmgoiibccjnionbdap	FALSE
klminjbljkhdiofpfcb	FALSE
lfidemgjfodbdmogkkb	FALSE
lfjgkfofejinieigpbb	FALSE
lpogicghbacaekobeib	FALSE
lpoknhkglknbpakiebb	FALSE
mkmlnmnafpjaedgjpbb	FALSE
mknakgohdfonedcdlbb	FALSE
nepmhgeemlfhlelmjbb	FALSE
nfaialbmbejdpienogj	FALSE
nppgklfccccccjffpbb	FALSE
nppofaimfhcenhgohbb	FALSE
olhfnbbpcnnkolmmbcg	FALSE
olhgbeblfpinnmpehoa	FALSE
pfmioclhngomllmnjbb	FALSE
pfohcdckiakoonadkbb	FALSE
