aabigcdfaa	TRUE
aaceeppgaa	TRUE
alfholaaaa	TRUE
alklnlaaaa	TRUE
bgljgiaaaa	TRUE
bgmmeeaaaa	TRUE
bpmkkmaaaa	TRUE
bpmljnaaaa	TRUE
ckdjfmaaaa	TRUE
ckdnjhaaaa	TRUE
debpcpaaaa	TRUE
deejffaaaa	TRUE
doopcoaaaa	TRUE
dpafopaaaa	TRUE
ejdnobaaaa	TRUE
ejfdgaajaa	TRUE
fbjpdmaaaa	TRUE
fbklgfaaaa	TRUE
fmkpgeaaaa	TRUE
fmmeegaaaa	TRUE
gghabcaaaa	TRUE
gghehhaaaa	TRUE
hancblaaaa	TRUE
haojofaaaa	TRUE
hkkcmlaaaa	TRUE
hkndohaaaa	TRUE
ifnehkaaaa	TRUE
ifnlfdaaaa	TRUE
ipofimaaaa	TRUE
jaacemikaa	TRUE
jjonebaaaa	TRUE
jjpcgaagaa	TRUE
kdpjbiaaaa	TRUE
kdppepaaaa	TRUE
kpcgfiaaaa	TRUE
kpejlfaaaa	TRUE
ljceaiaaaa	TRUE
ljcijbaaaa	TRUE
mckcooaaaa	TRUE
mckhjcaaaa	TRUE
mmmbmlaaaa	TRUE
mmmengaaaa	TRUE
ngenlgaaaa	TRUE
nghdndaaaa	TRUE
oapambaaaa	TRUE
oapfgkaaaa	TRUE
oliploaaaa	TRUE
oljggbaaaa	TRUE
pgbcdcaaaa	TRUE
pgcmokaaaa	TRUE
aabhfbceee	FALSE
aacppgpgii	FALSE
alhdnklceg	FALSE
alilonedpf	FALSE
bfkkfmpkmi	FALSE
bfknmgkhhh	FALSE
bpjfhaghpo	FALSE
bpkejgajom	FALSE
ckagbjdibd	FALSE
ckcioefiad	FALSE
dekedmgnlm	FALSE
demlmiafna	FALSE
doknaidemd	FALSE
dolhmelibj	FALSE
ehfoejfpfg	FALSE
ehihpfnpem	FALSE
fbmljpgndh	FALSE
fbmolhclmp	FALSE
fmhpilbpbm	FALSE
fmjibpgggj	FALSE
ghcdkfpckp	FALSE
ghcjfmnbef	FALSE
hapbjkddhi	FALSE
hbahkiepfp	FALSE
hlblojnihl	FALSE
hlbmjijchp	FALSE
ifmbifdhbd	FALSE
ifmkadggpg	FALSE
ippoganalf	FALSE
jaacjcbeam	FALSE
jkalmfkmba	FALSE
jkbcpdpiai	FALSE
kefileegll	FALSE
kefnipebmc	FALSE
kopglhfhhd	FALSE
kpbdfhlakh	FALSE
liihddlfak	FALSE
lijfhejkfk	FALSE
mcgngodhdm	FALSE
mciefhlmhj	FALSE
mmmncekego	FALSE
mmnmoehimb	FALSE
nhcpbknghe	FALSE
nhdgkmamnj	FALSE
obalddnjmn	FALSE
obbppdodki	FALSE
olhojppnnd	FALSE
oliepmgihj	FALSE
pfkloidllo	FALSE
pfkpajhpnc	FALSE
aacijkhgkaa	TRUE
aafcalgeaab	TRUE
akghjfbaaaa	TRUE
akgilhjaaaa	TRUE
bghaokkaaaa	TRUE
bghcgepaaaa	TRUE
bpmihlmaaaa	TRUE
bpnhfafaaaa	TRUE
cikbpfeaaaa	TRUE
cikjndmaaaa	TRUE
dcbgidiaaaa	TRUE
dcbhnaiaaaa	TRUE
dnajkehaaaa	TRUE
dnanngaakaa	TRUE
eheknjhaaaa	TRUE
eheocoeaaaa	TRUE
fahpidhaaaa	TRUE
fakipikaaaa	TRUE
fjmnahkaaaa	TRUE
fjndgemaaaa	TRUE
gbpjplpaaaa	TRUE
gcanbhiaaaa	TRUE
gngmjobaaaa	TRUE
gngnhinaaaa	TRUE
hiecmncaaaa	TRUE
hiehaiaacaa	TRUE
icelklaagaa	TRUE
icfnckfaaaa	TRUE
inlpgcbaaaa	TRUE
inngfogaaaa	TRUE
jiccjmeaaaa	TRUE
jidfnoeaaaa	TRUE
kbmlcklaaaa	TRUE
kbnhkmpaaaa	TRUE
kmfgeghaaaa	TRUE
kmgjidbaaaa	TRUE
lgdlfgdaaaa	TRUE
lgeifmgaaaa	TRUE
mbddnajaaaa	TRUE
mbdpmadaaaa	TRUE
mmagghcaaaa	TRUE
mmbdnnhaaaa	TRUE
ngcmflbaaaa	TRUE
nggefncaaaa	TRUE
oanglcpaaaa	TRUE
oankgdiaaaa	TRUE
okndljiaaaa	TRUE
oknedilaaaa	TRUE
penkmimaaaa	TRUE
pepbofdaaaa	TRUE
aacijkhgkca	FALSE
aaflgeabacf	FALSE
akkiefbgfpl	FALSE
akkkghlfjmp	FALSE
bfdfmneiemb	FALSE
bfdjmdkdlmo	FALSE
bpibkiocldn	FALSE
bpjjobafgec	FALSE
cipgpjaakph	FALSE
cjajcgbhkdk	FALSE
dckdffpklfn	FALSE
dclfhiafmah	FALSE
dndmaggplfc	FALSE
dndoemfikfk	FALSE
ehddegfliao	FALSE
ehdpihpjjag	FALSE
fakfabnhcfg	FALSE
fakgliodkla	FALSE
fjbigdochol	FALSE
fjbolcobfhn	FALSE
gbpliofkejo	FALSE
gcaipphpkpp	FALSE
gnnkfjkgebm	FALSE
gnodcnfphif	FALSE
hhlnhlhmefi	FALSE
hhobgelkpgk	FALSE
icbpkghlmkg	FALSE
icdbmgmhjeb	FALSE
inengdpgmae	FALSE
infdhkbdelp	FALSE
jidlhfpgebb	FALSE
jiedembbpnh	FALSE
kchkpgpmiih	FALSE
kcicdabiagh	FALSE
kmeohgcbapl	FALSE
kmihjodknee	FALSE
lhaglbnknil	FALSE
lhcaingilfp	FALSE
mbkgnpgmkmp	FALSE
mbknobamcbf	FALSE
mlglpolifij	FALSE
mlgmhjmfmok	FALSE
ngaiejmeddd	FALSE
ngajnoophog	FALSE
oapkmahfflb	FALSE
obbkchoopif	FALSE
okolhnnhgcb	FALSE
okpfpoabodp	FALSE
pfbaicjkjhh	FALSE
pfbpaddinfm	FALSE
aacijkhgkcaa	TRUE
aafalgeabaab	TRUE
akkkjekdaaaa	TRUE
akliilmhaaaa	TRUE
bfkiimacaaaa	TRUE
bfljklejaaaa	TRUE
bpnnljjaajaa	TRUE
bpnnooonaaaa	TRUE
cjfcljjeaaaa	TRUE
cjgfkpilaaaa	TRUE
dcboohakaaaa	TRUE
dccjkoopaaaa	TRUE
dmohnhilaaaa	TRUE
dmpeldgjaaaa	TRUE
egkbgnolaaaa	TRUE
egknimjpaaaa	TRUE
falbhnpeaaaa	TRUE
famfmfnfaaaa	TRUE
filaffpcaaaa	TRUE
fipdhplmaaaa	TRUE
gcjigejeaaaa	TRUE
gcnealpdaaaa	TRUE
gnlfdjebaaaa	TRUE
gnlgldcpaaaa	TRUE
hiaglldlaaaa	TRUE
hibcfcdfaaaa	TRUE
icfhnmdeaaaa	TRUE
icfohicoaaaa	TRUE
imnmnnpaamaa	TRUE
imnodlbkaaaa	TRUE
jiaepdoeaaaa	TRUE
jibdkknfaaaa	TRUE
kceeidelaaaa	TRUE
kcfhkamiaaaa	TRUE
klokeofmaaaa	TRUE
klphnfjbaaaa	TRUE
lhbjahkdaaaa	TRUE
lhbnjfkpaaaa	TRUE
mbehooaoaaaa	TRUE
mbgjlfhnaaaa	TRUE
mljlbfmpaaaa	TRUE
mlkeneliaaaa	TRUE
ngemanbpaaaa	TRUE
ngigilcnaaaa	TRUE
oakonaieaaaa	TRUE
oaleiikbaaaa	TRUE
olboeppmaaaa	TRUE
olbpnldaapaa	TRUE
pekepljgaaaa	TRUE
pekjkknnaaaa	TRUE
aaafjapfodhf	FALSE
aaahjljidobe	FALSE
ajmkjjagpago	FALSE
ajnbjhbgdnlp	FALSE
bdngdcepophb	FALSE
bdnpgniipnmm	FALSE
bpcacpbaopkd	FALSE
bpckmghnefdi	FALSE
ckbleijclcgd	FALSE
ckblicdbjpfc	FALSE
dedejdijnicg	FALSE
dedlgkfgjfen	FALSE
doejlkmjlmjd	FALSE
dofedijoohdk	FALSE
eikglomfjlkm	FALSE
eikideoojgkj	FALSE
fdmmmlfehdmp	FALSE
fdojbfdgjago	FALSE
fnkbhamgapjp	FALSE
fnkcmnamlmnb	FALSE
ghejebbnkjkh	FALSE
ghfjgfjaifgl	FALSE
hcdibipfhdfl	FALSE
hcdlhmedjagm	FALSE
hmeogjhnjgff	FALSE
hmfamnabgghk	FALSE
ifmcnefcjjgo	FALSE
ifmdopcibojm	FALSE
ipflmdofplkg	FALSE
ipgdjmglhlko	FALSE
jioiapcdenll	FALSE
jipkgffgciak	FALSE
kcnpkiojmeag	FALSE
kcokkfcfmblk	FALSE
kmcgdlgbekfn	FALSE
kmckhjkfllpi	FALSE
lglnbckhmkbh	FALSE
lgmflhjcjjpk	FALSE
mbmdcaejaiji	FALSE
mbnbalgnabmp	FALSE
mlflmpeobmke	FALSE
mlgbamdkgbjh	FALSE
nfmjfklnbnfb	FALSE
nfmnpafgfgnj	FALSE
npldngbbbkci	FALSE
npllnofbghdf	FALSE
okdjbolehidj	FALSE
okgbldolcbci	FALSE
pfllgfijmchh	FALSE
pflojadpfenc	FALSE
aaafjapfodhaa	TRUE
aaahfjljidoaa	TRUE
ajnpablldaaaa	TRUE
ajobjfdcpaaaa	TRUE
bejlpklpaagaa	TRUE
bejoiepdfaaaa	TRUE
bpemmahbpaaaa	TRUE
bpffjgcjaaoaa	TRUE
ckepamjbfaaaa	TRUE
ckfidkjldaaaa	TRUE
delnpdabmaaaa	TRUE
deloblpjcaaaa	TRUE
dodlefbabaaaa	TRUE
doeggcicnaaaa	TRUE
ejlglbaaeppaa	TRUE
ejndijjccaaaa	TRUE
fdfpgegfaakaa	TRUE
fdgkddindaaaa	TRUE
fngnbaplfaaaa	TRUE
fninpdenaajaa	TRUE
ghkejmgdiaaaa	TRUE
ghkikkefcaaaa	TRUE
hbpgnpjjpaaaa	TRUE
hcbdlpppjaaaa	TRUE
hmoecanbgaaaa	TRUE
hmohmlnppaaaa	TRUE
ifoihenikaaaa	TRUE
ifokafgcdaaaa	TRUE
iphlapagaaeaa	TRUE
ipienbpccaaaa	TRUE
jjdnkcockaaaa	TRUE
jjeafiiooaaaa	TRUE
kcbjikhdnaaaa	TRUE
kcbkncihcaaaa	TRUE
kmldglnicaaaa	TRUE
kmllcbcmhaaaa	TRUE
lhibfnngcaaaa	TRUE
lhkgmgonlaaaa	TRUE
mblkldknoaaaa	TRUE
mblonnkcfaaaa	TRUE
mlmpgglmlaaaa	TRUE
mlnhlgeanaaaa	TRUE
nfogdoillaaaa	TRUE
nfoglieceaaaa	TRUE
npkeodjomaaaa	TRUE
nplifeodaaaam	TRUE
okdohedkcaaaa	TRUE
okeeiafbaamaa	TRUE
peneajaocaaaa	TRUE
penlgmmboaaaa	TRUE
aaabanfmpodhp	FALSE
aaaimodmdfpej	FALSE
albldgblgjlck	FALSE
albphceldcmdf	FALSE
beooplhiiimlj	FALSE
bepppgjlemllg	FALSE
caadaaaaefjbg	FALSE
cabjfcejaafnh	FALSE
cjaonahaobijo	FALSE
cjbadjmlcjajj	FALSE
dddjjfnpbpkol	FALSE
ddeihjiabckgj	FALSE
dopgbkofohplc	FALSE
dopgcongdcgkk	FALSE
ejeedipdkiafa	FALSE
ejegammljkfhf	FALSE
fbkgioaekhlka	FALSE
fblfnlbcclfcl	FALSE
fmgfepdmljbio	FALSE
fmidmlblofjfc	FALSE
ggjienmifngoa	FALSE
ggjodpmonlhbi	FALSE
hbchejomhmaji	FALSE
hbclpccbdphdg	FALSE
hmlkdpkimeaop	FALSE
hmmdfcghdokgl	FALSE
ihjbdnplcdpcf	FALSE
ihkgacfnpiggd	FALSE
jbbomjgbfcinf	FALSE
jbcajapjboagc	FALSE
jmeabfeoibidc	FALSE
jmfmehapbpnea	FALSE
kfgaelpbldljb	FALSE
kfgihacmbkmfn	FALSE
konbmddjgenkg	FALSE
koofahfnceooa	FALSE
ljfbhcjflhgbj	FALSE
ljfehaohmjlno	FALSE
mejfifhhlneno	FALSE
mejidecmahgnk	FALSE
mohokfpljjalk	FALSE
mojikfcbkmfno	FALSE
nhenhbkpkmhfa	FALSE
nhenkjhdingbg	FALSE
obdibelfmnmdf	FALSE
obdjdehenfakh	FALSE
olcaellaaldco	FALSE
olcnkpglfccbl	FALSE
pffnabhpamokb	FALSE
pfglikeoilfko	FALSE
aaabanfmpodhaa	TRUE
aaaipmodmdfpaa	TRUE
alehdooacpaaaa	TRUE
alehfpjkiaaeaa	TRUE
bgciopjmlpaaaa	TRUE
bgeenalgnfaaaa	TRUE
caaehlfagehhaa	TRUE
cabloddpjoaaaa	TRUE
cjecnebfmcaaaa	TRUE
cjeddchioeaaaa	TRUE
dckkmdkolfaaaa	TRUE
dckpanenpjaaaa	TRUE
dpboaddhjfaaaa	TRUE
dpcjnkbikgaaaa	TRUE
eipniidocaaeaa	TRUE
ejbmpojpdfaaaa	TRUE
fbpamoknplaaaa	TRUE
fbpdpdjcncaaaa	TRUE
fmadekaembaaaa	TRUE
fmcbpnlnmdaaaa	TRUE
ghagehofnmaaaa	TRUE
ghagphjeegaaaa	TRUE
hbiafkibedaaaa	TRUE
hbidonlcnfaaaa	TRUE
hmfdenkckgaaaa	TRUE
hmggdlggkjaaaa	TRUE
igimogifnoaaaa	TRUE
igligmdbpiaaaa	TRUE
jbflfcmlcaaiaa	TRUE
jbfmomhaebaaaa	TRUE
jlgmggakblaaaa	TRUE
jlhgljcnjcaaaa	TRUE
kfaoegpoojaaaa	TRUE
kfbepogpgjaaaa	TRUE
koidhppfkeaaaa	TRUE
koijbjkncgaaaa	TRUE
lkdjjmejabaaaa	TRUE
lkgajmicfeaaaa	TRUE
mecihioabmaaaa	TRUE
meejafphemaaaa	TRUE
mocfjppddpaaaa	TRUE
modoabeecfaaaa	TRUE
nhikhnijpjaaaa	TRUE
nhlbepoincaaaa	TRUE
obidnncomfaaaa	TRUE
obikcdmeciaaaa	TRUE
ollgbabheaaiaa	TRUE
olmamgmlleaaaa	TRUE
pfpdpggbfpaaaa	TRUE
pfpimjpdcoaaaa	TRUE
aaadcejkeegfdn	FALSE
aaafgoceiogbaj	FALSE
akplphkaggdhbj	FALSE
alaclodkffjglo	FALSE
bffldabaaogkcp	FALSE
bfgacndoehgjbo	FALSE
caiihdjcdoiagn	FALSE
cainamgdingjaa	FALSE
cmflpbbcfadlgj	FALSE
cmgdlalmmmfpfl	FALSE
dflnjnmkjmocgn	FALSE
dflpogbaedjgnm	FALSE
dpdlmlajiegbgi	FALSE
dpdnlfidgkeggn	FALSE
einobbdofaelfd	FALSE
eiogdeebihpnjg	FALSE
fdbgdkfbmopbam	FALSE
fdbhlnlijbdbnk	FALSE
fnnlcdfalkeobf	FALSE
fnnoijmmmeiomd	FALSE
gjcjpgginjnalp	FALSE
gjdkhpckbfmhdj	FALSE
hcpmfobmlagdid	FALSE
hdaicdfbpbeakj	FALSE
hngeofmpbkedlo	FALSE
hngjkgcleiahhi	FALSE
ihlminhmmpciao	FALSE
ihmemdoakcajan	FALSE
jccchhddnejdfl	FALSE
jcdebiinkcpbaf	FALSE
jmclomcihipcea	FALSE
jmfeabjhjcbbpc	FALSE
kggpdidkdaoone	FALSE
kggpjflclnmgdo	FALSE
lagafnhlhoakfa	FALSE
lagnajlkcalnga	FALSE
lkjbpbalgafela	FALSE
lkjjmnmbdphijm	FALSE
mepcflidifghch	FALSE
mfaokmciolklhk	FALSE
mpjcnoifeoolpl	FALSE
mpkeljjiiimgee	FALSE
njnhjhlnmmnklg	FALSE
njobppanodnhbk	FALSE
ocoodpiclkbkmi	FALSE
ocpfhbloocpjge	FALSE
omlbkbclcgmkdi	FALSE
ommgkkngpcjcbc	FALSE
pgidbapmjncaeo	FALSE
pgigicpjjkapnc	FALSE
aaadcejkeegfdaa	TRUE
aaafngoceiogbaa	TRUE
akodohbiamaabaa	TRUE
alaldedlhpnaaaa	TRUE
bgojedfleolaaaa	TRUE
bgpppehnjmkaaaa	TRUE
calfhpbpkceaaaa	TRUE
calkfinbcngaaaa	TRUE
clncdhobfkaaeaa	TRUE
clnfdhlehimaaaa	TRUE
dfegknoafngaaaa	TRUE
dfenfgiiklhaaaa	TRUE
doocnmddgfeaaaa	TRUE
dopcifbnemjaaaa	TRUE
ejabommkjnlaaaa	TRUE
ejakicchancaaaa	TRUE
fdbiehcfoajaaaa	TRUE
fdbipfhcaphaaaa	TRUE
fnkkbmhnhnpaaaa	TRUE
fnkpegacaeoaaaa	TRUE
gijjaddjjbjaaaa	TRUE
gijndopookhaaaa	TRUE
hddfmfojjlbaaaa	TRUE
hddkelhoopeaaaa	TRUE
hnmaihbhjdfaaaa	TRUE
hnnocdnfbhnaaaa	TRUE
ihmhogcchdeaaaa	TRUE
ihnebhacgjbaaaa	TRUE
jceapmjkilmaaaa	TRUE
jcebplhikccaaaa	TRUE
jmhfmbcfpoiaaaa	TRUE
jmhihecfgloaaaa	TRUE
kfpdcaibkgfaaaa	TRUE
kfpfnpcnecpaaaa	TRUE
lahhocojhmiaaaa	TRUE
lahnkidhhflaaaa	TRUE
lkfjnhcnnoeaaaa	TRUE
lkgkdpijjlaahaa	TRUE
menlomibnjnaaaa	TRUE
mennjbokipkaaaa	TRUE
mpiiejlamimaaaa	TRUE
mpkhklmmhakaaaa	TRUE
njdapbacplcaaaa	TRUE
njdejpilhmmaaaa	TRUE
odbdeoeljmcaaaa	TRUE
odblepompgaaeaa	TRUE
omcepbolajgaaaa	TRUE
omcmmgpfebgaaaa	TRUE
pgbfiedogpnaaaa	TRUE
pgbgopnnpmeaaaa	TRUE
aaacokbpdjakodg	FALSE
aaaeiodppinpjbk	FALSE
akgcolnmldbdjeo	FALSE
akhelojkogpdbbb	FALSE
bebpkhdhcodopmj	FALSE
beejhdmfdehjifd	FALSE
bogjcihnlepklpb	FALSE
bognmjnlnmnglbd	FALSE
cglnlpaigigkfdk	FALSE
cgnaedlnhokcknf	FALSE
dckdimllmdoaebl	FALSE
dckealpmijjcncb	FALSE
dmddilecbagkfcb	FALSE
dmeeadcajgfbmga	FALSE
eglbabbdnjoeajh	FALSE
eglcddingkinpbb	FALSE
faieidnbaiihjam	FALSE
faijkdbpiflecha	FALSE
fjhgbgfniaaeehc	FALSE
fjilagnmjbgieib	FALSE
gcnipbmlagcikba	FALSE
gcnjgppjihakcbc	FALSE
gnidkhpgcejpmhf	FALSE
gnincpicmnlhhgm	FALSE
hhhipghanlgfcma	FALSE
hhhmbfdcpenjbfo	FALSE
idadenfjhdfcpmf	FALSE
idaklmnmkiccinl	FALSE
innaolbcjpcfaed	FALSE
inocpdpjdgnpbfp	FALSE
jilmnllclmpnbaa	FALSE
jimaaeecenhfacd	FALSE
kcjgcmjhhfgligl	FALSE
kcjkfcacngdpfgg	FALSE
kmagcadfbjpaemh	FALSE
kmalkkffidnfmbn	FALSE
lfgegiamnkicfke	FALSE
lfgokefmjakacjg	FALSE
maagkepgplalmbi	FALSE
maajglalcldklgh	FALSE
mjoobecmpklkkda	FALSE
mjphbaiffgebllh	FALSE
ndjcnmehdebjlfc	FALSE
ndjobjcdmmgmeem	FALSE
nohhfiilkhpnmhn	FALSE
noikbgbpkemocdg	FALSE
ojpjlmnicfgfpfb	FALSE
okaameehpgbiabn	FALSE
pecenoaogjpeiai	FALSE
pecledihlilgpig	FALSE
aaakipehmpffemaa	TRUE
aaamgenpfainiiaa	TRUE
akflcaacpnnmgnaa	TRUE
akhfeaigamoiaaaa	TRUE
bfcpnjphnhapaaaa	TRUE
bfcpnldfmhkaalaa	TRUE
bokpafafjlcaajaa	TRUE
bolmmlacnkepaaaa	TRUE
cingpjnkammmaaaa	TRUE
cinkkdckhdjpaaaa	TRUE
debkiaoolebpaaaa	TRUE
deblpajbpnhnaaaa	TRUE
dpmmfdadedflaaaa	TRUE
dpndpceehehaaaab	TRUE
elbjcekhknifaaaa	TRUE
elbjfejildjmaaaa	TRUE
fegicpcbjmipaaaa	TRUE
fegojegiifjmaaaa	TRUE
fpbefhiliegoaaaa	TRUE
fpbmjfkpacldaaaa	TRUE
gilnnkpdjkmpaaaa	TRUE
gilpohjfkfedaaaa	TRUE
hedhelkeflplaaaa	TRUE
hedppjenjdikaaaa	TRUE
hpkgfbmhgappaaaa	TRUE
hpmagkbhfhilaaaa	TRUE
ijkaiaacipfplhaa	TRUE
ijkboiniidpaamaa	TRUE
jdicgbpheihkaaaa	TRUE
jdjdabameiopaaaa	TRUE
joapmkfiabkgaaaa	TRUE
jobeikihimafaaaa	TRUE
khdmmomihddaacaa	TRUE
kheodppengaiaaaa	TRUE
ladgjhfopnkbaaaa	TRUE
ladgmikclebdaaaa	TRUE
lkhaaeinnkhlbhaa	TRUE
lkhchnhaccojaaaa	TRUE
meikfaljgjbnaaaa	TRUE
meiplanknkdbaaaa	TRUE
mpbaigjdlgmhaaaa	TRUE
mpcikpenpndkaaaa	TRUE
nihahonlaeodaaaa	TRUE
nihgcaangdaeebaa	TRUE
objhdkdmljefaaaa	TRUE
oblfigmlfagmaaaa	TRUE
oklmljkhedenaaaa	TRUE
oklnjdidopjcaaaa	TRUE
pflpaepeieehaaaa	TRUE
pflpdoghoomoaaaa	TRUE
aaakipehmpffemge	FALSE
aaamnpfainiibidj	FALSE
akggahnkonidinhb	FALSE
akhbhaabpmbkjfla	FALSE
behmfbofljebacje	FALSE
bejahnnmdgcggege	FALSE
bpemimalkbgdidgi	FALSE
bpflinhooflabaif	FALSE
cjmidockheagekni	FALSE
cjodbjngbnbnpofh	FALSE
delflaafabchnfpm	FALSE
deljlpmbiclpppfj	FALSE
dpjedjhnbdgknflf	FALSE
dpllnilgmmkplpkb	FALSE
ekcgiocjmodfmigo	FALSE
ekdllochfliaiddm	FALSE
ffafnhknkjhagbje	FALSE
ffapmkhndpklokjf	FALSE
fohplpillpfefgcj	FALSE
foieoiplidacbcnp	FALSE
gjgfjakoadmpdbfj	FALSE
gjggfkpmbdpbeide	FALSE
hechplbopjooeajj	FALSE
hedkdbdmgijgbieo	FALSE
hphhofegdljgllke	FALSE
hphopcpgdjfbaefa	FALSE
ijcjaapbjankdeed	FALSE
ijcnjppcgkgjelco	FALSE
jdfnekimemlfmgdc	FALSE
jdggdjefjnlelick	FALSE
jnndjjnpfkdjbagp	FALSE
jnnmicbihekgdobd	FALSE
kgmkjnbkomcmhlog	FALSE
kgnoijfhlnbkccdd	FALSE
laklnnoiiiokndei	FALSE
laknnklbgjngdhcg	FALSE
llcjihjjpnjgdcnm	FALSE
lldcehbpkikmfbpf	FALSE
mebhlddpooplhcia	FALSE
mebkbhgijpgcekme	FALSE
mpaindfaaginhlmd	FALSE
mpblbphialoienaf	FALSE
nikaaoealnjpppli	FALSE
nikacepdngfddbah	FALSE
obifclalkhchfhda	FALSE
obimojpbfabeojmg	FALSE
oldfaadeocjfnnhb	FALSE
oldgpflpeljklgdm	FALSE
pfldilndkkkjdhdh	FALSE
pflgkopnaemgkmph	FALSE
aaabodojddkopenaa	TRUE
aaajdebomablmfmaa	TRUE
aipgcjnnlngjhaaaa	TRUE
aipmkogneclakaaaa	TRUE
bdmlgpllefchlaaaa	TRUE
bdnflamhbkiegaaaa	TRUE
bmmkkmjoaoecpaaaa	TRUE
bmnlekioljjpgaaaa	TRUE
cfnjdageeknlpaaaa	TRUE
cfnpoocejoahbaaaa	TRUE
copmhedbgphmmaaaa	TRUE
copnamcbphcpdaaaa	TRUE
dkcgeaeglmdhaabaa	TRUE
dkdcgjijibiepaaaa	TRUE
edhambkmccopcaaaa	TRUE
edihdoehlphfcaaaa	TRUE
eocopaecfeeobaaaa	TRUE
eocpcekjnebeaagaa	TRUE
fiiloclbikcipaaaa	TRUE
fijkkdaccklbmaaaa	TRUE
gdhnpokopejagaaaa	TRUE
gdinihmecbkopaaaa	TRUE
gobodijigocmaahaa	TRUE
gockogjdipainaaaa	TRUE
hjabhnpdjcdicaaaa	TRUE
hjcoanijibijjaaaa	TRUE
ifadmiljkkmfaaoaa	TRUE
ifbacbaoibihdaaaa	TRUE
iogjjeakalfobaaaa	TRUE
iohioacojnlkkaaaa	TRUE
jhiljjfijilleaaaa	TRUE
jhkaiifkbhjnmaaaa	TRUE
kbhjffiigmlmeaaaa	TRUE
kbigenhialbofaaaa	TRUE
kmobpmhafpegeaaaa	TRUE
kmohdgcgpoklbaaaa	TRUE
lginajpaiinckaaaa	TRUE
lgjmgadjjmekdaaaa	TRUE
mcbmcmhmdojndaaaa	TRUE
mcbmjpagmhedmaaaa	TRUE
mljllinghlnbnaaaa	TRUE
mljmecobfidpaadaa	TRUE
ngdebanpjndnbaaaa	TRUE
ngeiggachmkabaaaa	TRUE
oahhjifgpdlhkaaaa	TRUE
oaihamldchkohaaaa	TRUE
okjopijfjdcocaaaa	TRUE
okkgkmebdeiheaaaa	TRUE
pfgnjfmapimggaaaa	TRUE
pfhfmhpacodpcaaaa	TRUE
aaaijjbdjjbjkfnpf	FALSE
aabajaifjcmkfmjgb	FALSE
akihjhagjcpgbhnek	FALSE
akjmibikpkemldocn	FALSE
behefcagdoahmokjo	FALSE
beighijldpkjojbfo	FALSE
bpaoaamdbeolkepko	FALSE
bpcclcgngchmoelol	FALSE
cjjgcnjiidoooelal	FALSE
cjlkadnaafgagnpli	FALSE
deliphcojmmehpmbc	FALSE
denlbanlkfclgbklb	FALSE
dphpbblpcokphbili	FALSE
dpiiicgfhnlkefmck	FALSE
ejcinpjkhgaijmebi	FALSE
ejdlkahhdhcdfofid	FALSE
feklchdncjmkpedck	FALSE
fekllgooojoiaobca	FALSE
fokjinjhccmhigidl	FALSE
fokmgofecnhagepgd	FALSE
giihelddneiiikneb	FALSE
giipoemopoclnfkdb	FALSE
hdefhmajfbocdbepf	FALSE
hdekloecggapjpgge	FALSE
hobcilaocjjhhgoji	FALSE
hobloigdollhkhcaj	FALSE
ihgmgfflbnoggahgh	FALSE
ihhdcnlhdaopekked	FALSE
janhkdblfkdcaioal	FALSE
jaofhabdjhpfkdfnk	FALSE
jlfmjhijaiiialhek	FALSE
jlfniilacldicabnc	FALSE
kgfjdfgaaodfdggoa	FALSE
kghhmnkmgmghfaijj	FALSE
laifdbogjcdecplip	FALSE
laihmefebmgfkbijl	FALSE
lkglbeepdagampcal	FALSE
lkmgilijneakjocck	FALSE
mdnjlgnephcdodhjd	FALSE
mdofojgemcdealogb	FALSE
mnmglggogllelhhlo	FALSE
mnomacpekgobnlikf	FALSE
nigknklfcbccpkggk	FALSE
nihlfgaiiikldinen	FALSE
obpdognakgledpmeb	FALSE
ocaecmhcplnknbima	FALSE
olonnoeccjjaidgcl	FALSE
olpbccnhnpibhdgjm	FALSE
pfofgmebhfppkcfld	FALSE
pfpgficiojpjpjofi	FALSE
aaaecbjnmnghdemfaa	TRUE
aabkcgciomcgnpdnaa	TRUE
ajpkbldfffcfpoaaaa	TRUE
ajplmmagelidegaaaa	TRUE
bgfpgakmicfnfmaaaa	TRUE
bggjghpnngoegfaaaa	TRUE
bpcnnfjfaegoceaaaa	TRUE
bpdngfigopelccaaaa	TRUE
cjpkdhlamlcpfiaaaa	TRUE
cjpmkeedfjhmgbaaaa	TRUE
deelaadlilooblnfaa	TRUE
defedenbffajodaaaa	TRUE
doppmhajpeamhbaaaa	TRUE
dpacedidmpnolhaaaa	TRUE
ekcmgebiicplmkaaaa	TRUE
ekdhjdgnfghejoaaaa	TRUE
fdgjaoffgmnlkaalaa	TRUE
fdikijdmcbnfacaaaa	TRUE
fnhplbogakjkbeaaaa	TRUE
fninfmnjfdodblaaaa	TRUE
gikkggkonkcilhaaaa	TRUE
gilgnnggomkefoaaaa	TRUE
hboaegocobacpkaaaa	TRUE
hbpjpgdafcacibaaaa	TRUE
hmdonlljcmmlknaaaa	TRUE
hmfbccmmghihmeaaaa	TRUE
ihapnhpmpnkiahaaaa	TRUE
ihbafaokjcijjiaaaa	TRUE
jcohhnheoanpkmaaaa	TRUE
jdaeoaacjiofklgmaa	TRUE
jnccmpgokgpefaaoaa	TRUE
jncdjhlifbfjhgaaaa	TRUE
kibomipjdcmgghaaaa	TRUE
kicnakleimhlleaaaa	TRUE
lciopdandgmmlcaaaa	TRUE
lcjagojlgbnajfaaaa	TRUE
lllgffdlonlnhaafaa	TRUE
llmdcoaodaoojaamaa	TRUE
mfkpnebfdpefgeaaaa	TRUE
mflkjpfejgopfpaaaa	TRUE
nangkehabndldfaaaa	TRUE
napmeefdhddknhaaaa	TRUE
njlibkgpkhchkkaaaa	TRUE
njljjgplikponiaaaa	TRUE
ocohkfldlcbejiaaaa	TRUE
ocpbndiakbeehhaaaa	TRUE
omhiahbjgpjokoaaaa	TRUE
omieidnbcpnnpoaaaa	TRUE
pgihfogcamicimaaaa	TRUE
pgipigoanccidmaaaa	TRUE
aaaecbimlmfgcdlejb	FALSE
aabfbhnlbfmocmhbhd	FALSE
ajmiopapgmgjlinknc	FALSE
ajopaeijlddmcokhhc	FALSE
bfbdeobihpnodmlpbc	FALSE
bfbeibjimhfedpcjhm	FALSE
bphbdjfinhkhfpjmoh	FALSE
bpiijjkaadgiapckjf	FALSE
cjhadfgpgbehiomgnc	FALSE
cjhdjdabganpkjdbbd	FALSE
dephclngkebebkacbh	FALSE
depknfpfdfaofmnimh	FALSE
donmnfgmghofhjbccm	FALSE
dookgkbbngcihkokmd	FALSE
ejhjegjldkbhflagfe	FALSE
ejikjkkaapbggfagea	FALSE
fddgkcfhogmpjhbmih	FALSE
fdemdnjlmibgggnmob	FALSE
foafjlnfnkboahiahl	FALSE
focbjlhpodkmlfideb	FALSE
gjchfpfldmglngbjlj	FALSE
gjdikfoagenpcphedn	FALSE
hcibbomilodmbeghjn	FALSE
hcinkppehloemgamof	FALSE
hmklkneddfekeondgp	FALSE
hmmcodmdlppkohlfjc	FALSE
iiobddokppdkflgjbo	FALSE
ijaljfpmmfkbdijghi	FALSE
jcjfgecmhnbaniamdp	FALSE
jcjljlbgbbkniimpfg	FALSE
jmhpacibndphiiilhn	FALSE
jmillheajaiaihimof	FALSE
khpgngbcfljbeefnhd	FALSE
kicebhjafdfbiekcdc	FALSE
lccmofhmkemlclnnjo	FALSE
lcdkgkhpclinopeeih	FALSE
llgoggjiigbbnfddjk	FALSE
llhiebpnnakagegjke	FALSE
mggafdhafhbnhncahh	FALSE
mgjednmgffcjnakjdk	FALSE
nbachkdggmfpekjpam	FALSE
nbammhpmmccphekegm	FALSE
njmmjjpbikmeaccpej	FALSE
njnenclfofnccjnaed	FALSE
ocnfdppmeepkelikeo	FALSE
ocnggehgilbegpfbol	FALSE
omaacnccgiibpepobe	FALSE
ombflgfmcadhjbojmh	FALSE
pgenmoleiolnogchhi	FALSE
pgimkjngmlfpjafnga	FALSE
aaefjlkmebfojcdnhaa	TRUE
aaeikeaifnicipnaoaa	TRUE
akgjcfgcckpamneaaaa	TRUE
akhedghceimaofnaaaa	TRUE
bfkeaocfalflohgaaaa	TRUE
bfmengpaklhbjgjaaaa	TRUE
bphlgjochnoaklbaaaa	TRUE
bpiafldoadaehodaaaa	TRUE
cjigkgnfnhlcdibaaaa	TRUE
cjjjcmpadaaclcndnaa	TRUE
ddmelnkcbmlaediaaaa	TRUE
ddnamanoogdofiiaaaa	TRUE
dnjhdglngjjegpnaaaa	TRUE
dnkanmikkackpngaaaa	TRUE
eiohehobmloojmfaaaa	TRUE
ejapjcbpgkmejgcaaaa	TRUE
fcfhponohmbfofjaaaa	TRUE
fchpgenbglmfpecaaaa	TRUE
fnaeagfdlmbkkipaaaa	TRUE
fnbmpkkpnpgkkkdaaaa	TRUE
ggellmaedeoiehdaaaa	TRUE
gggaikdpoopmpciaaaa	TRUE
gpmkhmehijpmdkfaaaa	TRUE
gpmkmingemkdjmdaaaa	TRUE
hjnnecjoalbccckaaaa	TRUE
hkailmpkafgnjmpaaaa	TRUE
idpiedajbghpjpjaaaa	TRUE
ieaejdmlhahhmdkaaaa	TRUE
ipkcpfiknmhnfhlaaaa	TRUE
iplgpfgfkjkemijaaaa	TRUE
jipppfibodahlemaaaa	TRUE
jjccmnijdklhgbaalaa	TRUE
kefcgoonlpmmodjaaaa	TRUE
kegkilklihjjgcpaaaa	TRUE
kokeaeicabloindaaaa	TRUE
kololmbecimoeepaaaa	TRUE
lhjdialilnckdngaaaa	TRUE
lhjnckoeljfpnkfaaaa	TRUE
mcimbjagpmhpdfpaaaa	TRUE
mcljiepdjihbipoaaaa	TRUE
mmlfnipaabichmdpgaa	TRUE
mmlmpebefgmgfidaaaa	TRUE
nhgemabcnianfnfaaaa	TRUE
nhggefdjniikmakaaaa	TRUE
oaoamkfpkppalmgaaaa	TRUE
oaobcfgkkofaajlggaa	TRUE
okmedfcjdjgagndaaaa	TRUE
okonffhneedhomlaaaa	TRUE
pfefiifnbocljccaaaa	TRUE
pfehpolffmblfhcaaaa	TRUE
aaabehcdhdkcndmhhig	FALSE
aabeeonapcfibdbkkda	FALSE
aknmkedlhlaejdocihh	FALSE
aknplagncppiolodgak	FALSE
bfmllpkbjanfpmnajld	FALSE
bfmlmdnlcjblfflodgn	FALSE
bpjoeojoffohmcmcbpe	FALSE
bpkiemjpjfcpgcdkolk	FALSE
clgdcjlkifnlanblfdp	FALSE
clgiloakknoeiglifla	FALSE
dfchgbaelbpmpoaddbc	FALSE
dfcjahepijfnohnihlj	FALSE
dpghfeajhlahefgihpc	FALSE
dphifeljaldooogdmih	FALSE
ekpicopgcikjkljnmdp	FALSE
ekpnlmkjdkmkgpggahm	FALSE
fgdckmdikbigpnhmmel	FALSE
fgdcmfbeeiglidhihef	FALSE
ganibjfpddigncgahef	FALSE
ganmcifcodbbkfbkifb	FALSE
glmigcideifdbmpmoli	FALSE
glmpnkdjhpabiklakln	FALSE
hfgjfljemkbkfmkjjoe	FALSE
hfgkffcemccjnpddcjf	FALSE
hpcjgmkplceokldicgf	FALSE
hpenppmljlpkjbdmokp	FALSE
ijmlabdhldcmbialdbm	FALSE
ijnhnihbogbinhgkbod	FALSE
jeebmdegikgefmgjdch	FALSE
jefamfmnabhojcpfflp	FALSE
jnfmcepcelepaebhhlk	FALSE
jnhdpkkefibjiomkhpc	FALSE
khaiopnoiofegeockch	FALSE
khajeaidfajlhjmdafb	FALSE
landnlkboinfahcbaii	FALSE
laneaffngognohggcbk	FALSE
lkkhkcoomjemcijnkfd	FALSE
lklecnnoinpdgbobhlf	FALSE
mffblmakeglonhoedlg	FALSE
mffndjnihngakjppmcp	FALSE
mpnodhlppagghikpcbf	FALSE
naamlegagofhpagadcg	FALSE
njkddfilobfaeoogneb	FALSE
njmemanoobaklbnmhfi	FALSE
odbpnemdiofjmbnjkhp	FALSE
odcmhahfjmhkbemjmen	FALSE
omhddnfhajbciekoben	FALSE
omipibeekofogajjkkf	FALSE
pgaleagcbkbdaeboamm	FALSE
pgcoenoplhmlfaoodbl	FALSE
