aaadipaccp	TRUE
aaajcjjdal	TRUE
akhfgeejjo	TRUE
akhnpnpcpo	TRUE
beapgbnalm	TRUE
beapnclhcn	TRUE
boacoipedg	TRUE
boaodjmcae	TRUE
chlgjjfkdn	TRUE
chlnjddjaf	TRUE
dbcikeecch	TRUE
dbcpgoimbp	TRUE
dmcgbhfdia	TRUE
dmedcbnbld	TRUE
efodgfilgl	TRUE
efpcfempbd	TRUE
falhggheee	TRUE
famfgcdakj	TRUE
fjlamgjool	TRUE
fjmniibdke	TRUE
gdjfnpiaog	TRUE
gdjlllpcpp	TRUE
goppfjjmem	TRUE
gpamnphmcd	TRUE
hjhllceecn	TRUE
hjieeanpla	TRUE
ieimfcgmoc	TRUE
iekdbmdiai	TRUE
inocmcgmcc	TRUE
inollbfibh	TRUE
jidppacibk	TRUE
jigelnibne	TRUE
kceehfdpkl	TRUE
kcgnkgalef	TRUE
knjidhjdfp	TRUE
knjnboakil	TRUE
lhpmbiaakk	TRUE
libcnphkeg	TRUE
mddkomdbjl	TRUE
mdedcaljjh	TRUE
mmofgbajph	TRUE
mnbcpmhihc	TRUE
nhmcpamhil	TRUE
nhmfbaopaj	TRUE
oaipdeakkp	TRUE
oajegepodo	TRUE
olpfegemmk	TRUE
olpmdbjmoi	TRUE
pfefpgiojh	TRUE
pffganacpm	TRUE
aaacjopjab	FALSE
aaadgcopab	FALSE
ajoofhcoab	FALSE
akbgdefpab	FALSE
bdkmfhlfab	FALSE
bdknebhaab	FALSE
boccmhhlab	FALSE
boeeagkdab	FALSE
cibejdkbab	FALSE
cibmadodab	FALSE
dbfofkdnab	FALSE
dbgjddjaab	FALSE
dleincmfab	FALSE
dlepomciab	FALSE
egeognofab	FALSE
egfhemagab	FALSE
fbampnkoab	FALSE
fbcdbmdgab	FALSE
fjnhcngcab	FALSE
fjnhopfnab	FALSE
gefofionab	FALSE
gehicphpab	FALSE
gpdiomgfab	FALSE
gpemegpmab	FALSE
hjmbpkbfab	FALSE
hjmelbhaab	FALSE
idnnfpimab	FALSE
idoakpcnab	FALSE
ioeodkomab	FALSE
ioeomdagab	FALSE
jiokfjoiab	FALSE
jipddknmab	FALSE
kdenkljcab	FALSE
kdfljmeeab	FALSE
knljakamab	FALSE
knmbnciabd	FALSE
lhojipngab	FALSE
lhpknjcmab	FALSE
mcgkifmpab	FALSE
mchbhdmmab	FALSE
mnhebgaabh	FALSE
mnhkibpfab	FALSE
nhfkmpklab	FALSE
nhfpeaapab	FALSE
oagdokenab	FALSE
oageigfiab	FALSE
olfhkmceab	FALSE
olgbadnnab	FALSE
pflmggkjab	FALSE
pfmfcnipab	FALSE
aaaclpdcpbg	TRUE
aaahecneeek	TRUE
ajngamdngpp	TRUE
ajniiopjhnj	TRUE
bdgdgcbaihm	TRUE
bdgmnfpjckd	TRUE
bofmlnadchg	TRUE
bogdkkbjmad	TRUE
cihhhgckahf	TRUE
ciigkmfjpnp	TRUE
ddephikbldk	TRUE
ddfigaeamip	TRUE
dnmiijjhafb	TRUE
dnmjakhjeco	TRUE
ehmpiandibl	TRUE
ehnoioihnfi	TRUE
fbcfefcloea	TRUE
fbcjalipmkk	TRUE
flcmdhpjgoe	TRUE
fldemeiehlo	TRUE
ghaefpbhkok	TRUE
ghagegbfbmi	TRUE
hancedlmijn	TRUE
hanifegicil	TRUE
hnbnjgocdca	TRUE
hndejnjaiph	TRUE
igjffhnpeoi	TRUE
igkkcigmnnk	TRUE
ipkmofjpeao	TRUE
ipmdhkcklpi	TRUE
jlcjmecfgmf	TRUE
jldcajnidla	TRUE
kgbdjcalpgj	TRUE
kgbmoiofmak	TRUE
kpgiimpgaae	TRUE
kphdinaofno	TRUE
lkennhlciin	TRUE
lkfgonnfhak	TRUE
medepojjpng	TRUE
medikaeebpf	TRUE
mokohmiobao	TRUE
mollnlfadjg	TRUE
niokccenjma	TRUE
nipaamlallg	TRUE
ocdgnhfibmo	TRUE
ocdoceahlic	TRUE
olpindinldn	TRUE
omacoldjhhj	TRUE
pgflmheehcn	TRUE
pggjieejehi	TRUE
aaanhahmeab	FALSE
aacaihlbbab	FALSE
ajbikjhjoab	FALSE
ajbnkbjnnab	FALSE
bdkkdcpdmab	FALSE
bdmalkcakab	FALSE
bnodefhhnab	FALSE
bnpahpnmdab	FALSE
ciolcmgonab	FALSE
cipflhmieab	FALSE
ddendhfedab	FALSE
ddeokabeind	FALSE
dnneinhlfab	FALSE
dnngolocjab	FALSE
ehmjhnhenab	FALSE
ehmokjlcfab	FALSE
fbkpcapnabk	FALSE
fbmolahdoab	FALSE
fleipdlleab	FALSE
flfealbkhab	FALSE
ggiffgpclab	FALSE
ggkiebhokab	FALSE
hbjdnkghbab	FALSE
hblahaffkab	FALSE
hmcpbplleab	FALSE
hmeilblcaab	FALSE
igchnlakcab	FALSE
igckhcigdab	FALSE
iplnnommnab	FALSE
ipoknpjghab	FALSE
jknnfheabnp	FALSE
jkojhmbpaab	FALSE
kfjhjcfncab	FALSE
kfkoeeaopab	FALSE
kpifllgldab	FALSE
kpilhhidkab	FALSE
ljahknjlfab	FALSE
ljbelknaoab	FALSE
mdkmfmdhcab	FALSE
mdkmnajmoab	FALSE
mpcbkigejab	FALSE
mpccebejnab	FALSE
nicakedgbab	FALSE
nickodeccab	FALSE
ocbfpambkab	FALSE
ocbgickjoab	FALSE
omgjngimhab	FALSE
omhfhnalmab	FALSE
pficimoifab	FALSE
pfidppljmab	FALSE
aaaclpdcpbge	TRUE
aaahcneeekci	TRUE
ajiemiocljdk	TRUE
ajiikknnhebe	TRUE
bddpgpijfmgo	TRUE
bdfdemdkcmco	TRUE
bocifamnhnji	TRUE
bodeaaoljlpl	TRUE
cjjefggaapcl	TRUE
cjjlcpehhlae	TRUE
ddbbgmciplfh	TRUE
ddbepgdhlibh	TRUE
dnpfckedifgb	TRUE
doadbpdohmap	TRUE
egpifggijikg	TRUE
ehaodahipnen	TRUE
fbogoellmpeg	TRUE
fbpcappghanh	TRUE
flkgmkfkgmhf	TRUE
flkolckobmpm	TRUE
ghbdiibpdpin	TRUE
ghclldgjilei	TRUE
hbjojkgpjnja	TRUE
hbkghpfeofpj	TRUE
hnefofooomea	TRUE
hnenkbbjafge	TRUE
igkhjghgcbgm	TRUE
igkkknnjecil	TRUE
ipheapgjdklp	TRUE
ipjifbncnmnd	TRUE
jleinacfjglp	TRUE
jlhoekealifn	TRUE
kfhkbjbfnndo	TRUE
kfidddjkbkec	TRUE
kpjolhehfbci	TRUE
kpkciicageco	TRUE
ljokkdbpifkg	TRUE
ljopmpbgcjka	TRUE
mdmnafaijcde	TRUE
mdnipfpnobdh	TRUE
mokednnlcaog	TRUE
mokfkkonpiid	TRUE
nilblhpocgki	TRUE
nimdicifciio	TRUE
obopchldjdjp	TRUE
obpgfdebkmfi	TRUE
omcjagjaacjp	TRUE
omcmogkemhmn	TRUE
pfkjjfmjdjga	TRUE
pflilhemompc	TRUE
aaakgejibaab	FALSE
aaalbjjljfab	FALSE
akkppncklaab	FALSE
akmbgbbjilab	FALSE
beailgimdlab	FALSE
bebcoocjhiab	FALSE
bojjlgimcfab	FALSE
bojmiopngeab	FALSE
cioddfobndab	FALSE
cipdmcecmiab	FALSE
ddhndlnoebab	FALSE
ddhnegnofpab	FALSE
dndmifaggcab	FALSE
dnecndkohpab	FALSE
eggopackipab	FALSE
eghbkgmbdjab	FALSE
facjpcanghab	FALSE
facppkflglab	FALSE
fkikofpgdhab	FALSE
fkjinfeikbab	FALSE
gfeiajppndab	FALSE
gffjiochckab	FALSE
hagekiemeiab	FALSE
hagjgbanekab	FALSE
hknaicljmdab	FALSE
hknbcoonkdab	FALSE
ieeedpklacab	FALSE
ieepipmdobab	FALSE
ipfneccjehab	FALSE
ipgkbfbeejab	FALSE
jjdholaifcab	FALSE
jjenakfilgab	FALSE
kdbccnlkgfab	FALSE
kdbhoineogab	FALSE
koaopnfagoab	FALSE
kobaiopkbeab	FALSE
lhjdkicodcab	FALSE
lhkfafoeniab	FALSE
mcbeokdmljab	FALSE
mcbienbmjcab	FALSE
mncnekpdhcab	FALSE
mnelhbabkofl	FALSE
nhpphleiphab	FALSE
niaooaedhjab	FALSE
obljanhiidab	FALSE
obmgalehdhab	FALSE
omdhdhjgebab	FALSE
omealikbdjab	FALSE
pfofliejmmab	FALSE
pfoipkbkceab	FALSE
aaajdojgfmopk	TRUE
aackccdklemid	TRUE
akgmoboccheam	TRUE
akhdmehfijcnf	TRUE
bebcibejpnemk	TRUE
beddaodcfagdi	TRUE
boggbcpbjoang	TRUE
boghdphfjnpca	TRUE
ciokihciojdgl	TRUE
cipbnplkbmcom	TRUE
dchnobnoneleh	TRUE
dcjhjooljahgl	TRUE
dmkpacdppnhlp	TRUE
dmnplfmlpkglg	TRUE
egkhcdmnlambd	TRUE
eglhfghobhffc	TRUE
fackbcnebdegf	TRUE
fadaofhelagcj	TRUE
fkoafpmdenbbg	TRUE
fkodenmfbobbn	TRUE
gfochoamhglml	TRUE
gfohmhijhlbjg	TRUE
haefopddcgigg	TRUE
haegcjkadhkmo	TRUE
hjljkihcofcob	TRUE
hjmhlohhbcjhc	TRUE
iebhdnjhgaodb	TRUE
iedihkaamdnca	TRUE
ionenchljcdnl	TRUE
ioolepmhjdafd	TRUE
jjlehdgfkmoad	TRUE
jjlpkpclbmfgc	TRUE
kdogalhpodibk	TRUE
kdopboiglhnfn	TRUE
kolfaondalcpi	TRUE
komhdifobganp	TRUE
lijlpnekklmlb	TRUE
likdjpcilnjmf	TRUE
mcgpljfjfmaem	TRUE
mcjallpbkaaao	TRUE
mncnkbkjjmhem	TRUE
mndacgnjkkkac	TRUE
nhcahkginofio	TRUE
nhcdgmmjjjkki	TRUE
ocjldpgfbbeaf	TRUE
ockbaoonpbjgb	TRUE
ombpildfpgpcn	TRUE
omeigkbgiagdj	TRUE
pgldpinkcimig	TRUE
pglljgnmphnkj	TRUE
aaaojidikjoab	FALSE
aaapibhhepiab	FALSE
aknhacifalhab	FALSE
aknpkkojekmab	FALSE
bgfodkkloinab	FALSE
bgglgoaniiaab	FALSE
camfpjkeiafab	FALSE
camhalcoidnab	FALSE
cklliidmkpaab	FALSE
ckofodlmlfoab	FALSE
dfajkagloenab	FALSE
dfakbhiklelab	FALSE
dofaiolfbkcab	FALSE
dogkbccjiohab	FALSE
eihpjafjconab	FALSE
eiiaiihganmab	FALSE
fdcdgagmafiab	FALSE
fddbdimjbbhab	FALSE
foekmkidopeab	FALSE
fofebbpjmdhab	FALSE
ghmmjbbjfioab	FALSE
ghnchokknphab	FALSE
hbmhpbfjgepab	FALSE
hbmigcngkklab	FALSE
hlbgfgcccdabn	FALSE
hlbnbkllgohab	FALSE
ifmcegdnckbab	FALSE
ifmhbgbmpccab	FALSE
ipeimjhcakcab	FALSE
ipejdfbihlmab	FALSE
jjbjlondehoab	FALSE
jjdaialfkgoab	FALSE
kcelapofkcgab	FALSE
kchdnbiejjkab	FALSE
kmbcfodobmiab	FALSE
kmdeccfbbbmab	FALSE
lfocnfdkjbdab	FALSE
lfoicfhhmolab	FALSE
lpjphnfoldfab	FALSE
lpledodngbkab	FALSE
mkgaghbbgmnab	FALSE
mkhedmgoophab	FALSE
nfpbncniblaab	FALSE
ngaajddnnafab	FALSE
obhlicbfijmab	FALSE
obhollaolnabm	FALSE
olefhfdbabonb	FALSE
oleggeodocgab	FALSE
pekeijpppioab	FALSE
pelgepndcjdab	FALSE
aaajainajoefod	TRUE
aacmkojnnoibmj	TRUE
algdpjocmlaanh	TRUE
alikoacipaamib	TRUE
bgahdmdoiemgcl	TRUE
bgbhcflmfkopeb	TRUE
cbhombmkhmpflf	TRUE
cbiikfgbdjnhif	TRUE
clemhgmemamlbc	TRUE
clfclflfmjigan	TRUE
degngbfgibnhgm	TRUE
degnkaacbcmbfo	TRUE
dobanegodeinop	TRUE
docboaohlfbhga	TRUE
ejjcdecgpgepld	TRUE
ejjefbnjkjfggj	TRUE
fdkifhpbgbkdib	TRUE
fdkpagjonnolmo	TRUE
foggnbikbhdiol	TRUE
fogijcmcmifmkj	TRUE
giaginffnikbim	TRUE
giagjlckokajhb	TRUE
hblaomoffeelef	TRUE
hblldldilancmj	TRUE
hlldkpnggcakaj	TRUE
hllgcfjccefldf	TRUE
ifefmjlhffgfhc	TRUE
ifehnopjmpdjnk	TRUE
ionfhckpbdojbb	TRUE
ionlfbochcbnhm	TRUE
jipnakdhkfmghf	TRUE
jjachgponindll	TRUE
kdfbmkmpaoafed	TRUE
kdfegjehcmmahh	TRUE
kmcajhaindnepn	TRUE
kmcbedjllgkdic	TRUE
lfieedomhpljcm	TRUE
lfjgmehcmnaakb	TRUE
lplgkamlbddcgm	TRUE
lpmcgnafjogeed	TRUE
mlfckocjdhahld	TRUE
mlfdiekimimlnd	TRUE
nfgchhhmopaanf	TRUE
nfgehpgbjgfbhl	TRUE
obhcociokmenmk	TRUE
obhpkibeljkgdk	TRUE
okodnmpmoikbef	TRUE
okojfilgmhlcbc	TRUE
pechgebepglimh	TRUE
pecmemfgoojaoe	TRUE
aaafjbmhpohiab	FALSE
aacalgojnoegab	FALSE
alandlijpkhgab	FALSE
albkkmfijbamab	FALSE
benocjgmihgmab	FALSE
beogednbkiahab	FALSE
boigbhcjfidpab	FALSE
boiokoajmdakab	FALSE
cjgobihfbdnkab	FALSE
cjhcocehminoab	FALSE
dcnfknocndlpab	FALSE
dcnnlbppghcdab	FALSE
dmhaokkokocgab	FALSE
dmhmmgpkolpdab	FALSE
egnbpnebagacab	FALSE
egombgonkidlab	FALSE
fahlmcadeageab	FALSE
faihoclelhljab	FALSE
fmefpjgleocjab	FALSE
fmekplnafhajab	FALSE
ghflnnnkfdgbab	FALSE
ghgnfcnmoindab	FALSE
hcdfaldjjbgeab	FALSE
hcdfepfiiobpab	FALSE
hmpmoncgfolcab	FALSE
hnagbcloepomab	FALSE
ihdnahegjdlaab	FALSE
ihejcflknigeab	FALSE
jamglokpnhbcab	FALSE
janfhkjinijbab	FALSE
jlfhehibeaipab	FALSE
jlfpnedhdedabk	FALSE
kfgeeljpjflkab	FALSE
kfhmchjgbcihab	FALSE
kpdnlgfgkhnlab	FALSE
kpepddildmehab	FALSE
ligmnmgjoakdab	FALSE
lihkilfoljnmab	FALSE
mdgpegdkomfpab	FALSE
mdhhnnipfheoab	FALSE
mnpeiaagfjkeab	FALSE
mnpeikbhjcabme	FALSE
nhcceokjjjldab	FALSE
nhchdoppcncfab	FALSE
obgengojbepnab	FALSE
obianhgnbpigab	FALSE
oldfonffmncfab	FALSE
olfbnccalkkdab	FALSE
pfnjkeccillbab	FALSE
pfnllbkjggekab	FALSE
aacenncgmgikpaj	TRUE
aaegapaeajbjdjn	TRUE
akoobakghmhkokf	TRUE
akpdobjmoaeofbb	TRUE
bebebbnnniojlpk	TRUE
bebhkfgchilmdog	TRUE
boloaemlambjfkg	TRUE
bomfkmlgeikpchc	TRUE
cionenlkfhogddi	TRUE
cjaambjeokipgoe	TRUE
ddjfhelddnmboho	TRUE
ddkbpfclhaeiodj	TRUE
dndjhieogfdjnjp	TRUE
dndjpdkbdglnjnp	TRUE
egicmhlgloogfkf	TRUE
eginkinfnaojmpp	TRUE
fajknmnamdofepf	TRUE
fakmlpfcncjndgb	TRUE
fmleoihadlcopmj	TRUE
fmlmliekdojniml	TRUE
ghjmbigaegpgijn	TRUE
ghkfghjdfidhckj	TRUE
hbockphhgnadggo	TRUE
hboealiiggejjdi	TRUE
hmbcffdgpogcndl	TRUE
hmcgcamobpljoki	TRUE
ihlbbbpbdhdokoc	TRUE
ihlfnofflicokjm	TRUE
jaongldddmnfcpn	TRUE
japiandffdipmeg	TRUE
jknoliakiimbmjf	TRUE
jkpclciilohgimg	TRUE
kfodjmjbmdnedji	TRUE
kfolaifmhbncmho	TRUE
kpbllclapbefgel	TRUE
kpcllljkmheagia	TRUE
ligonkdfjanimch	TRUE
lihllnndmielcfn	TRUE
mdblkjblmnmcofp	TRUE
mdcepackbienomk	TRUE
mnbgdmghififdfe	TRUE
mndhbkcnkcaogfl	TRUE
ngpeoogmecdljbb	TRUE
ngpkajpljjdcdcg	TRUE
oaocbfceeojompp	TRUE
oaocjjhdfgolnkf	TRUE
oljkmmgodelmjmm	TRUE
olmpgpjbopoibbn	TRUE
pgcdpibknfafjoc	TRUE
pgddbpllddgkcgo	TRUE
aaadfleppgamiab	FALSE
aaakbddbffoafab	FALSE
ajmeaeckkfahcab	FALSE
ajmejdfdmpdpeab	FALSE
bdknflbmnhibeab	FALSE
bdkoampikafklab	FALSE
bnbflkfealkekab	FALSE
bndcbgidfdkdhab	FALSE
chbojjcagneojab	FALSE
chchdlcbjbfhjab	FALSE
dbdiklkgpndhjab	FALSE
dbdlgaipcjcfnab	FALSE
dldlkpackcblfab	FALSE
dlellgfjahmoaab	FALSE
egpdepffodehaab	FALSE
ehaecehkjecalab	FALSE
fajmldoemdcmjab	FALSE
faldijknbbdaaab	FALSE
flddmnkkjbkmeab	FALSE
flejloalabampgb	FALSE
gfemcgidcnlhdab	FALSE
gfemllenpdamgab	FALSE
gpnchioelcjjjab	FALSE
gpnloolhpnhbnab	FALSE
hkadjeffdkebbab	FALSE
hkajkhbdhlgnpab	FALSE
iemdnhjhoinajab	FALSE
ieojmcbpkdmolab	FALSE
innlbblmfoogmab	FALSE
innoahklhpgpbab	FALSE
jhnmldalmifooab	FALSE
jhnocfliccbhgab	FALSE
kbkaidnmeiolpab	FALSE
kbkkmnbkjamifab	FALSE
kmbpnkbegjajlab	FALSE
kmcadalfgkjgeab	FALSE
lgaooiffnnicbab	FALSE
lgbclljdgpbcdab	FALSE
lppkmpedfnaomab	FALSE
lppobaemkakhoab	FALSE
mmfhfacnafapaab	FALSE
mmgckknffhjmdab	FALSE
nfapgcfbgmhogab	FALSE
nfbhmjbhadioeab	FALSE
oacioojpcplhkab	FALSE
oafdefdglomnjab	FALSE
omakiflihelngab	FALSE
omanpjlebfkkaab	FALSE
pfiocihbgamnmab	FALSE
pfjmhpnllfhipab	FALSE
aaadmlokpkknckka	TRUE
aaaeaacmhbgeggpj	TRUE
akngmgpggcpebhmn	TRUE
akpoomghcogahnia	TRUE
bfcelnlcdfjgmlln	TRUE
bfcmhbdkjhhhjppl	TRUE
boemfhdnjnlcccii	TRUE
boflijlfbkidgmgm	TRUE
cjckimjcdcmnbndh	TRUE
cjdjebceajjhfeik	TRUE
dcpdkpnglakiiceh	TRUE
dcpgjeefgkgkigan	TRUE
dnjinijaljogjfko	TRUE
dnmapdnhaljmcngp	TRUE
eidmkdodkiifnphg	TRUE
eiendobfemilkinm	TRUE
fbndgdaomaooalid	TRUE
fbnkdmhfdlhffcgh	TRUE
fmappgcfoglpmjcc	TRUE
fmcejafnhkobgfie	TRUE
gglonkdllnocehcc	TRUE
ggnanhiheglhiong	TRUE
hapglofkgachnpag	TRUE
hapnnjokoalbejbk	TRUE
hkgppgmnggdfpgjl	TRUE
hkhpbdlpaoaaodio	TRUE
ifhopimnbikgodok	TRUE
ifjginifkeiiogpj	TRUE
iphggogdfpdkboop	TRUE
iphigppohgfdogad	TRUE
jjigdhkemicjjgmk	TRUE
jjinfgkdaeohfpoo	TRUE
kdjgoahblcgbfhgp	TRUE
kdmalnahgpjhoiao	TRUE
koekfbknnbfeghhm	TRUE
koeoplleolmbbjff	TRUE
likgbelbpnpjncad	TRUE
lilhmbmfkjniiook	TRUE
mceajmoibdbpkegk	TRUE
mcekphjkjbchnahm	TRUE
mncgaohahnanblce	TRUE
mncnfaelpkiklfcm	TRUE
nhmehafmhkoffidg	TRUE
nhmmlacbmgjgndfg	TRUE
ocpkibaoocgnfdij	TRUE
odbjklibcdkmmncn	TRUE
omibjcgfhdlbipcf	TRUE
omidokihddldnjlg	TRUE
pggkdagdcaplgmco	TRUE
pghildhlflncgnep	TRUE
aaamcpjekanchcab	FALSE
aaapcdkbjbmgnpab	FALSE
akidgaidebcojcab	FALSE
akidiocoabhblhpp	FALSE
bdihcagbodlinnab	FALSE
bdjakdglhjehihab	FALSE
bnlpobmoohmnpiab	FALSE
bnnfhbmpbcahafab	FALSE
chmcicjfdbhennab	FALSE
chmdcbchimlbifab	FALSE
ddnaegcfmaclglab	FALSE
ddncgemkgcdjohab	FALSE
doadcobpbdhpelab	FALSE
docnogdlehboibab	FALSE
eieecgfkgpfnokab	FALSE
eieejimlednfclab	FALSE
fcccihphimcohlab	FALSE
fccfkhkopegbboab	FALSE
fnbeckojppeggfab	FALSE
fnbefikjgeegafab	FALSE
ghjbflioflcdfhab	FALSE
ghjgnalagbkhdpab	FALSE
hankfjihdbepphab	FALSE
haopciigddoboiab	FALSE
hkgkaknhienjjbab	FALSE
hkigapnldhkcnnab	FALSE
iffgandlolkpobab	FALSE
ifflbjlkaimaalab	FALSE
ipfbbampmcpfjlab	FALSE
ipfefhmkgacfgfab	FALSE
jkappiaejknaojab	FALSE
jkcedpfdjjfaamab	FALSE
kdfghphmochpcfab	FALSE
kdfgnikhgpadbdab	FALSE
knpmpngpgcnolhab	FALSE
koakocaklgeeoaab	FALSE
liefneoifenbbfab	FALSE
lifcbijbiehjjdab	FALSE
mclgcbhcccdpeeab	FALSE
mcljjabppcoalcgh	FALSE
mnlkifhbjgeiojab	FALSE
mnmempinjjmilpab	FALSE
ngpieijbfbnaceab	FALSE
nhabgbhecpnbmahi	FALSE
ocdjahgngcjafmab	FALSE
oceeacacgilnlfab	FALSE
omeflappgblnfdab	FALSE
omglkcfcdmbokcab	FALSE
pfndjnnkecbnbhab	FALSE
pfoibbpnecjaegab	FALSE
aacdncmjclmedcgej	TRUE
aacelmglapainfpfm	TRUE
ajnpceglaedbpphjp	TRUE
ajpajbjknehniapmd	TRUE
bconlfkjahhpfdihh	TRUE
bcpfdkackplhcefbb	TRUE
bmmhbnilbmbjipnoe	TRUE
bmmjpcjdoiimoipdi	TRUE
cgmleecelpkakckpp	TRUE
cgojameokojgnfhoj	TRUE
damjhkdlklhecnhpg	TRUE
damjkjnadfkgoikhc	TRUE
dldpolfajbdcancgd	TRUE
dlefejbmpjnkolpli	TRUE
eeoleacofjknaocon	TRUE
eeoocanibfkipjono	TRUE
eofphbfdjclfkjgbk	TRUE
eogakneedpcefpicf	TRUE
fhenfajoepmheodcf	TRUE
fhfalmamnppkhngpm	TRUE
gcbimdcjlampknelh	TRUE
gcbkkodkiecjcjdeo	TRUE
gmpfinmihhpdgelne	TRUE
gnajandganicoeafn	TRUE
hhfgoohdlnaldicbj	TRUE
hhglagpkbbnimjmig	TRUE
icggefkhpeddnaana	TRUE
icgkjngcnigfnppjf	TRUE
imcnpefbjejcfpkff	TRUE
imdlahlnjdibnlppa	TRUE
jhlnilbjnibhmhjih	TRUE
jhmchfghpdadaihno	TRUE
kdejmjfmcfgjoljga	TRUE
kdfcmcknjanhapija	TRUE
knageecdnljojpccm	TRUE
knaieijifhlofemge	TRUE
lhihjckpmnkphleob	TRUE
lhjfegmpgcofhcoec	TRUE
mbgndnjknmjchbkdk	TRUE
mbhghpibddkdjiljh	TRUE
mlaidphepmfdeobba	TRUE
mlalogiflchnenipf	TRUE
neocedlbcbgflcghb	TRUE
neomjdoanodoeafna	TRUE
oaafhlbcbmlgibpio	TRUE
oaeeagambhhpcanho	TRUE
okmfdfjkpgacjcind	TRUE
okngepicjehnmjlcl	TRUE
pfccclognoobjckha	TRUE
pfdgbpokhjcpgeeec	TRUE
aaaaijolkdljgdgab	FALSE
aabcmbhcmimnnjaol	FALSE
ajolgjefbfmlbpiab	FALSE
ajphgbjfadelnegab	FALSE
bejpkjogpnjkkpkab	FALSE
bejpppcnjllkdlfab	FALSE
bnoclhakcklomkgab	FALSE
bnoeljlopgoommpab	FALSE
cjcadbkhddnpbbmab	FALSE
cjcbmfibohgogcjab	FALSE
dccdekmeejklembab	FALSE
dccmhkcjpmbenbcab	FALSE
dlljamifjnopiggab	FALSE
dlmlemdaikghionab	FALSE
effjipfcmibcfaeab	FALSE
efgchgdglngfnofab	FALSE
epjoekddgjldblkab	FALSE
epkbnelondlibgiab	FALSE
fjdoebldbeamjbbab	FALSE
fjebjmkemajalhnab	FALSE
gdipkkgfenkjpocab	FALSE
gdjcobglnpppapmab	FALSE
gpbjncchehbanklab	FALSE
gpcneipiddlocohab	FALSE
hknaopmohoeghajab	FALSE
hkopbphmggbnadnab	FALSE
iepijhkkaepjfmgab	FALSE
iepppebpmdmmggjab	FALSE
ipiibngcncefdibab	FALSE
ipijfbcaejcagnpab	FALSE
jjefoncocempkfnab	FALSE
jjfhaejbmooljeiab	FALSE
kdbkmkhkioecloaab	FALSE
kddimmopjhnlmocab	FALSE
kmdaiodgaadkmicab	FALSE
kmdbcpbkaehocjcab	FALSE
lhchpfaijcnoceeab	FALSE
lhdiaeplhafimcpab	FALSE
mboaibomhkngogjab	FALSE
mboajmdiaoplgbcab	FALSE
mloijbokhngopfaab	FALSE
mlokanacdenccpabc	FALSE
nfpebiimmbmhpccab	FALSE
nfpiikacmidkoogab	FALSE
oadnhgfcaojfoknab	FALSE
oafdnogecglmficab	FALSE
olgngffcncmnmdfab	FALSE
oljbfjkimbghhgcab	FALSE
pggigbanpmbgfamab	FALSE
pghfmilkfcohlpbab	FALSE
aaahdgcpmbhcmimnnj	TRUE
aaakaplkopejkcgddn	TRUE
akiamohaeahakjagcl	TRUE
akiihhokmcbpbgapnp	TRUE
bfganacakadbldimce	TRUE
bfgocmnmbpgbeofaea	TRUE
bojiajoclmlmekobgc	TRUE
bokdfhilfmmlgpnckk	TRUE
chpkjpmpolflkmefla	TRUE
cicefgoobkdmgmcfhe	TRUE
dbdkboffoefbbhakcb	TRUE
dbdlkfiiaamjnkpjhe	TRUE
dlfmjaegjcejljncgp	TRUE
dlhkjjbejbndcghbnc	TRUE
egaccniaejgiddpafg	TRUE
egbdiaeedalljhimkc	TRUE
eplgejhjalnijeocoa	TRUE
epmojjfpbejbaebjbd	TRUE
fjkokkkldecdmkapnk	TRUE
fjlcdkmfkalgeaanpe	TRUE
gekgehhooahfgccobm	TRUE
geljlkmjjgeomkmfpe	TRUE
gpinnolfkgejhlgeoa	TRUE
gpjofnekhfmnmppmai	TRUE
hlhheaigllhpkdhloh	TRUE
hlhjbempmcleoamlke	TRUE
ifgbkkckpnggckafel	TRUE
ifhljiecngefajcdap	TRUE
ipfipfdlpcnkidlbnj	TRUE
ipgiodfcdbijglloed	TRUE
jjjgioojnlbkpocfam	TRUE
jjjheeojjpdkkkfkge	TRUE
kdcghmmbcomplhnfgd	TRUE
kdediembephadfakik	TRUE
kmpdjcdndhbahjlcji	TRUE
kmpgkjagpemoeopnok	TRUE
lhdihajbgbblcbagop	TRUE
lhdlbhcbfgdlfjdial	TRUE
mbppghcjpgkhchlfmb	TRUE
mccccedpigpjdcbgcm	TRUE
mlemhjalhhlfoecgom	TRUE
mlfhloekpbpinegpfj	TRUE
nfipgneokdnibkjiem	TRUE
nfjddekhimlfbpeiij	TRUE
oachjfahnidakfaiaa	TRUE
oaeicededghlfejihn	TRUE
olhlgngmgbncclhgme	TRUE
oligdneildlfdladel	TRUE
pfjfalanlhkjniaddi	TRUE
pfjknkmbjhjdallddn	TRUE
aaanckjnjfmhajchab	FALSE
aabahpmljdahjamkpl	FALSE
akcflomgjkcdadiaab	FALSE
akdanjdppjlegkhnab	FALSE
bgaojoaoaniofhlgab	FALSE
bgaokpcnngfaloieab	FALSE
cabfephnfldphklnja	FALSE
cabgdmcdfniohjpicd	FALSE
ckbfapjikoebgfecab	FALSE
ckbiffkdjokmohemab	FALSE
dclfbpddohgciiahab	FALSE
dcloenajnoifhediab	FALSE
dmpcmdenoiomamajab	FALSE
dmpkcabihpdnfhjmec	FALSE
eidpheiggppalieaab	FALSE
eiecbhjbffhnidliab	FALSE
fbfdbbccmjjamblbab	FALSE
fbggkikglhfckfemab	FALSE
fkpbhfpfmbmlboceab	FALSE
fkphamgbhapcbjiiab	FALSE
gfcipmfpnjbldgbjab	FALSE
gfhmienlicbimaphab	FALSE
gppgnhiiimopaakjab	FALSE
haaccpkejcpifnomab	FALSE
hjlmlkebigjanbkjab	FALSE
hjmijodbalkgmdiiab	FALSE
iefglfgfehjccjhbab	FALSE
iefnbefkcnbmoffmab	FALSE
ipeonlnolipbgijhab	FALSE
ipfdfccekefajflhab	FALSE
jjikkngcdcdhhodoab	FALSE
jjioepobhofkjhpiab	FALSE
kdmhidcbnjpilgjfab	FALSE
kdnhpbidbeohiidnab	FALSE
knlailbhmgmefhmgab	FALSE
knlmpnifndonefnjab	FALSE
lhbgdajaaefhhafjab	FALSE
lhbiilmjengjmoedab	FALSE
mbeijihkonijobckab	FALSE
mbiapjcaigiljdfaab	FALSE
mlofbdajhangdlicab	FALSE
mlolmgohddljplfdab	FALSE
nfiofjefbbdchajnab	FALSE
nfjeejfflkglobjaab	FALSE
nppefndahochahfjab	FALSE
nppnhjkjcgekbmlfab	FALSE
okficchiejcnceomab	FALSE
okggiieilinmhocpab	FALSE
pfefmicgckhofighab	FALSE
pfghhkpejmopphblab	FALSE
aaedjiacjkkkaeapoek	TRUE
aafacifpdffocikgkoi	TRUE
aklaehhjcjdmaffjmhg	TRUE
aklhdckaacbbfgnakpl	TRUE
bemliddhbhcgfmhphec	TRUE
beoddcajjmnpmpbfomo	TRUE
bopmleilkmmdoidahfn	TRUE
bpafokikdhbaphlnhod	TRUE
cimbchblkdnpinbeghf	TRUE
cimcnndnpbiajfkedlk	TRUE
dcidikngalbjjdfbekl	TRUE
dcikfclhiblbanacfai	TRUE
doclagpioepdgljhkdp	TRUE
docnnhklkdeandlpiij	TRUE
ehfpfhbbonmphifacnl	TRUE
ehgbjlemipahanbocgf	TRUE
fceceoalaijmjfckeep	TRUE
fcecnggjmjkpbcalali	TRUE
fmghkadkokgnbdjljlc	TRUE
fmhkdnkpelfgbfobfmh	TRUE
gfnefgmcedfkklbgnpe	TRUE
gfomghemcpjpdaioioa	TRUE
hafpincdcmmgapkddej	TRUE
hahjlejpokpaindjpdg	TRUE
hjjibhfopjolpkadhni	TRUE
hjjljoacpmhmdgbajom	TRUE
idmgoomifeennlccenb	TRUE
idndcnlihlcmefghlkb	TRUE
ioaadiobmjediphaaih	TRUE
ioakichiohjjmjihbhd	TRUE
jidffhdnpgjpcfghgih	TRUE
jifacmmnjajkmjpoajj	TRUE
kcahidkbdimiejkhihg	TRUE
kccapkokiaibchmlkal	TRUE
knalaplhfbjidfmdopm	TRUE
knapmknhfgeegdakpon	TRUE
lhjnkepbkmannojnlhe	TRUE
lhkejbmcdnpbkfojkij	TRUE
mbbeckapnblcdgmcmma	TRUE
mbbedljlhlgcbeflojj	TRUE
mklcnbjjpgdafhaeohk	TRUE
mkmhfcidmjbjkckjghi	TRUE
neooegndgphmmipmbhh	TRUE
nepbnhlkggpjandfhaj	TRUE
npljnjodmdepakdckja	TRUE
npmfdkhmflbcebckdcm	TRUE
ojomfgbgbpaipjkigcg	TRUE
okadekjldamcjidkofi	TRUE
pflngcjgfhamaejjdin	TRUE
pfmibeakgddjphjkgll	TRUE
aaamgklfpammhamfdab	FALSE
aabnfbgfmdobghcppmn	FALSE
ajmgbbklicjlaegbnab	FALSE
ajogcnlppakjnmpijab	FALSE
behcgkojjogcdckajab	FALSE
behdcdncnbpficbeiab	FALSE
bpfldgcpeaaohahmiab	FALSE
bpfmjbokpdmikdjcfab	FALSE
cjonklgdloclgdcjoab	FALSE
cjpfmdocefpmmmefeab	FALSE
ddinochhelkbadnkkab	FALSE
ddkbelpjbefgdjjphab	FALSE
dngappoendjdjmjclab	FALSE
dniofoeagfobmgnnaba	FALSE
ehenfhkbobklegghcab	FALSE
ehhieafniegdlegkpab	FALSE
fcpkdcmblpeknkjbiab	FALSE
fdajhijhllkjfhmhiab	FALSE
fnnidoegajgjklflnab	FALSE
fnnkggfdioofmlmnbab	FALSE
gihooljpjcjiiddppab	FALSE
gijehdlfkihnfbfgoab	FALSE
hcadinbgoibpkeofhab	FALSE
hcadkdfjihakchjnlab	FALSE
hlnldhbkdcaikeillab	FALSE
hlphdjkdiibjicpklab	FALSE
ifleohepejnhnkhmdab	FALSE
ifmemlpldakcnokglab	FALSE
jaflnoeobdiocbecmab	FALSE
jafpgcjjedcfhpcadab	FALSE
jkkngblimfcacgidgab	FALSE
jkkoeajmeaipbjchfab	FALSE
kfmjidnljbnaejmgmab	FALSE
kfnbjkbmnjchfkgphab	FALSE
kpbgkmdklakjnhcajab	FALSE
kpchigieakcohgihaab	FALSE
liboinkljknjdlhdfab	FALSE
lidpjhmoeebkddbgdab	FALSE
mcehaojcgngmkhongab	FALSE
mcekeakmifdmkbeliab	FALSE
mmmkdffniljbgockpab	FALSE
mmndpmnhhlnocklpeab	FALSE
nhmepdkcpglmjkenhab	FALSE
nhmjhmljinnoomkdbab	FALSE
ocdpppgcgndnncnnmab	FALSE
ocelbnnkeeocgopmjab	FALSE
onaeafcmlljmjoipfab	FALSE
onbbjmhkcekbieibbab	FALSE
phbicchjinpnhbdjaab	FALSE
phbipijpmbaoidnlgab	FALSE
