aaafhjnaho	TRUE
aaahmhigjg	TRUE
akhikeaabj	TRUE
akihkejcom	TRUE
bfpmggpeol	TRUE
bfpmienmce	TRUE
cafkmplcfp	TRUE
cagjnbaiob	TRUE
claefbdamg	TRUE
clbojaefeo	TRUE
dfilafmabm	TRUE
dfjldheici	TRUE
dpaabmnopf	TRUE
dpaiiconca	TRUE
ejojoddpno	TRUE
ejonlbnifh	TRUE
fdaonfdljm	TRUE
fdbjehmjkh	TRUE
fnjjioigep	TRUE
fnknmphalj	TRUE
gijopdhpcm	TRUE
gikdnkbhfi	TRUE
hckfjhejdk	TRUE
hcmdilapek	TRUE
hmbdllfbdj	TRUE
hmbjdofapf	TRUE
ighnebgcbc	TRUE
igjpepcken	TRUE
jaibnbhdfi	TRUE
jaifgchiik	TRUE
jkmccakcji	TRUE
jknaekjfkc	TRUE
keeedfjale	TRUE
keejchkjfc	TRUE
koiaklcmge	TRUE
kojccaphkf	TRUE
ligibaegom	TRUE
lihjielkef	TRUE
mccgkbheeo	TRUE
mccmcmfeac	TRUE
mncinnafcc	TRUE
mncmhjpimh	TRUE
nifmkbiejn	TRUE
nigdmnnfno	TRUE
ocpppbhbie	TRUE
odafohoogh	TRUE
olopkjfdmk	TRUE
olpbimcegl	TRUE
pgfnodhnff	TRUE
pgfodinfdc	TRUE
aaakbpcdcd	FALSE
aaaophbbaa	FALSE
alebamaaaa	FALSE
alecfbaaaa	FALSE
bfdlogabcd	FALSE
bfehlocdcd	FALSE
cacaipabab	FALSE
caclbkcdcd	FALSE
ckcfafabab	FALSE
ckdmdnabcd	FALSE
degfkfcdcd	FALSE
degmjababp	FALSE
dnkfpgbbbb	FALSE
dnllmmaaaa	FALSE
egmmiicdcd	FALSE
egmoddbbaa	FALSE
fadohgcdcd	FALSE
faencpbbbb	FALSE
fkfiembbaa	FALSE
fkgdgkbbbb	FALSE
gecmemaaaa	FALSE
gegeemcdcd	FALSE
goeajoaaaa	FALSE
gofjfiabcd	FALSE
hilgldaaaa	FALSE
hinfokabcd	FALSE
idggimbbaa	FALSE
idgkijabcd	FALSE
iogaijbbbb	FALSE
ioghcpcdcd	FALSE
jjceicbbbb	FALSE
jjdennaaaa	FALSE
kegiocdcdb	FALSE
kehbdnbbbb	FALSE
kpghpnaaaa	FALSE
kphimkcdcd	FALSE
ljeonnabab	FALSE
ljfohdbbbb	FALSE
mddjgmabcd	FALSE
mdeckjbbbb	FALSE
mobnecdcdi	FALSE
mobpdfbbaa	FALSE
niijngabcd	FALSE
nijbegbbaa	FALSE
obphiccdcd	FALSE
ocaelhaaaa	FALSE
omdjlpbbaa	FALSE
omdjolaaaa	FALSE
pggjddaaaa	FALSE
pghaegbbbb	FALSE
aaalbpkphlb	TRUE
aaapgdgbabb	TRUE
aldkcfkkbed	TRUE
aldkgmhpjkj	TRUE
bgjnapfcdba	TRUE
bgjpafdhjfl	TRUE
cadhffccpeg	TRUE
caenepdncgk	TRUE
ckgledlkogf	TRUE
ckgoilocbeb	TRUE
dehnbmlginf	TRUE
dejbncgbcfh	TRUE
dneibobcapl	TRUE
dnfjgcfkpgb	TRUE
ehkgmbomgfg	TRUE
ehkmongnhlh	TRUE
fahcphapeid	TRUE
fajihjmjfdf	TRUE
fkcicncobpe	TRUE
fkecfdgoppc	TRUE
gdomaijdbjc	TRUE
gdomhpkimgg	TRUE
gnoaonchaik	TRUE
gnplmceedad	TRUE
hjjlbbecbaa	TRUE
hjkmiemmkkl	TRUE
idiknededfe	TRUE
idjdmhpmphf	TRUE
iohggdleaid	TRUE
iohjehlddcm	TRUE
jinobeekknk	TRUE
jioocbjopjk	TRUE
kefeaghkeim	TRUE
kehehmabenk	TRUE
kopjamdkdmk	TRUE
kopppeiacfe	TRUE
linmfnemnkf	TRUE
liomgknhpda	TRUE
mdmoganbmpb	TRUE
mdnmfabodio	TRUE
mnokcanfgho	TRUE
moblkcdobbo	TRUE
njaifegcjgo	TRUE
njbaolmjenc	TRUE
obmljmbdhek	TRUE
obnopldcidl	TRUE
omieioelick	TRUE
omkinaniifo	TRUE
pgkggocimec	TRUE
pgkochlgepm	TRUE
aaakbpkbbaa	FALSE
aaaodgbabcd	FALSE
alddbgcdcdd	FALSE
aldfgccdcde	FALSE
bfnnicfbbaa	FALSE
bfnpmaaaanf	FALSE
caemcooaaaa	FALSE
caenkojbbaa	FALSE
ckjicchbbaa	FALSE
ckkgihicdcd	FALSE
dedgdkdbbaa	FALSE
dedogjabcdk	FALSE
dnkbbclbbbb	FALSE
dnlmmpebbaa	FALSE
eghfcfmbbbb	FALSE
egjaikkaaaa	FALSE
fagmpkaabab	FALSE
faikhimcdcd	FALSE
fkbibjkaaaa	FALSE
fkcianibbaa	FALSE
gedipoobbbb	FALSE
gefihmebbbb	FALSE
gohknecbbbb	FALSE
goigpclaaaa	FALSE
hihafkgbbaa	FALSE
hijkaibbbbg	FALSE
idlmbpncdcd	FALSE
idmliabbaak	FALSE
ioffojebbaa	FALSE
iofnppbbaal	FALSE
jjekckecdcd	FALSE
jjfoojpcdcd	FALSE
kdkjkhdaaaa	FALSE
kdknalcbbaa	FALSE
kpdnhakcdcd	FALSE
kpeijpmcdcd	FALSE
ljbhiokcdcd	FALSE
ljcmfkpabcd	FALSE
mdhlcllbbbb	FALSE
mdkbmhhaaaa	FALSE
mocbhmjbbaa	FALSE
moclnehbbaa	FALSE
nicflkbcdcd	FALSE
nidkehacdcd	FALSE
obnfhnobbaa	FALSE
obnllbfcdcd	FALSE
oniogmeabab	FALSE
onkmmedabcd	FALSE
pgjmgmcbbbb	FALSE
pgljcpdbbaa	FALSE
aaanogmddhai	TRUE
aabbacpkhchj	TRUE
aldjihhpeoab	TRUE
alehmnnhcphp	TRUE
bfhjmacnhhmp	TRUE
bfillooenmhd	TRUE
bppohopnhkai	TRUE
caadbijdnggl	TRUE
cjlbkcnacbio	TRUE
cjmikghfoooj	TRUE
ddplkchjdmhp	TRUE
debdlccicgji	TRUE
doeeplhocpck	TRUE
doenpflcffoa	TRUE
ehlnokfkejoa	TRUE
ehnjlglakclj	TRUE
fcchbchcplah	TRUE
fccoiecnmbil	TRUE
fmlalnncaeda	TRUE
fmlgpeeeanjd	TRUE
ghhchkbbekpe	TRUE
ghhncmehdlee	TRUE
hbfocfiknkmd	TRUE
hbgbkhcibgbi	TRUE
hlbaikpfmmhm	TRUE
hlbgdabgijca	TRUE
ifnhkjhjacnc	TRUE
ifnpgadalnbg	TRUE
ipdockgidmgo	TRUE
ipeddeoijaaf	TRUE
jkghlhgdegji	TRUE
jkhekfpegnck	TRUE
kdmnchikkboj	TRUE
kdndpenpgfkn	TRUE
koncjdigffip	TRUE
kongjmeajccn	TRUE
lhpnlolfbbof	TRUE
liaifolillhn	TRUE
mddffkbjganp	TRUE
mddkohmpabja	TRUE
mocimphgnioc	TRUE
moehlfohlhlm	TRUE
nhnjpoioigbp	TRUE
nhohmcfbkbbo	TRUE
oannhmhikbdk	TRUE
oaoedhmhhbfg	TRUE
olenlkfoglcf	TRUE
olfogmbmkcbk	TRUE
pgjibcednajh	TRUE
pgjmoonbinik	TRUE
aaamogmdaaaa	FALSE
aabbabpkcdcd	FALSE
albncpfpcdcd	FALSE
aldjjfhkbbaa	FALSE
bfmnihlkabcd	FALSE
bfnejghnaaaa	FALSE
bpplnjdbaaaa	FALSE
caabjojfbbaa	FALSE
ckfcacmpcdcd	FALSE
ckgadcphbbbb	FALSE
ddpogfpccdcd	FALSE
deacfpgicdcd	FALSE
dncgckimbbbb	FALSE
dncmfmeababj	FALSE
ehbbjgfmaaaa	FALSE
ehcdgcpmaaaa	FALSE
fbohgleabbaa	FALSE
fboohdaiabcd	FALSE
fmfhkpghbbbb	FALSE
fmgbojhkaaaa	FALSE
ggpldmafaaaa	FALSE
ghaabpmababg	FALSE
hbhmdehhabcd	FALSE
hbhplkgbcdcd	FALSE
hlfcnoamabab	FALSE
hlhfpaonbbbb	FALSE
ifgbacegaaaa	FALSE
ifgfahajabcd	FALSE
ipfnfheaaaac	FALSE
ipfpnhckaaaa	FALSE
jkmgggdmaaaa	FALSE
jkoeagenaaaa	FALSE
kdjpnkpjcdcd	FALSE
kdmfhcbcaaaa	FALSE
koemanehcdcd	FALSE
kofbkpdoabcd	FALSE
liejcgplcdcd	FALSE
lifecinbcdcd	FALSE
mdhigedmbbaa	FALSE
mdhjnnlocdcd	FALSE
momdolhcdcde	FALSE
momkojhlabab	FALSE
nihfodpgbbbb	FALSE
niihaaaobbbb	FALSE
obgbkajhcdcd	FALSE
obgmealacdcd	FALSE
olmakhakcdcd	FALSE
olmdfclmbbbb	FALSE
pggngdeeaaaa	FALSE
pghdgbbncdcd	FALSE
aabjnbodkcbcm	TRUE
aacmclhokccaj	TRUE
akplaagbjjkfc	TRUE
akpnfeehbhpaa	TRUE
benmjifcoonfn	TRUE
beohekmapmppa	TRUE
bppdlikhlhill	TRUE
bppfjhdbcdgpf	TRUE
ckbpecagohhdh	TRUE
ckdmbbjjdeblm	TRUE
dfbojkkbpbpnh	TRUE
dfeonhiicbmji	TRUE
dpnaaeiohclbi	TRUE
dpnpmdmignijp	TRUE
ekkiogakefahf	TRUE
ekmoekjlbbbah	TRUE
fdkcgepjlbfad	TRUE
fdkkdhljkhhdi	TRUE
fobnkgcanjhej	TRUE
focddodmjhjbi	TRUE
ggipiajfkdhkm	TRUE
ggjbjpdlkcdab	TRUE
hbepoohknkmbc	TRUE
hbfeehiinjnog	TRUE
hlnmkpahbaddo	TRUE
hloekhmjjioaa	TRUE
igapofpeaboop	TRUE
igbehklngjngm	TRUE
ipmciidiflcmb	TRUE
ipmeddmgkeaje	TRUE
jkekaoikmljif	TRUE
jkfjnopaeimio	TRUE
keddkamlaohae	TRUE
kedoaogpkehme	TRUE
koaihjakihonm	TRUE
koajcmcaplcdl	TRUE
liilbinmpbigf	TRUE
liipbdiiaikgm	TRUE
mchkjlkhbieab	TRUE
mcjglfpcdmcid	TRUE
mmejepohikdaj	TRUE
mmfokjdpokhbo	TRUE
nghkhhbjghhcp	TRUE
ngjdofkgliaei	TRUE
obcbbagnpmmmc	TRUE
obclofnlknhlf	TRUE
olhlpikpbgpak	TRUE
oljcgeiacejci	TRUE
pfplcppegmmga	TRUE
pgajppbfhcfig	TRUE
aabjnbodkcdcd	FALSE
aacbcmmclcdcd	FALSE
akpdgjpihbbaa	FALSE
akpdjfcfibbbb	FALSE
bfaaojceicdcd	FALSE
bfampmnkjaaaa	FALSE
bplaglgjababg	FALSE
bpnbahcoebbaa	FALSE
clckolonncdcd	FALSE
clcoiaghpbbaa	FALSE
deomgbcldaaaa	FALSE
depdlghilcdcd	FALSE
dplhcloonbbaa	FALSE
dplllbjgnaaaa	FALSE
ekidokmdfcdcd	FALSE
ekiikpmnacdcd	FALSE
fefejjjmdbbbb	FALSE
fefjihndgbbbb	FALSE
fnkpapinkbbaa	FALSE
fnmbjbabjaaaa	FALSE
ghingmfooaaaa	FALSE
ghjacnijlbbbb	FALSE
hbenkoplfbbaa	FALSE
hbfaakfmkbbaa	FALSE
hlcfmmcpbaaaa	FALSE
hlcibmfgiaaaa	FALSE
igbojjimicdcd	FALSE
igckfphjdcdcd	FALSE
ipmmhdijacdcd	FALSE
ipmnbhjejcdcd	FALSE
jjjdkcahnbbaa	FALSE
jjjmeilelbbaa	FALSE
kekfeempjbbbb	FALSE
kekjjbkbdaaaa	FALSE
kocdgdijfcdcd	FALSE
kocnpenghbbbb	FALSE
lilppbehbabcd	FALSE
liojnfclebbbb	FALSE
mcfomohbnaaaa	FALSE
mcfpahmcgbbaa	FALSE
mmphgcojnaaaa	FALSE
mnagaenapaaaa	FALSE
ngnebolgncdcd	FALSE
ngninidnlcdcd	FALSE
oaolahjboaaaa	FALSE
oapaodkkccdcd	FALSE
olmbjlfggcdcd	FALSE
olmhkicidbbaa	FALSE
pfkcfbiipbbbb	FALSE
pfkiikpmhbbaa	FALSE
aaafepemingpcf	TRUE
aaamoienmjjppe	TRUE
ajjmminomeadfd	TRUE
ajkhhldmdkldgj	TRUE
bdloomenihlemo	TRUE
bdmkhldjckbnoi	TRUE
bnhgecbegbmncm	TRUE
bnhjbajjecoldf	TRUE
cihgooaikojkdb	TRUE
ciicfekacabkci	TRUE
dbmgofnohgolij	TRUE
dbmhcbkofljkdp	TRUE
dleggnhofgnodk	TRUE
dlgfpnicimjckl	TRUE
efjghhpippjdhb	TRUE
eflinppijlnbde	TRUE
eponmlidofmole	TRUE
faabldgcaidiba	TRUE
fkaphcclgfecjm	TRUE
fkbbidkgcfehne	TRUE
gepahoppaichaj	TRUE
gepoldalbjijnm	TRUE
gpfbndpdfgcafh	TRUE
gpfjdcooigipmp	TRUE
hikkcamhaimgid	TRUE
hikogbedcgefdi	TRUE
ichffcafppoljc	TRUE
iciljdedmfknmn	TRUE
inbijcbpfoikcn	TRUE
inchopkbcmmidm	TRUE
jhglclgdijnaec	TRUE
jhhmccnepgoall	TRUE
kbhnmnhbblnkje	TRUE
kbiflbjdmjbgei	TRUE
kmclbkpokmgcpb	TRUE
kmdhpodemfccah	TRUE
lgickilnmjnacl	TRUE
lgiggobaegogfl	TRUE
mbfbpdohpflaag	TRUE
mbflledpggfehk	TRUE
mmgckcabnbhdha	TRUE
mmgjencokhgpgf	TRUE
nggbflobekfbmg	TRUE
nggmmighbfkdoi	TRUE
obfcfpadnhmdaf	TRUE
obfhlabkfdnefe	TRUE
ollkaaekdbmcjp	TRUE
olmjbfhfokpdag	TRUE
pgchnddcpfcpja	TRUE
pgdhmbiogppoij	TRUE
aaaeepemincdcd	FALSE
aaalpcfoiebbaa	FALSE
ajibpdochmcdcd	FALSE
ajiidgbckicdcd	FALSE
beblpdmgdjbbbb	FALSE
beeigaladkcdcd	FALSE
bobbdnibojaaaa	FALSE
bobklmfckdabcd	FALSE
cjbhibhcekbbbb	FALSE
cjcenogaplcdcd	FALSE
dcheabpfomabab	FALSE
dchfgmjjaoabab	FALSE
dkolkncbiiabab	FALSE
dkpcaoejipcdcd	FALSE
efgpjhbohacdcd	FALSE
efhehniidfaaaa	FALSE
eppcafenafcdcd	FALSE
fabbdchkplcdcd	FALSE
fkgjfomfngcdcd	FALSE
fkgoidifgeabcd	FALSE
gdpiifmejfabab	FALSE
geaggflodgaaaa	FALSE
gpemhblgimbbbb	FALSE
gpfdgjikmiabcd	FALSE
hindhhefoocdcd	FALSE
hiohkblcnjbbbb	FALSE
icjaadbikiabcd	FALSE
ickiaadbmgbbbb	FALSE
infiickhnmbbbb	FALSE
ingbgnaeelcdcd	FALSE
jhpnfanbedcdcd	FALSE
jhpnpiabgeaaaa	FALSE
kbkpkbokgkabab	FALSE
kblhcmddlgbbaa	FALSE
kljcdkgpcfabcd	FALSE
kllcmeigmhabcd	FALSE
lghheabojocdcd	FALSE
lghpnmflngcdcd	FALSE
mbelkbcjklabab	FALSE
mbfniegddmcdcd	FALSE
mmcblaabkfcdcd	FALSE
mmddhgcpmmbbaa	FALSE
ngpedjpneaabcd	FALSE
ngpenflpancdcd	FALSE
obfpobpdohbbbb	FALSE
obgaagledpcdcd	FALSE
ollhlogkmababb	FALSE
olljgkjmdiaaaa	FALSE
pggjlmcfmdcdcd	FALSE
pggmficchoaaaa	FALSE
aabnomjpomeleap	TRUE
aadjkphpdafnhgd	TRUE
akaggldfbnipbgh	TRUE
akbmkegpoplbkdg	TRUE
bfhimhefbdpdaee	TRUE
bfhjglcmpfjjdck	TRUE
bpmafjaphpibnba	TRUE
bppldijabppmkce	TRUE
ckpjifciimahjac	TRUE
ckpnjgjflkmcjoc	TRUE
dflkelbpgebbdnk	TRUE
dfpiohdchimapfl	TRUE
eanneblpkomilce	TRUE
eapbnhagpfggaif	TRUE
emajgamomgegjfm	TRUE
emfcfkpilcmpfdo	TRUE
ffobedndmcegnll	TRUE
fgbdhjjpjlmkenl	TRUE
fplacnbfibhcfmn	TRUE
fplkehpclaefonj	TRUE
gklaegichokffmi	TRUE
gklempeniikbhli	TRUE
heeedmicikipejl	TRUE
hefneimladdepig	TRUE
hohlnonjghckehb	TRUE
hohodnpolkhfnlb	TRUE
iiaiilamegnpajc	TRUE
iibhkknkjhcnfcm	TRUE
jcdldaolhnpjpal	TRUE
jcdldlgoiaabcmj	TRUE
jlpelmjhbmjbjna	TRUE
jlpmojmhoacfgan	TRUE
kenpbcgkddlhekm	TRUE
kenphnjdendgofc	TRUE
kophdodmgheohbg	TRUE
koplbfpfgdfceag	TRUE
lkfdikieioplbcl	TRUE
lkfhnlnnplgmcmn	TRUE
mfcglnmkddlalhk	TRUE
mfemhckmebhbmem	TRUE
monecdfmlkmjepn	TRUE
monfbbljkkhbfhe	TRUE
nifjfjpbgajaclo	TRUE
nighafhhfeflpcc	TRUE
oblmniejpaoceoa	TRUE
obloieflhmdbajb	TRUE
omdngbfefchioik	TRUE
omeiiaihjpglifo	TRUE
pficcccefdiocih	TRUE
pfidhckibdpglog	TRUE
aabnomjpomeaaaa	FALSE
aadpjkphpdabbbb	FALSE
akdjjajkkebcdcd	FALSE
akecmblomlmabab	FALSE
bfenhkdjhboabab	FALSE
bffahmdibidcdcd	FALSE
bppdigffmpkabcd	FALSE
bppfghnipjebbbb	FALSE
cledbnbhfoiaaaa	FALSE
cleecakgdpgaaaa	FALSE
dflbcdeglnncdcd	FALSE
dfmjdmmgklgabab	FALSE
ealhgpjcdafcdcd	FALSE
eampgjmagdbaaaa	FALSE
elialpgjmaicdcd	FALSE
elibbcnblddaaaa	FALSE
ffhdjggoildabab	FALSE
ffhdkcagnhpbbaa	FALSE
fplmfhammmdbbbb	FALSE
fpmcfndnibaaaam	FALSE
gkhnmajokfocdcd	FALSE
gkiljpkcnfjbbaa	FALSE
hecnlljaleebbbb	FALSE
hedjlamdfeababf	FALSE
hoccginjakoaaaa	FALSE
hocdidhoglbcdcd	FALSE
iibehbebbcmbbbb	FALSE
iibkigkcmaobbaa	FALSE
jbnjomikepabbaa	FALSE
jbodboblbnobbbb	FALSE
jlieoiideegcdcd	FALSE
jlihlgdnmhkcdcd	FALSE
kepfhopjapkcdcd	FALSE
kfbolcchkpbabcd	FALSE
koiohidcjnacdcd	FALSE
kojogeldegcdcdh	FALSE
ljajdigekebbaaj	FALSE
ljaohmfnihgabab	FALSE
melipjghbbgaaaa	FALSE
mellaagpmjgcdcd	FALSE
mookoohmachbbbb	FALSE
moomabomffccdcd	FALSE
nikfjlnbbiicdcd	FALSE
nimipbcflkebbaa	FALSE
ochbpdgfbfibbaa	FALSE
ochmmhggcpobbbb	FALSE
omfmlpbfmjbbbaa	FALSE
omgjiffobfpcdcd	FALSE
pgjcoekjlflbbaa	FALSE
pgjdmkapihbaaaa	FALSE
aachgfhakjlleddi	TRUE
aaegdgonnljcecdl	TRUE
ajkfnanccgkmhhhl	TRUE
ajkiiaoejfbdjcnf	TRUE
bddandbdmfkgamaj	TRUE
bddjcejfgmdddgbd	TRUE
bmdpnlipfdcgcofh	TRUE
bmedeldfeeapkdhf	TRUE
cfebfnkjklajmepb	TRUE
cffgkponcgpdkihh	TRUE
cppphppajdfmaimp	TRUE
daagpdbegfnimpnf	TRUE
dldnogcdehffhabn	TRUE
dldpcpekcllkbmom	TRUE
eglhkhbidbmcjpcj	TRUE
eglmjhajgipbeiba	TRUE
fakplmkphjalbfgf	TRUE
falilgllajmjmhhi	TRUE
fkipbcdomfihkfca	TRUE
fkjeokfpbccbnekp	TRUE
gfmghgjajclolpbc	TRUE
gfnmkhcoghocbopa	TRUE
hadcchjahbjpehdp	TRUE
hadknoabhfjfaicp	TRUE
hjjhkampfaehmhfj	TRUE
hjknglkjhhcappck	TRUE
idebbpecjfdohbkm	TRUE
idhhcjjnjiogjbee	TRUE
iojacjopmcofdaaa	TRUE
iojdpbnokjpianib	TRUE
jhbibopfmhaglkpm	TRUE
jhcjhlijeibomdci	TRUE
kbjejkfimpffleip	TRUE
kbjlnebdpjljlchl	TRUE
klepnpjhbkdfaipk	TRUE
klfpahfbbmhgohch	TRUE
lfeifbngchhapgcl	TRUE
lffeikkadihbdcpf	TRUE
lplennfmgdajfebj	TRUE
lpmagajplklhmcdb	TRUE
mjnhodgdabdmgfji	TRUE
mjohheamaglkfbfk	TRUE
neeeoeefgpmgjdef	TRUE
neelgoephlmkknck	TRUE
oaadfcnlipfbnipf	TRUE
oaadghhjecfgjadi	TRUE
okhmcmogmddgbpjo	TRUE
okknbbdelohpidof	TRUE
pemboajlmpjbiihk	TRUE
peoecoajkfeeacjj	TRUE
aaaijaihpphgcdcd	FALSE
aabacpnpnkgjbbbb	FALSE
ajpkjoelkglcdcdf	FALSE
akaaaaoabkmkmklo	FALSE
beakdmghmfaiabcd	FALSE
becgoggnoaoeabcd	FALSE
bnphgcpmcfndaaaa	FALSE
boafoijlcfinabcd	FALSE
chjeliaagbeiaaaa	FALSE
chjkefcidpgibbbb	FALSE
dbpmpkhgclfjbbaa	FALSE
dbpoghllfhfdcdcd	FALSE
dljepbhiohkncdcd	FALSE
dljffknhmoalabcd	FALSE
efijdmopenodbbaa	FALSE
efijmlacpocabcdm	FALSE
epgfeemnnomjabab	FALSE
ephgggfeogkkcdcd	FALSE
fhmpdbpoaoekbbaa	FALSE
fhnnilenfmmebbbb	FALSE
gcbmkekhnepcabcd	FALSE
gcceadeopihicdcd	FALSE
gneekgepknodbbaa	FALSE
gnfmopmbkkkkaaaa	FALSE
hhdmdfgadnkiabab	FALSE
hhfckkakkcblaaaa	FALSE
ickepcgpbgbibbaa	FALSE
iclfnoeicnniabcd	FALSE
imhejjkagnhjabcd	FALSE
imhemkcidmgnbbbb	FALSE
jgpkobgalfdfcdcd	FALSE
jhbookckckcdcdhd	FALSE
kdaacngllgfibbbb	FALSE
kdaffdalokokcdcd	FALSE
knadidodjhncbbbb	FALSE
knadpmpakcicbbbb	FALSE
lhhjnnigmbblaaaa	FALSE
lhiihodjdabacdcd	FALSE
mbgimefjfbhkbbaa	FALSE
mbgldhpmkihhabab	FALSE
mmbajicknfkabbbb	FALSE
mmbanlkknipgbbbb	FALSE
ngghpbehbbhoaaaa	FALSE
nghaiikggeifcdcd	FALSE
oaonjllfjhafbbbb	FALSE
oapakjidnnldbbaa	FALSE
okogmffbbkdnabab	FALSE
okpadhfgechaaaak	FALSE
peflchdkeniibbaa	FALSE
pegfeokgfnfiabcd	FALSE
aaajjaihpphgocnca	TRUE
aabcokgjffkkiblgf	TRUE
ajpigfkjemhoienek	TRUE
akagonefpjdfgoime	TRUE
beogenldcnlfmclnh	TRUE
beoildcdkgnemljoi	TRUE
bododanhldnlfonja	TRUE
boeknngglhfldiamd	TRUE
chehdgffdhbbkhpfn	TRUE
chfgnigmcglmoehfj	TRUE
dbkokogfgolhchfca	TRUE
dblljdghejncoilim	TRUE
dlhpfaefgjbdbjlkh	TRUE
dliffgomhjfogmckk	TRUE
effclogmmjnkbdnpe	TRUE
efidjfjhndfihphcm	TRUE
epecfjkegdndeebpp	TRUE
epemchhobaoagafbd	TRUE
fihbkhoibcccmimmc	TRUE
fihckkbmiopncacjo	TRUE
gbpcgdmmickedjbdb	TRUE
gcacmciaicoiihfmm	TRUE
gnmcijipbaoibmfoa	TRUE
gnmnebdiadcajdmbm	TRUE
hhpohihmhdiimiaba	TRUE
hiaikmijkhindegbp	TRUE
idegkgfiiphipnlcd	TRUE
ideledpijnneicbhf	TRUE
imkjcldppoalbpjle	TRUE
imkjcmlglbndndajj	TRUE
jhfamjejlnjjmkled	TRUE
jhfbedchhkniadamg	TRUE
kceojnadnhjdkaoke	TRUE
kcffgdfbgpljpmkgb	TRUE
kndompgihcjohockb	TRUE
knfajfmeoiegpjcbi	TRUE
lhmdphhghiabfjfmc	TRUE
lhnhmneehokldgjab	TRUE
mbijenlabknmlldmj	TRUE
mbioabmdppledbbkd	TRUE
mmkgmchljhbmcefjj	TRUE
mmldaaadpckhkefdd	TRUE
ngjmkdndpekajehkf	TRUE
ngllpnfcobbfniapa	TRUE
oaoldjcnjnjbmamec	TRUE
obaepjlogelfdldee	TRUE
okfkdlhejlhfhnfbo	TRUE
okfojpbbmafdhmfip	TRUE
pemdgljnkpdamckeb	TRUE
pemlcpjbkgbobdjio	TRUE
aacajhkaedljlbbaa	FALSE
aaejbclfefgfnbbbb	FALSE
alceafdlpccinbbbb	FALSE
alcholdlaenlfcdcd	FALSE
bgflihpkplafjbbbb	FALSE
bgfpmbomnfdmlaaaa	FALSE
cbgbghkfkkbecabcd	FALSE
cbhlpkfmlkajkbbaa	FALSE
ckklbjlibedlobbbb	FALSE
cklhjemhgdfabcdej	FALSE
dffhgobfmddlccdcd	FALSE
dffilfpnokgaiaaaa	FALSE
eapphpijfhffoaaaa	FALSE
ebaapeilnhnpjcdcd	FALSE
ekcocccndjmgkcdcd	FALSE
ekdemkmadmejobbbb	FALSE
fejjngdmlmlbdabcd	FALSE
fejkkemdbejgfbbbb	FALSE
fplmggmecgafpcdcd	FALSE
fpmbpbgphabknaaaa	FALSE
giofejnnegelebbaa	FALSE
giokgaebejofkcdcd	FALSE
hdbpocnpjmfdlaaaa	FALSE
hdccffnaippbdabab	FALSE
hmnebcblncabebbbb	FALSE
hmnmldhahkponaaaa	FALSE
ihhhoemaphljacdcd	FALSE
ihkffeocgjjfhabcd	FALSE
jbjddjbndhlleaaaa	FALSE
jbjodaobkjbgpcdcd	FALSE
jldopkonfmmlibbbb	FALSE
jlenklmmgbhapcdcd	FALSE
kfgohkhgloejjcdcd	FALSE
kfhocpiakndopabab	FALSE
kpllhcnibhjgbbbbi	FALSE
kplpngdckhpjlcdcd	FALSE
lkboailiebkknbbaa	FALSE
lkceniolanhccdcdf	FALSE
meajljjggpcjaaaab	FALSE
mebedlioomhjccdcd	FALSE
mnaaajigfaccaaaao	FALSE
mnaeogffjfcjmbbaa	FALSE
nhcekhcfdhmkncdcd	FALSE
nhckbdhjcnkacdcdp	FALSE
oalcbadphdghkcdcd	FALSE
oalhmpmpfpfeobbaa	FALSE
okpobmdgkdpdjbbaa	FALSE
olbmffdolnhhkaaaa	FALSE
pfihjpijpncakcdcd	FALSE
pfiollcbdojpgbbaa	FALSE
aaaegenojllpbdgfdp	TRUE
aabjmdjnhchohgghcp	TRUE
akicldnooilippkcpa	TRUE
akiofdjijnnomibbpo	TRUE
bfgmmdgcpiakligfda	TRUE
bfhfaanlnnnfajccme	TRUE
bpamcpdigomohfgaib	TRUE
bpcabpmpbeobbfnijg	TRUE
cidcofehoigkkbphdd	TRUE
cidepfeaklbbniciam	TRUE
dcienndkhcjcifnock	TRUE
dcjdflfohnmlkjnomk	TRUE
dmgooafmkafmkapbch	TRUE
dmiglnondjjnfklimc	TRUE
ehalhlmeafkjbdflnk	TRUE
ehbpccoikkhjdkliji	TRUE
fcfopcggkjckljdplm	TRUE
fcgbladfjiipjonodi	TRUE
fnmoldmkejfinbkhfg	TRUE
fnndagfdnbjclcooop	TRUE
ghhbjeclifikehifmk	TRUE
ghhebaidognhfdaelf	TRUE
hbfdnkiidbfjljplpb	TRUE
hbfepnnjndpebkaaff	TRUE
hmfpphlngdllcalaed	TRUE
hmigehlikfklldkhol	TRUE
ihcbnanglggngnopag	TRUE
ihcifpddleklhjdppa	TRUE
jamahojpejgbencoah	TRUE
jambadbgeejempiloi	TRUE
jlhhfnjecgmjhfbhpo	TRUE
jlimdmnbcokcppheie	TRUE
kfoklnpmenakhdfibb	TRUE
kfopkohapnebefgfag	TRUE
kpigfljadlmpbjmpjk	TRUE
kpmdlfopajppialgkg	TRUE
ljkpcepcmgfffjhgep	TRUE
ljmmbbmcdbgjdiecgc	TRUE
mdiipofijdidlgaina	TRUE
mdiljibpnafglpmbbi	TRUE
mmoeekbihhmjlddmmn	TRUE
mnagfmmimhgdpldcdg	TRUE
nhffoialmdbdnmhmbf	TRUE
nhgjljmgboabmhehfd	TRUE
oanancmkefokajddjn	TRUE
oanebanikbaeodegln	TRUE
okpbhipalkljgfdknk	TRUE
okppdeifhhkaaccogd	TRUE
pgacbhoanlcdggndoe	TRUE
pgcgeiemfognkmhofo	TRUE
aaadgenojllpbdcdcd	FALSE
aabfdpjmdjnhchcdcd	FALSE
akihfaolcafllebbbb	FALSE
akjkiaeglmjaomcdcd	FALSE
beapdhjfbmhkkcdcdf	FALSE
bebkphcmgaihaobbbb	FALSE
bofedgfljbnmiocdcd	FALSE
bofgdhonbkifahbbaa	FALSE
ciphaaahejhhhocdcd	FALSE
ciphfjjfgehffebbbb	FALSE
dcglngcgelkaodbbaa	FALSE
dchghdmopdgolkcdcd	FALSE
dlojeighjbaaogcdcd	FALSE
dlphfphlghihbiabcd	FALSE
egnjpaiidohglcaaaa	FALSE
egnpkffgmjpgeobbaa	FALSE
fccfgbgmneofpkbbaa	FALSE
fcdiikbhccfhdmbbbb	FALSE
fnakiieogbneoaaaaf	FALSE
fnbhopcggkjcklbbbb	FALSE
ghilbadllheamecdcd	FALSE
ghjgminbcmhlmmabab	FALSE
hbomeophjljigabcdd	FALSE
hcbbopnbgjhoiacdcd	FALSE
hmkdgipekaongabbaa	FALSE
hmmgadcnmdbhidcdcd	FALSE
igelnhjaknhdcocdcd	FALSE
igjgachekenkgicdcd	FALSE
jannkojmfianjfaaaa	FALSE
japcaelapdfjaibbbb	FALSE
jlhafdnnkcbcnfabab	FALSE
jliacnoemkmehibbaa	FALSE
kfkbmaagbcgkhbabab	FALSE
kfkhokbmgcnenfbbaa	FALSE
kpjckjahopnacpabcd	FALSE
kpjiafgfcligiccdcd	FALSE
liojkpaneaeefdcdcd	FALSE
ljahbdllcomgijcdcd	FALSE
mdheolhnnpfaoebbaa	FALSE
mdilhiboohngngcdcd	FALSE
mnddlkbafmnhkbcdcd	FALSE
mndjkjhlkkiljpbbbb	FALSE
ngnhhpbnajfgekbbbb	FALSE
ngofmanddfdkimbbaa	FALSE
oapaichfblnkiibbbb	FALSE
oapbelnbmkknnkabcd	FALSE
olebggiginhfcabcdd	FALSE
oleipojleennpfaaaa	FALSE
pgdhecipjkffoocdcd	FALSE
pgdljdgcnggglbabab	FALSE
aaalnaopglkbamfgpea	TRUE
aabaignkmakhnmpidch	TRUE
ajdlagnofddpbnclglp	TRUE
ajemigofkhgphnojdbi	TRUE
bdjfbakolmcmghbeenk	TRUE
bdjlcmelaniannikhfn	TRUE
bpplfgcdocblniknehc	TRUE
bppoendjgdpmipkibfh	TRUE
ckhpghgnfolcnbaglmc	TRUE
ckhphkmnhipaimhjjfh	TRUE
dfhaplbccfmnhpiadjp	TRUE
dficnbpfcphdlhajgij	TRUE
eaikfkkahkipfdjobnk	TRUE
eajanfdcggajmnbodfk	TRUE
elokchhccfcopkinflo	TRUE
embeopolcopglfllmmm	TRUE
ffiebkimmfmnmogenle	TRUE
ffjdaaajalceapainpi	TRUE
fpicdflmodpelfhoeme	TRUE
fpiiaimkcmdbnbklmpg	TRUE
gjlaahenndebcodaehf	TRUE
gjmjkfnadipoeaaogge	TRUE
hdljhoffbfhmcabfnfl	TRUE
hdmlhligbfolpigampf	TRUE
hofimnhbekdjjndcnli	TRUE
hofmpdhmknbblgnpmfc	TRUE
ijcoiamnilagfkcldib	TRUE
ijedbdaejnaomoebldn	TRUE
jeeoibnmfgkglomjalk	TRUE
jefnaafcbabpmbdobgm	TRUE
jpgkjlnjmmgkdiahcfb	TRUE
jpgklmdmpfeaibgladn	TRUE
kkahkpgpllnjcegbilo	TRUE
kkbpfdjgamcfldpmjoh	TRUE
ldbenlochgcccmgcnoi	TRUE
ldbnpiihnljbnmhnloj	TRUE
lmflkdmlddfikgppbld	TRUE
lmhgkhognoepokjjgkl	TRUE
mgalkfpamekmndghcbo	TRUE
mgbdnlcmkiciadbjgkp	TRUE
nabhlkegkoaajihpgdc	TRUE
nabjoccbgnmigeppela	TRUE
njjflpmdpmhkhhjlbck	TRUE
njjndgjdinjolpmpdhd	TRUE
ocgbldckbgklgbkfbnj	TRUE
ocjepolpnlghngpgogp	TRUE
onenknelpmdfholdmbh	TRUE
onfdcenjgnlcnfjecha	TRUE
phbpgihonolgalhlmnj	TRUE
phcgaiijknjdlpldeee	TRUE
aaagfiffjonfeecaaaa	FALSE
aaammpniahfihbnabcd	FALSE
aikdppdeadpaijlbbaa	FALSE
aillgnplimkpkenabab	FALSE
bcpkelabkabnokfabab	FALSE
bcpmknfclepnbghabab	FALSE
bngjfnbdpgcakbnbbaa	FALSE
bngobnnglegjnolaaaa	FALSE
chlihehkifgjbcpaaaa	FALSE
chnbkfpfggcmlhkaaaa	FALSE
dcbaaknfehejejgbbbb	FALSE
dcbkjpeilbjpcelaaaa	FALSE
dmgiokkmgfnoadeaaaa	FALSE
dmglgmjndchikdhcdcd	FALSE
eggcmhlchaiejkgbbbb	FALSE
eggfhlldpijmkeicdcd	FALSE
epjecfcaeilcoajcdcd	FALSE
epjefgkfpnojeogcdcd	FALSE
fkfalfcbijgkjlecdcd	FALSE
fkfepkakmcpnpngbbaa	FALSE
geccmdgcdahockebbaa	FALSE
gecpheiicnhhdmgbbaa	FALSE
gopojdlbaeddiacbbaa	FALSE
gpbnjfkiodjnlhhaaaa	FALSE
hjedgighghoajgbbbaa	FALSE
hjfaecaegcdejokabab	FALSE
idgemgoniboomplcdcd	FALSE
idgenoaphddphkhcdcd	FALSE
inpiieicnojihencdcd	FALSE
ioaooklcndhmjnfaaaa	FALSE
jjninfmcmjliankbbbb	FALSE
jjnpbcbappmmllhabab	FALSE
kdmbmbbncacafnjabab	FALSE
kdmcpgfmdplpamcdcdd	FALSE
kncehpipmgcfoelaaaa	FALSE
kndamcdahniiohiabab	FALSE
licaogckfpaldihabab	FALSE
lickglboaneljhpcdcd	FALSE
mcchnggiiakanppaaaa	FALSE
mcdcehgombllnofcdcd	FALSE
mmejdajgijejpbgbbaa	FALSE
mmficplddnekdgocdcd	FALSE
nhjpehpfoppibaibbaa	FALSE
nhkhcmchfjogbalabcd	FALSE
obdcfcdgimenodlcdcd	FALSE
obdgpmhhgcmdccgcdcd	FALSE
okhknknlfaohbnlbbbb	FALSE
okigdbjpkikbnlfbbaa	FALSE
pfmnhminepfklifaaaa	FALSE
pfnnlfpkangjpmjabcd	FALSE
