adaphndddk	TRUE
adbhmmobem	TRUE
allccghbcd	TRUE
allhjihjdk	TRUE
bgponmnfif	TRUE
bhbeanjcgn	TRUE
bpfidlmipl	TRUE
bpgbjeogbm	TRUE
cikndejiof	TRUE
cilijeiodh	TRUE
dcfjhfjegg	TRUE
dcighclmhm	TRUE
dmnhamgjjb	TRUE
dmoijeminp	TRUE
egkolgcngo	TRUE
egmagehloo	TRUE
fadodhajai	TRUE
faemkmbmcn	TRUE
fjoddfkonf	TRUE
fkaheojpan	TRUE
gdhonhiplm	TRUE
gdijajmdih	TRUE
gpbmgeonhk	TRUE
gpdfncpmig	TRUE
hjidlhfmni	TRUE
hjiedildfd	TRUE
icfkohfgef	TRUE
icgcjceghn	TRUE
ioclkegdaj	TRUE
iodjbhhioi	TRUE
jhmbommeea	TRUE
jhmjbfdbeh	TRUE
kbldpdghkj	TRUE
kblmlfajic	TRUE
klmmjdhcob	TRUE
klmodkefld	TRUE
lgpamonifa	TRUE
lgpkmbmiie	TRUE
mbgeodgpdp	TRUE
mbhncgcfjo	TRUE
mlbeolmkjn	TRUE
mlbicipjoe	TRUE
ngjegafgkm	TRUE
ngjmghmglp	TRUE
npojilkmfm	TRUE
nppbcdhhoj	TRUE
okkempdlcd	TRUE
okkkcamfhk	TRUE
pfgknghflp	TRUE
pfjchojnim	TRUE
aaabeppjdo	FALSE
aabopklefl	FALSE
ajpbkocnbd	FALSE
ajpdpgojba	FALSE
behfgajfac	FALSE
bejgimaaid	FALSE
bojnkdpach	FALSE
bokalielbd	FALSE
cihhhffdbd	FALSE
cijiedheac	FALSE
dddcglioac	FALSE
ddeanmhdaa	FALSE
domgeinhab	FALSE
doncggggab	FALSE
ejclieeeab	FALSE
ejdfkjnnba	FALSE
fdhiedjibb	FALSE
fdikadfebb	FALSE
foidedpiaa	FALSE
fojijpjmaa	FALSE
gjhmmdknaa	FALSE
gjiagemfbb	FALSE
hcmcecnhaa	FALSE
hcmjpbnnba	FALSE
hnhgjdkmac	FALSE
hnhknjklaa	FALSE
ihbflckdba	FALSE
ihbhoemobd	FALSE
janglggfac	FALSE
janmbejhbd	FALSE
jkjgonfhbd	FALSE
jkjpjgbkac	FALSE
keoofgbibb	FALSE
kepaijjpbb	FALSE
kpkojjfjab	FALSE
kpmohdombb	FALSE
lkihgjcdbd	FALSE
lkjeljkfbb	FALSE
mdkooahhbb	FALSE
mdlaoamoab	FALSE
mnojaahdhl	FALSE
mnpjdpchac	FALSE
nhgajhpoaa	FALSE
nhinjhemac	FALSE
obkmgopnab	FALSE
obmdkceibd	FALSE
okjgljjcab	FALSE
oklbkhfoba	FALSE
pfpgcomiab	FALSE
pgailhklac	FALSE
adajiblgnpm	TRUE
adangbghbkl	TRUE
albflkgnpje	TRUE
albhechhngo	TRUE
bgjhehkameh	TRUE
bgjkgaddjpe	TRUE
boolaebmapf	TRUE
bopdfmmadmg	TRUE
cjffogkalan	TRUE
cjgdfggdhpa	TRUE
dddadbffcnc	TRUE
ddelmffpokc	TRUE
domagpkaenm	TRUE
donbkhgbkjk	TRUE
ejccbhodbfk	TRUE
ejcdbhpjmoj	TRUE
fdniakeocmh	TRUE
fdnianlheed	TRUE
foknphkialb	TRUE
folkjmafmho	TRUE
gjbmmdllakc	TRUE
gjbonjhblaf	TRUE
hdpaonoibld	TRUE
hdpdefojbgl	TRUE
hnffmganape	TRUE
hnfglaenkdh	TRUE
ignkcblglje	TRUE
ignodgechhj	TRUE
jakkbmhencl	TRUE
jakknnldkbi	TRUE
jlalhchpnbk	TRUE
jlckfleajop	TRUE
kfeleihkjpd	TRUE
kfelkdfgdko	TRUE
kpmmpfmifea	TRUE
kpodeefhnfe	TRUE
ljdjghmckjf	TRUE
ljebneeplom	TRUE
meeoelpklep	TRUE
meghgjpoimf	TRUE
mnjighhloan	TRUE
mnjjcmgmedo	TRUE
nhpfldajong	TRUE
nhpkchfcplg	TRUE
oblkipmkhih	TRUE
obmiileanof	TRUE
oljdpklclib	TRUE
ollknlhegbf	TRUE
pfilkonaehf	TRUE
pfingcplchp	TRUE
aaabeppjdoo	FALSE
aabpkleflel	FALSE
ajphdbfpdab	FALSE
ajphjonmgac	FALSE
bejmgpaakig	FALSE
bekdobfgpac	FALSE
bojaplannab	FALSE
bojmjhpjoaa	FALSE
chllnhianba	FALSE
chmhlooccbb	FALSE
ddfghahjoaa	FALSE
ddfjophfkaa	FALSE
dodoalilgaa	FALSE
doefnjlbbbm	FALSE
ejgnjgmhkbd	FALSE
ejinhhhbanb	FALSE
fdengepfpaa	FALSE
fdgbmnpagbb	FALSE
fojeclladab	FALSE
fokhdggefbd	FALSE
gjgdclmkpbd	FALSE
gjgkagiikba	FALSE
hdnliodnlac	FALSE
hdpbkppmmbb	FALSE
hnchkipnoaa	FALSE
hndaahdlghc	FALSE
iggnldnjcba	FALSE
ighfjbfgmaa	FALSE
jakbfcoglab	FALSE
jakhddabkch	FALSE
jkmllhgldac	FALSE
jkoondcpaac	FALSE
kfddkhhgobd	FALSE
kfegejceeba	FALSE
kppajnoccba	FALSE
kppbjpllkac	FALSE
ljehlkhkabi	FALSE
ljengnbagki	FALSE
mdgfeloekaa	FALSE
mdjjicfnpab	FALSE
mnfmdlgimab	FALSE
mnfnkfaihac	FALSE
nhhbeemmhab	FALSE
nhiefmpjcba	FALSE
obnepofhcbb	FALSE
obnngbdclef	FALSE
olhfoabikfe	FALSE
olhgkgclgab	FALSE
pfimfokbcbd	FALSE
pfinnikcfab	FALSE
adcnfnbnalkn	TRUE
addmldjjaofo	TRUE
alojdikidmle	TRUE
alpdihamncim	TRUE
bhmbhelpdlde	TRUE
bhmicfejhnge	TRUE
caimdgfdbmhj	TRUE
cainkafdmfop	TRUE
cjbgngllocnc	TRUE
cjbidkpnjaof	TRUE
dgdckemlhlip	TRUE
dgdhblkhdagd	TRUE
eamfhoohalfp	TRUE
eamjhecekpif	TRUE
ekbpmjafopej	TRUE
ekcpgmjpenkb	TRUE
fddkjpioidce	TRUE
fdekbfoneapp	TRUE
fnnpelhlophl	TRUE
fnohphncmkng	TRUE
ghfoedbigjjo	TRUE
ghjhdgoildde	TRUE
hboncnibmfng	TRUE
hbpgnnealicm	TRUE
hlbpceooedhd	TRUE
hlchpnhmiepi	TRUE
iepnggplicbf	TRUE
ifadecehnjpb	TRUE
ioaomgpopnoe	TRUE
iobcekbmcpne	TRUE
jimhiclakpmf	TRUE
jimjhioneklb	TRUE
keccflkaogdm	TRUE
kecjmphehnao	TRUE
knffodonjelb	TRUE
knfhoekbnnfn	TRUE
lhcbhcimcfhe	TRUE
lhcffikljdej	TRUE
mbhdpafdeddk	TRUE
mbibgpmbocpe	TRUE
mmianlopdlip	TRUE
mmigklemkhno	TRUE
ngcdcdmaiglo	TRUE
ngckenfkidal	TRUE
obhmlidfalok	TRUE
objpfcelfbpm	TRUE
omchkdcfimnm	TRUE
omddldcddibk	TRUE
pfjjjljdmbed	TRUE
pfjkfgnbncik	TRUE
aaacncpkedep	FALSE
aabcbkefbbek	FALSE
alanbmbfkdbb	FALSE
albielhpbebb	FALSE
bfdjgeknkebd	FALSE
bfekadbhmiba	FALSE
cahdjbieedbb	FALSE
cajbdpiicnoc	FALSE
cjnnegegmhac	FALSE
cjnnialbkgba	FALSE
dfmklpipdgba	FALSE
dfoaehikacfl	FALSE
eainadgmkjaa	FALSE
eajldojkgcab	FALSE
ejglakkbalee	FALSE
ejhpigooihbb	FALSE
fcmgcemapjbb	FALSE
fcnbepnnaalj	FALSE
fojjllbknebd	FALSE
fokdofngdhbd	FALSE
ghnmhijdifac	FALSE
ghnommkdidbd	FALSE
hbjioojohcac	FALSE
hbkdbmmbhoaa	FALSE
hldknnajfoaa	FALSE
hlegaoganmbd	FALSE
ifaokkmnbpaa	FALSE
ifcggomogaac	FALSE
iohkndhddabk	FALSE
ioiohdpobgba	FALSE
jigepgcckbag	FALSE
jihojecinfaa	FALSE
kdjfmmiohkac	FALSE
kdlcnkakidbd	FALSE
koabjgadmehb	FALSE
kobdnkgdfhel	FALSE
lhlfdflehdbb	FALSE
lhljkdhbblog	FALSE
mbcochllkfbd	FALSE
mbebabiejgaa	FALSE
mlfkbbnfndfj	FALSE
mlhaooeeakab	FALSE
nhfkepbmomba	FALSE
nhgnincnohaa	FALSE
oaopapdiiiba	FALSE
obajehponmeo	FALSE
oljfjdfnogac	FALSE
olnaenpkpmab	FALSE
pfjkhgpiejaa	FALSE
pfkcoaeekfaa	FALSE
adafhomnpjcle	TRUE
adahcdfkdpgin	TRUE
amgbhedoioede	TRUE
amijbhceajkdd	TRUE
bicgkhcconmfe	TRUE
bicjojnkfjdme	TRUE
caodgoomdaofi	TRUE
caofdeceeclkp	TRUE
cmegclbikdael	TRUE
cmejngbhmgaeg	TRUE
dfpjakbiodkfi	TRUE
dfpnbiadkhkdc	TRUE
dpinmcclklkpk	TRUE
dpkbhchmfpmbe	TRUE
ejfllcnamncae	TRUE
ejfndhcfhffnn	TRUE
fdlhfaocplchm	TRUE
fdlkdadkpaejk	TRUE
fnddfipangjdh	TRUE
fnelgcmfnimak	TRUE
ggnpnehcjccml	TRUE
ggooodkigngka	TRUE
hblodcgcofemh	TRUE
hbmjejejgidmo	TRUE
hlloegcophijg	TRUE
hlmiknnnpmjmi	TRUE
ignedadjijkah	TRUE
ignncfknolplh	TRUE
jbgiliiodmagl	TRUE
jbgpncjajkfcg	TRUE
jlenanmcjnmao	TRUE
jlfofdemobmeg	TRUE
kfipmhlklbelh	TRUE
kfjblnjbhlndc	TRUE
kpjmonfibgfoa	TRUE
kplohebnedkhl	TRUE
lkcegagbhnfkb	TRUE
lkejppamimdcg	TRUE
mdledehejfgkk	TRUE
mdlnndbkdmegi	TRUE
mnobgbcjinhno	TRUE
mnpcfnadificg	TRUE
niliilbfecmid	TRUE
ninbhbjfhfglb	TRUE
ocfenhgjpdloa	TRUE
ocgjhgdnpoioe	TRUE
omlglfoeimgll	TRUE
ommfbjhaekaod	TRUE
pghlgkpfbfjae	TRUE
pgifdklnoagen	TRUE
aaakfoonpecmj	FALSE
aabgbiclnichl	FALSE
ambfjdfigmkaa	FALSE
amcfjnpnoclba	FALSE
bgbmfiinnmobb	FALSE
bgdgjaifbalaa	FALSE
canchdhinogaa	FALSE
canpdjpigddba	FALSE
cljofbjibbjcf	FALSE
cllaaphjhcpna	FALSE
dflojofajigac	FALSE
dfmdocnjkpfbb	FALSE
dpiemgepbmnbb	FALSE
dpiemobbcmake	FALSE
ejcoiempibkba	FALSE
ejdjbkjfcohaa	FALSE
fdijjgllocbac	FALSE
fdjfnabjaidmh	FALSE
fncbhcejjijbb	FALSE
fndflofbifjaa	FALSE
ggnbjgfpljcbd	FALSE
ggnkjhlmilmaa	FALSE
hbleiecnhmibd	FALSE
hblnkdgjmgkaa	FALSE
hlofkomnplebd	FALSE
hlopdojkhlmbd	FALSE
igjjbbpejpiaa	FALSE
igjmfockkbgab	FALSE
jbianjhpiogbd	FALSE
jbjbkmfcmdgba	FALSE
jkmechnjnjfac	FALSE
jknokjaccbgil	FALSE
kfnacdfockjem	FALSE
kfopgcfajaapl	FALSE
kpmacaeacjdgm	FALSE
kpmpmahlkpcac	FALSE
lkajlnlmochac	FALSE
lkbakhhjgfapg	FALSE
meblfclmfcoab	FALSE
mecnleanndaaj	FALSE
mohonjinainab	FALSE
moikffnncbkba	FALSE
nibfffjacagam	FALSE
nidaccccfkhep	FALSE
oclkgkokpanab	FALSE
ocnhlmmbhnoab	FALSE
ommkmalgokaci	FALSE
omnoimlmmpgab	FALSE
pgmmigcipcbbg	FALSE
pgojahkillebd	FALSE
adcnejbnhhefoh	TRUE
addaelfbgodmaj	TRUE
almjkfdkgdmnil	TRUE
alndjffkfjggcp	TRUE
bhbncjcfgmdici	TRUE
bhcklppggflakc	TRUE
bpianmmnicmice	TRUE
bpijinfpdcnfkm	TRUE
ckionjphninbcl	TRUE
ckjedlblbiekhe	TRUE
decblikoedekja	TRUE
deckbpkekbgihi	TRUE
dnohlmkgmmpaeg	TRUE
dnohpfbgadfffm	TRUE
ehmhdmbjcefnka	TRUE
ehmlkdmmkfnble	TRUE
fbggipppmmpldo	TRUE
fbheaeclibhdap	TRUE
flnjcjajollenc	TRUE
floeaphadbphfi	TRUE
gghajafdmddian	TRUE
gghckkcmllgodf	TRUE
hbokpfmimdgncd	TRUE
hcaoahmfhhbgmd	TRUE
hlgmibnldcjkmh	TRUE
hlhjifhggcknhm	TRUE
ifdgbnjfbignol	TRUE
ifekgooojlnopo	TRUE
ioilhjapmiagfo	TRUE
ioionplnmpoope	TRUE
jiekmkfmogflip	TRUE
jieopioofhakma	TRUE
kbnbfpdmocaekd	TRUE
kbndciajbclibc	TRUE
klpngfdepjbkbo	TRUE
kmalellnbemijj	TRUE
lgcgpngehfoomk	TRUE
lgdggeafcfahho	TRUE
lpmapilllbmhic	TRUE
lpohldfnnmcnog	TRUE
mkkllcdhadjnpf	TRUE
mkmfgmbgdjmike	TRUE
nfogdafjdakccb	TRUE
nfoiogpmdkdjkl	TRUE
nppjebogggokfa	TRUE
nppmhcpejlhifk	TRUE
okednifhlkpdln	TRUE
okemeendgpdoin	TRUE
pfcbgepjnkgmgo	TRUE
pfcofmihaecoge	TRUE
aacnkpnoafpfnl	FALSE
aacnmflnbmdahi	FALSE
akdbkkfnocdiba	FALSE
akdcggfnikflbb	FALSE
beinfpbbbjiomo	FALSE
bejoobpalfomaa	FALSE
bphpolpkdefeaa	FALSE
bpifahgbnfjcbb	FALSE
ckcemccopaooaa	FALSE
ckcjnjnfgpbakf	FALSE
deeepiadpngoac	FALSE
defpdihcceinbb	FALSE
domaegojolobbg	FALSE
domafjalgpblaa	FALSE
eicbplgiapfgbb	FALSE
eiccpgdldbhacd	FALSE
fbfgapockohgab	FALSE
fbiggcikfdhgac	FALSE
floifcdhojggab	FALSE
flokkahfgjkhbb	FALSE
gghjfiggeflhbb	FALSE
gghmnooldjphbb	FALSE
hbgjjmmfpnfjac	FALSE
hbhhiahbedclaa	FALSE
hmeljlpilhniac	FALSE
hmfofecpijeeab	FALSE
ifdefhdmbmdmaa	FALSE
ifdfniopoelhab	FALSE
ioicgcnldlaabk	FALSE
iojfcgbbjmadnc	FALSE
jioepdcfflalbb	FALSE
jionoabbpoahld	FALSE
kblhgkjiepfacn	FALSE
kbmfjfjhejjcbd	FALSE
kmgghhcdkmjcbd	FALSE
kmggkiacdcpbok	FALSE
lgeiecmaehpmbd	FALSE
lgfebfahdhggab	FALSE
lpoepcponflkbd	FALSE
lppepedmmldnbd	FALSE
mlcejahngnkjbd	FALSE
mlcekpdglhknbb	FALSE
nfmbjfhhfnfcaa	FALSE
nfmdbmklnlkgaa	FALSE
npoilbbjkmfkfl	FALSE
nppcaebbnljhhp	FALSE
olbabdhoooello	FALSE
olbkmjilcdimbd	FALSE
pemmjiohcmceaa	FALSE
pemnbmboiodoaa	FALSE
adaekokgcpkhnnp	TRUE
adbeonmlalnojdm	TRUE
alijlcajfnalgbi	TRUE
alimlliognkeghn	TRUE
bgjadljhpnigbfp	TRUE
bgjfeinmpkkmbmg	TRUE
caflpiifijakjpj	TRUE
caidoljecnajngm	TRUE
ckkckedjnggaeho	TRUE
ckkjlknokdcjfoh	TRUE
depkaglcdpdocgn	TRUE
dfagooajgikkngp	TRUE
doohdjddfhiimdf	TRUE
doomboffphanmeo	TRUE
ejbeheiplpcaldj	TRUE
ejbpdkbcoffekha	TRUE
fbpbpghepedihno	TRUE
fbplogbefajnklm	TRUE
flpiamajahnjfmp	TRUE
fmaefdphbmgkhie	TRUE
ggkdipcejmojnop	TRUE
ggkfjopkcpcchal	TRUE
hbnfoaomnlfpnpb	TRUE
hbofbohjmkhildo	TRUE
hljogjmcmdfbkfk	TRUE
hlkmalanfnlflic	TRUE
igfjlidmilgllng	TRUE
ighagnojjmeodof	TRUE
jbcpfjeflnjahkd	TRUE
jbejdmiecodblkc	TRUE
jlmokjehcealpme	TRUE
jlnechlaheimkel	TRUE
kfdagljnpbmodkh	TRUE
kfegkjbpnedcpoj	TRUE
koegnldedodgoal	TRUE
koejahndhojmnkb	TRUE
linpdmobgcadjgi	TRUE
liojgegpkcapcni	TRUE
mcigphlijefnhlp	TRUE
mcileknneaklbhf	TRUE
mmefmgaglichgde	TRUE
mmemcpohennodfd	TRUE
ngjbcmffbjaphjd	TRUE
ngjncgnnnpiklaj	TRUE
obfgkhiafhhccbf	TRUE
obfjbillnbnhalj	TRUE
olchigeebphkhhh	TRUE
oldjhgofbhdbibc	TRUE
pejnjapljgmmneg	TRUE
pekapnihhdncjjh	TRUE
aaajmnlkjaocfba	FALSE
aabhmkagceenheo	FALSE
akdcidanpmbcfab	FALSE
akdicdcoicdbjab	FALSE
beeoeommloeabeh	FALSE
befniamkkkamjac	FALSE
cacdoobgjlmoanl	FALSE
cacfdmmlkepkdao	FALSE
ckeloilddbglnbd	FALSE
ckfenmficpjhpab	FALSE
dfdmnpbifblbgab	FALSE
dfegnhmlgjaggac	FALSE
dpbdmnjeiecpmla	FALSE
dpbohmjcngbogbb	FALSE
eikenfbimdlecba	FALSE
eikkhccamhoihbd	FALSE
fboiejfppmjanbb	FALSE
fbolddlmphgmoac	FALSE
flokdaefiihedac	FALSE
flpaapfojjpcina	FALSE
gfmoaegeegbchbb	FALSE
gfncaadakaemgff	FALSE
hbdnpkbfodgdofh	FALSE
hbeakhcbilfljaa	FALSE
hlhnjekmfanphba	FALSE
hlhpnkhmoagepba	FALSE
igecdbnaggkkkab	FALSE
iggfddnjfbonabi	FALSE
jbakmanbeabfplg	FALSE
jbbhcbbdifimbdi	FALSE
jlbhhkkdeobcaaj	FALSE
jlchcebfnadbhaa	FALSE
kfachalokaihkpa	FALSE
kfcapgjkpmdiebd	FALSE
kohcibidpnfjkbd	FALSE
kohoidhogmhkhac	FALSE
liabfehejokgifb	FALSE
liahdfigondpcbd	FALSE
mchicmokngamkab	FALSE
mchjhaeleplciab	FALSE
mmkfdaagdgjibcl	FALSE
mmkjkkdjoagjdab	FALSE
nheachdehepifcb	FALSE
nhfcnchekmnbhbd	FALSE
obamnehonmbncdn	FALSE
obbanogfcjilbjc	FALSE
oklpjnlcgojdeba	FALSE
okmelffpnkkmgaa	FALSE
pencfmjmhkoocac	FALSE
peoijfciieajmbb	FALSE
adapbldlgcmfmpfg	TRUE
adbeikihdocagkdb	TRUE
amfojchpnlcpniok	TRUE
amggafkfldhbmdoe	TRUE
bhklnphejhnpjjgd	TRUE
bhlnhelclmdfgmjd	TRUE
cbieipcnkhgebgfj	TRUE
cbilmghanahpjigo	TRUE
clbplaikmpopnchh	TRUE
clfdagijaknaflgi	TRUE
dgccmiijmboahihj	TRUE
dgcofjfghhbiobfl	TRUE
domaholhpdbgjfmo	TRUE
dombkjgphllkinhk	TRUE
eiemldbiplpgkicc	TRUE
eiglgjeijapnahaj	TRUE
fccgcmgdiodhlced	TRUE
fcddfkiahkeakagg	TRUE
fkpdhibganaoonio	TRUE
flahbepgaogehngj	TRUE
gflnaopofijhmcjf	TRUE
gflnbeimbfanhnpg	TRUE
gpmlfjiedadndheb	TRUE
gpmmokgdgneeppln	TRUE
hkhojphlingnepkj	TRUE
hkikjggcbhomfnpe	TRUE
iepfcpdaiihbhemn	TRUE
ifaedajmfopccflo	TRUE
ionfhjffbgccblbg	TRUE
ioocoahinkpkgoik	TRUE
jipdchahkkckgick	TRUE
jipganblkijkigmb	TRUE
kcliidaikdiciaoa	TRUE
kcmfggkmndmpbmlb	TRUE
knhdpcdfnjionkli	TRUE
knihlnhnljhfdbjn	TRUE
lidgceldhcbidaog	TRUE
liefaimebpnfpame	TRUE
mcehlmohdpifcbkl	TRUE
mcgngoelkpneohil	TRUE
mlifmbkkjodfaimh	TRUE
mlkhplbigcmalceg	TRUE
nfghfcclkidjjpbo	TRUE
nfgnpbhdfglpkgie	TRUE
oajccllbillfhjdb	TRUE
oajdojdkojiejbnj	TRUE
ojknbcpceegefkhe	TRUE
ojmdoiohekgejemp	TRUE
pfaglggbjgioiijf	TRUE
pfblijjchfgefohp	TRUE
aaajaoogjmbcaipe	FALSE
aabcapkecgbpljbp	FALSE
aknkoampbfigjacb	FALSE
akpopiepcedoklba	FALSE
bekjjbhmgbcofoac	FALSE
beleddpljbljhmac	FALSE
bpeendgaemfllebd	FALSE
bpekalaklfainibd	FALSE
cjoboiedgbmkocba	FALSE
cjojcobacfnjlenp	FALSE
dehamkkiddndnpba	FALSE
dehhmlphdglidobb	FALSE
dodblcomdhioneaa	FALSE
doefgkkedinpmlbb	FALSE
ehjilhpnopochoba	FALSE
ehkekfglakhjkacb	FALSE
fbbngcjffpbahjie	FALSE
fbboimjkhonljfdj	FALSE
fkeccjlomaifljaa	FALSE
fkenjgopaankihgj	FALSE
gdoabpgaajdebhie	FALSE
gdoofmbihglhaibb	FALSE
gogoneagcomdnpba	FALSE
gohfioagbklgogac	FALSE
hilplnfnainbnmac	FALSE
himhfioijannkbba	FALSE
idnggjnmipbobjbd	FALSE
idnhjkoadcihgdac	FALSE
ioejijnfmpnpdbae	FALSE
ioelfhagcihllgab	FALSE
jjgpheoocnanmdbd	FALSE
jjhpbbnkmdaememe	FALSE
keimhjjaphnpeibd	FALSE
kekejllcclcmoeab	FALSE
kollgmfabkcoibdf	FALSE
konicflhmajndfab	FALSE
ljjbjldbhhfffiba	FALSE
ljjedglekhlhdibb	FALSE
meajiepdpnfmemab	FALSE
mecandjkifdomlaa	FALSE
moabpedfogiagnfp	FALSE
moaepafnfpkhllac	FALSE
nhkafekpbflngban	FALSE
nhkncnafokolmpac	FALSE
obfnbhoakedogeab	FALSE
obfnfamkbcjfjibd	FALSE
olaljdjfafehndaa	FALSE
oldjkflbhndhhgbb	FALSE
pfldnidkojajkdab	FALSE
pflmiioidibkmpac	FALSE
adahklcghahibnknf	TRUE
adaloahcdijlilaia	TRUE
ambnlfeioikciclef	TRUE
amdeahgnijopoieae	TRUE
bhemnejpcdldfgdoo	TRUE
bhfgohnepconkailh	TRUE
bpeibhapfijojalad	TRUE
bpelhhnnjbejdjnpk	TRUE
cjdffjkecnchfcbmg	TRUE
cjdmcafodndcfjfpc	TRUE
deeapnpafhgeednch	TRUE
degkeoihhikgpiifk	TRUE
dojjfehncbeklhbln	TRUE
dolaonamingjoogok	TRUE
eieaojcaklknllkbf	TRUE
eienakffhahbkghhf	TRUE
fbidceajfiofgnhbj	TRUE
fbifcenjcebhjpdea	TRUE
fkbkafdccppjjihjd	TRUE
fkclgcclcdcihpknl	TRUE
gedamhfiknifojidk	TRUE
gedjlcihddnclkpaf	TRUE
gogooidochgkbpfbl	TRUE
gohimjlpcbipcophj	TRUE
hiilnkpkhebgngcme	TRUE
hijdpfcpfcoohppnc	TRUE
idnibpnehcemmknob	TRUE
idolcjihamandpahe	TRUE
iogjakckpkiaeagbo	TRUE
iohceidmohbjjfaih	TRUE
jjjgdpopgdoekpekg	TRUE
jjjkgmcpifjmgjlme	TRUE
kdlmfgpdedoagnamg	TRUE
kdmpejhnaoipgdpbf	TRUE
koifajeecamppbjlf	TRUE
koiflalojceninngl	TRUE
ljphaklbiiadcoamc	TRUE
lkcakpicbklkidenf	TRUE
mfbfgkilpkmeagdfk	TRUE
mfcfanidpjhapjjge	TRUE
modjkocobhjghaome	TRUE
mofigdmmdohoobphp	TRUE
nhkeanhmljgipjgek	TRUE
nhngfpcijilcpknpi	TRUE
objbfogiaklklaipi	TRUE
objgigdbmlbmglhod	TRUE
olgjjfaigdmjhagno	TRUE
olglologhblfnoodc	TRUE
pfgfhloepbhkalgao	TRUE
pfifgghooceblpncp	TRUE
aaagekfnadnmbemlj	FALSE
aabgipfpoejdpcdoc	FALSE
ajmfdehnjlkhlljbb	FALSE
ajmgpaedplmaoiacp	FALSE
bdafkbpahngoeiond	FALSE
bdaoibocopmljmipg	FALSE
bnlnepcdckmagpkba	FALSE
bnmcncpjibonaajjh	FALSE
cjaejmmfbggbeefab	FALSE
cjapkigeoafmfnjbd	FALSE
dbphneaifnioigmab	FALSE
dcagkibogopjehmac	FALSE
dljcemgdbpalnnlba	FALSE
dljghmmhihjjdpcbb	FALSE
eekpbbgjhdijigoco	FALSE
eeljjonjfknmfjlba	FALSE
eokdgmfpnfblmkgac	FALSE
eokgmkdgieenngibd	FALSE
fjjkgejfldepjfoba	FALSE
fjjlbcogfiiinebda	FALSE
geeadfdhkkbmpofbd	FALSE
geekekpnmjmgnaceb	FALSE
gncecacppcdfahpfa	FALSE
gneahljecdogjjacl	FALSE
hggekmfhkjppogiac	FALSE
hggmhhciffpklfoac	FALSE
hpglpmnkepchcmjbd	FALSE
hphcbelldahofedba	FALSE
iimkgdhbbpfkehndd	FALSE
iimlnipgmlbicgpba	FALSE
jcnlcbenpbfkogmac	FALSE
jcnnelnolpdpejkbb	FALSE
jnagpnpploplgfjac	FALSE
jnaplmomhikggaaan	FALSE
kjamdkofhboclppab	FALSE
kjbklgenahijnijac	FALSE
ldmpmhecjkchciiaa	FALSE
ldnbanhcdhldelpbd	FALSE
lpfbfmnhnkfndmcac	FALSE
lpfpcniooflmeedab	FALSE
mkkacgacmcplheabo	FALSE
mkkegjijgkijmbnbd	FALSE
nekoiacjhecbekmaa	FALSE
nelfmmbkijkpkpfbd	FALSE
nphabkhgjjfomgbgf	FALSE
nphokojpmnedglgac	FALSE
okopedpboanpfooaa	FALSE
okpfeijgbblhbmfad	FALSE
pemckfonibdhcllfp	FALSE
pemhhdnnmmjffhhac	FALSE
adadggjngjfmebimcd	TRUE
adadnhofpjoiiodckh	TRUE
amcbiilkihhpkkfeoo	TRUE
amceijpmdhhmolcmkm	TRUE
bhipgaiimjdplfahao	TRUE
bhjcfoemanbgfbjkgg	TRUE
bonoajfmooflpmjioa	TRUE
boogpljchmbehmdhho	TRUE
cjepemmgdlpnpncdfd	TRUE
cjgecfjcgiefpplall	TRUE
dcadbepibenjmhgkel	TRUE
dcaeidibgjiifoebod	TRUE
dmhiddblhnejondhla	TRUE
dmhnkegmkdkpcojekj	TRUE
efpamhafhkphpbelbn	TRUE
efpkkmnbipfajkccbp	TRUE
fadkdgjmieekmbgini	TRUE
fadmoceikdaffojkdc	TRUE
fjgchfaignfcckpejf	TRUE
fjggndckhnpafchfam	TRUE
gclbnkopgklonenjol	TRUE
gclcebiokhnlegahnh	TRUE
gllhanhanfpcmcailf	TRUE
glmmbgichglbkdpmpk	TRUE
hgcojphckamcaehmln	TRUE
hgfelfkcbifhogaidh	TRUE
ibiaihgjahomgcnced	TRUE
ibifmbjghlgfhpimbg	TRUE
illdcgbkogdblcnmga	TRUE
ilneedakjcelankdke	TRUE
jffbngalffjjmlilhn	TRUE
jfffchnjfhooikmcjc	TRUE
kalpkmmbkgagifkigo	TRUE
kamglifidcoaeaiafj	TRUE
kkppdiiocbfeceppee	TRUE
klaegoooagnlgjgode	TRUE
lejhebimaolaihbmpi	TRUE
lelallmafjjgladamp	TRUE
lpjdomhcgchgmahoea	TRUE
lpjoeelncelbnjpick	TRUE
mjiapohefieanddpfh	TRUE
mjikjnegeahlagjane	TRUE
nffapoogkejbipbgfe	TRUE
nfflppodbpdfbjdljj	TRUE
oagnjebodnmmcjlndm	TRUE
oaihgopfnghaekpcga	TRUE
okifcoiiafbfjdbomo	TRUE
okiidefhaggloplhbm	TRUE
pfjkknjgehnahmfofc	TRUE
pfjmaigkhiceonddfh	TRUE
aaakehlcbngfnkknoe	FALSE
aabnkdelgmcmfdgofk	FALSE
akbekcndgpakholdab	FALSE
akbihhkdbkfgiklebd	FALSE
bdpkepjemjmlcfcioj	FALSE
bebhpohnjblcfjobbj	FALSE
bpiafaobinbooinpac	FALSE
bpikkjgejibjdfllaa	FALSE
ckabepohhndfcdfkbk	FALSE
ckadbhdlppkkdpalaa	FALSE
dekclcnbfddojpnlbd	FALSE
delbghoeaajjgpoppg	FALSE
doffagjoeedojelpaa	FALSE
doffngcbopneoblpab	FALSE
eilfbbhbnjbnceibde	FALSE
eiljopabfchigcblpd	FALSE
fdbhjgmalddnmcjdab	FALSE
fdbnccpikijfpmgabn	FALSE
fmmnibilleligidoba	FALSE
fmnjiafefingjdmibb	FALSE
ghcpfidlapbahgfjfe	FALSE
ghdnhedoojmjhbneab	FALSE
hbhnbmmcmfgigmckba	FALSE
hbigcpgmeldcoklbai	FALSE
hkccljleaapheaejoe	FALSE
hkchfamaakdcmecjio	FALSE
idkbmmbmcepjekppac	FALSE
idmcmhcddkkmkbfdab	FALSE
ipapiboennbodnjmbd	FALSE
ipbdgimgkbajnglobk	FALSE
jiicbajjimdbebkoce	FALSE
jiihjlmedldaikcacc	FALSE
kcbobckleldabdjlno	FALSE
kcdklhoheajoipliaa	FALSE
kljokchlaplbpammac	FALSE
klkgidjjmmndiaajhp	FALSE
lgjdpejnkfkojhlfbb	FALSE
lgjiffakibjnaekbbf	FALSE
maoafplnifpimkgfaa	FALSE
maocabaddhjnpkijad	FALSE
mmcfhfhdeknkhkbbon	FALSE
mmckjlhappbbmaaejh	FALSE
nfcgicfacedephjdfh	FALSE
nfdkmhfeibdpddfgni	FALSE
obdpibmamdggjmmdgc	FALSE
obfededjkcfdpofgbb	FALSE
olidabkkolpndljjfd	FALSE
olidikkgacledoiaih	FALSE
pfibfbhbnpjkbncpac	FALSE
pfipjdjeijlpdbhkaa	FALSE
adddjpopejhcefmaomd	TRUE
addfanphppnjolbjalp	TRUE
alieeoddiemoccgdjgh	TRUE
alikogfhejmcpccgopi	TRUE
bgdgglmlfhejcinfpnk	TRUE
bgephbppljcnkipdfdh	TRUE
bplbfindjnhcdgcbien	TRUE
bplphpngdmmdapdmojh	TRUE
ckedjhpjelmekdmfbfl	TRUE
ckfoaemcpmffcjboinn	TRUE
degfemkoaekmpeilhco	TRUE
dehliedgbhiopnhgmjp	TRUE
dnobcjpcobphgpcmpdi	TRUE
dnpnjblgekgfbpfnhhf	TRUE
eilhhibfgpmfaplaodj	TRUE
eilnoifonihjggnbmjd	TRUE
fcphkjelfkkfgdfmnda	TRUE
fdapdglahgejgjanfal	TRUE
fndebojkejjbhjmobpj	TRUE
fndgdcpoliocnmlppbc	TRUE
ghaicgdeijlkkhhcppi	TRUE
ghblldfbocmlggofpdd	TRUE
hbcogbfdfclgnjapocn	TRUE
hbefgfdekhmoegchhkk	TRUE
hjonlekahelkakfjpnl	TRUE
hjpapahgehodgimccbc	TRUE
idpllfeeefnnkmbjbjl	TRUE
ieaeoennbgnjmjkdgim	TRUE
iodagigepebjomjhjof	TRUE
iodcjnofjlclfddempk	TRUE
jiclgfiggagnfmpobjj	TRUE
jidlihgkknpaonndghe	TRUE
kcgadiiddfdhnanhdjk	TRUE
kchhcfegelllpmfcgdc	TRUE
kloobkhblaemkhgldgn	TRUE
kloocffmgccepgmkaoc	TRUE
lgmgkhlmeajljdmigdd	TRUE
lgnjlpbpnmlgbkgfhkg	TRUE
mankijfkkdbokaobnpk	TRUE
maobpkmejcigkafbcjf	TRUE
mlgnepjlgbkgaffkcji	TRUE
mlhcilhcmileclcaknk	TRUE
nfogljlghiikmhkodnd	TRUE
nfomhmdigjchgfamfha	TRUE
obgpnakbefgdaogeclh	TRUE
obhehnapgnghjobhbnm	TRUE
oligpapcjhmlfiniadl	TRUE
oljinimlnfmmmpelbge	TRUE
phgkahlhomcaiifdedk	TRUE
phglgblkfliajjcjfpk	TRUE
aaageldgdhnbalnibkc	FALSE
aaapbfpgggcbejfpeep	FALSE
akakanljlagdfknpibb	FALSE
akdnaobjhifopbehlac	FALSE
bcppnemilmmcncckibb	FALSE
bdbcdidogcbpbdimppl	FALSE
bndgohmiglplgnlmoba	FALSE
bnecdeipgjbknjlocab	FALSE
choogicamfmogpihjaa	FALSE
chpbaallpnmdlmbefch	FALSE
dbhckjlcaijjklogbbf	FALSE
dbikkehejemnnemffac	FALSE
dlhcapjdilkemiejdbd	FALSE
dlhmjmpmleggncjpcba	FALSE
egjhkfjlgedjdofjgbd	FALSE
egkkododfenhkpdnnab	FALSE
fajkblpdibjimhghkac	FALSE
fajkgdjbigdniikedac	FALSE
fjimlmehnfjcipgfhba	FALSE
fjjbkeckgocjlaefoba	FALSE
gfbalpcdpnnpbdlepce	FALSE
gfbfhngodnjnpmclmab	FALSE
gpbkabkpkglagdhomif	FALSE
gpbofegjifplpadnkbb	FALSE
hjhjpidkeoiahehjnba	FALSE
hjhonlmofiiidnoflba	FALSE
idgpopadimmcmopfebd	FALSE
idhajjelabiappoenel	FALSE
ingngbndicngfljdkba	FALSE
inhbaheogjhffojmjhi	FALSE
jiijjighdpmoaeelace	FALSE
jiinpekiclndiaiikbb	FALSE
kcceikiepedfplofeba	FALSE
kcdbkjmgklkcjmknfaa	FALSE
kmneolpghoojmeeliaa	FALSE
kmnnmbhdaopbmcpcgba	FALSE
lihjeoaeimjiileciac	FALSE
liigadoffmomdhbdafp	FALSE
mcamgijjffflhblejba	FALSE
mcbphpllaomfecghaco	FALSE
mndbcpcljbkbgaiahac	FALSE
mndlobiicpcmpchopba	FALSE
ngnamedfcohcmmkcgac	FALSE
ngoianlkibbcilpdmnl	FALSE
npkfcjohcddddghanbb	FALSE
npmhdjlflejfcakpdab	FALSE
okephjhliapdppialac	FALSE
okfecdchcgfbigihmbd	FALSE
pelapemihnibibeeabo	FALSE
pelbpehfbjbojbbpjkc	FALSE
