aaabmnmnji	TRUE
aaaofhjhnd	TRUE
ajcpoejnce	TRUE
ajdlkjceha	TRUE
bdhbgokhfj	TRUE
bdhmeohlbb	TRUE
bobfmpmjjl	TRUE
boblbhcjbn	TRUE
chmjdhipfa	TRUE
chpgcaelie	TRUE
dcdlcooibi	TRUE
dcfgeplogh	TRUE
dlljlainpk	TRUE
dlmnicdodp	TRUE
egdgpihebk	TRUE
egfehjaedh	TRUE
fbkhiignbo	TRUE
fbnjgoemjf	TRUE
fnbpekmfng	TRUE
fncfalphil	TRUE
ggpmknbhlj	TRUE
ghahdighfo	TRUE
hchjmjgfld	TRUE
hciafkcjhi	TRUE
hmembpkjcb	TRUE
hmfapbbgne	TRUE
ihfdcmppea	TRUE
ihflaehogi	TRUE
jbcaodlloc	TRUE
jbclpapbgm	TRUE
jlblnllfji	TRUE
jlchoimnob	TRUE
kdhffpidih	TRUE
kdhpddfbco	TRUE
kobekkegnf	TRUE
kocliammmm	TRUE
lhpjhbeebl	TRUE
liadlfmpcc	TRUE
mcgeemcaga	TRUE
mcglhbiffi	TRUE
mnbjdckhmg	TRUE
mndbhhllkd	TRUE
nhghaeagha	TRUE
nhlcceokkf	TRUE
obmaebabpn	TRUE
obmfdpiojo	TRUE
omadhmipel	TRUE
ombbhnnmjh	TRUE
pgkijjojjm	TRUE
pgkplpfdbc	TRUE
aaabniaaaa	FALSE
aaaeicaaaa	FALSE
aldmffaaaa	FALSE
aledbiaaaa	FALSE
bepdenaaaa	FALSE
bfaihnaaaa	FALSE
bobldaaaac	FALSE
boddpdaaaa	FALSE
chgllmaaaa	FALSE
chimoaaaam	FALSE
dciddoaaaa	FALSE
dcjcicaaaa	FALSE
dofjfdaaaa	FALSE
doicdeaaaa	FALSE
ejehbjaaaa	FALSE
ejfgogaaaa	FALSE
fcpndjaaaa	FALSE
fcpopaaaaj	FALSE
fmcpmdaaaa	FALSE
fmcponaaaa	FALSE
ggcdioaaaa	FALSE
ggclbdaaaa	FALSE
habcddaaaa	FALSE
hacaofaaaa	FALSE
hjjhliaaaa	FALSE
hjjnolaaaa	FALSE
idgpcpaaaa	FALSE
idhgniaaaa	FALSE
iminmnaaaa	FALSE
imjkfbaaaa	FALSE
jhgobjaaaa	FALSE
jhhikdaaaa	FALSE
kbnlffaaaa	FALSE
kbnnapaaaa	FALSE
kloebaaaao	FALSE
klomoiaaaa	FALSE
lffamkaaaa	FALSE
lfkclhaaaa	FALSE
mancjeaaaa	FALSE
manmbnaaaa	FALSE
mmaoipaaaa	FALSE
mmcgmgaaaa	FALSE
nfnpbjaaaa	FALSE
nfoicnaaaa	FALSE
oajfagaaaa	FALSE
oalfkhaaaa	FALSE
okpaclaaaa	FALSE
okpedmaaaa	FALSE
pfdmgoaaaa	FALSE
pfegcgaaaa	FALSE
aaacniicieo	TRUE
aaafkmlkakf	TRUE
alfnndklinp	TRUE
alfomaedoem	TRUE
bebdnpbmmei	TRUE
becjgeihkfe	TRUE
bogffhpooem	TRUE
boggpjfchbm	TRUE
cilmegoklne	TRUE
cilogaheole	TRUE
dcnbajfgfpe	TRUE
dcnjdjgkngj	TRUE
dodmefbjkki	TRUE
doelbgcodlc	TRUE
eiledemdbfi	TRUE
eilhldmejic	TRUE
fciiijgjoph	TRUE
fckbdfpfebk	TRUE
fmdinfgpicm	TRUE
fmdmhfaoedm	TRUE
ggbaogelbpj	TRUE
ggbcfcklfmo	TRUE
haacagehdoi	TRUE
haaonbcibja	TRUE
hkahnahgmgg	TRUE
hkainlmfaol	TRUE
iceeionjpgm	TRUE
icfihhhdmbp	TRUE
inepjflnabf	TRUE
ingobblackp	TRUE
jgnlcckkpln	TRUE
jgplkejopan	TRUE
kcalmnkcncj	TRUE
kcbcdpmnghk	TRUE
kmbchllifnd	TRUE
kmcckdogcaa	TRUE
lgldjbmpfcp	TRUE
lglophehjfd	TRUE
maihmfgblgj	TRUE
majmpippbnl	TRUE
mmebepdbggn	TRUE
mmfjlenclpo	TRUE
ngjmkcekmfh	TRUE
ngkjhammlma	TRUE
obcbagfefmb	TRUE
obcigcelnlp	TRUE
okmakahlmpe	TRUE
okmjpfgkejc	TRUE
pelbjdidibp	TRUE
pembdpomdjd	TRUE
aaamiedaaaa	FALSE
aaccbddaaaa	FALSE
alipgjmaaaa	FALSE
aljgammaaaa	FALSE
bglpngbaaaa	FALSE
bgmcbocaaaa	FALSE
cbmjojoaaaa	FALSE
cbnnmddaaaa	FALSE
clilljmaaaa	FALSE
cllhbfhaaaa	FALSE
dfloaklaaaa	FALSE
dfnlbflaaaa	FALSE
dppgobiaaaa	FALSE
eabgnknaaaa	FALSE
ekemileaaaa	FALSE
ekeolkhaaaa	FALSE
febhmoiaaaa	FALSE
feejmhfaaaa	FALSE
fphndjjaaaa	FALSE
fpijoabaaaa	FALSE
gipbiimaaaa	FALSE
gipimceaaaa	FALSE
hcnbalfaaaa	FALSE
hcnkboaaaam	FALSE
hmdgmmiaaaa	FALSE
hmeffhaaaaf	FALSE
igfcdpkaaaa	FALSE
igfifbcaaaa	FALSE
iplcdmpaaaa	FALSE
iplcnnjaaaa	FALSE
jibnhniaaaa	FALSE
jidmdacaaaa	FALSE
kcpenhpaaaa	FALSE
kcpjkblaaaa	FALSE
kmodmpiaaaa	FALSE
kmogdneaaaa	FALSE
lhofindaaaa	FALSE
lhojiclaaaa	FALSE
mcdibpoaaaa	FALSE
mceceofaaaa	FALSE
mngjkabaaaa	FALSE
mnienegaaaa	FALSE
ngjdjkjaaaa	FALSE
ngjkkihaaaa	FALSE
obkehfmaaaa	FALSE
obkjonnaaaa	FALSE
olgdghnaaaa	FALSE
olgpgkcaaaa	FALSE
pfimamaaaai	FALSE
pfminjbaaaa	FALSE
aaaniedcjbdd	TRUE
aacaohcmoham	TRUE
alihajadncjd	TRUE
aljekicfpmca	TRUE
bgaklafomlbp	TRUE
bgceoikamclm	TRUE
cbjapahpkbbf	TRUE
cbjmhallamom	TRUE
clbhlfijliih	TRUE
clcfmpnmibdj	TRUE
dfefpfjpfpgd	TRUE
dffbmfpbkhng	TRUE
dppfknnnkpim	TRUE
eaabbaioaghn	TRUE
ejfibokncnpg	TRUE
ejgmaebphpef	TRUE
femlliglfcon	TRUE
fenhlojiogml	TRUE
fphnnkgdnoii	TRUE
fpiebgkaiccf	TRUE
gjbcgpoeedac	TRUE
gjdaccacceda	TRUE
hcigakfmipoc	TRUE
hcjmdhkgopjn	TRUE
hmgdkeeojmpl	TRUE
hmhgfahacdij	TRUE
igdildcaoiea	TRUE
igdiljakgjja	TRUE
ipecljpghaom	TRUE
ipfcadoillkd	TRUE
jjedbnbbaeng	TRUE
jjenodfohoji	TRUE
kcebhfbcnbpg	TRUE
kcedfaajknpp	TRUE
kmgngclcobob	TRUE
kmheibifhhpn	TRUE
lgnhgbggamlg	TRUE
lgpahhecchcp	TRUE
mbifncodhpob	TRUE
mbiloclbmaoa	TRUE
mmihnmhhbcin	TRUE
mmimjhkjkjnn	TRUE
nhebmimddmae	TRUE
nheljbkggggp	TRUE
obgkehdmcibf	TRUE
obgnmafoglgn	TRUE
omfaklenemeg	TRUE
omffpbdgibog	TRUE
pfeibfagbijf	TRUE
pfgoohfockbn	TRUE
aaamiedcaaaa	FALSE
aacbddacaaaa	FALSE
algaeaogaaaa	FALSE
algddnimaaaa	FALSE
bgdeifodaaaa	FALSE
bggcjfkhaaaa	FALSE
cbljejnbaaaa	FALSE
cbloajocaaaa	FALSE
clofaepkaaaa	FALSE
clojddliaaaa	FALSE
dfochgigaaaa	FALSE
dfpdlhneaaaa	FALSE
dppgalmiaaaa	FALSE
eacflekmaaaa	FALSE
ekkikdobaaaa	FALSE
ekldkaepaaaa	FALSE
feljkndnaaaa	FALSE
felkpcplaaaa	FALSE
fpdcmnakaaaa	FALSE
fpejgejnaaaa	FALSE
gihhdanaaaan	FALSE
gijljjfgaaaa	FALSE
hcngnhhdaaaa	FALSE
hcnhpmedaaaa	FALSE
hmhndiepaaaa	FALSE
hmhpjpgbaaaa	FALSE
igggkfmfaaaa	FALSE
iggidnbfaaaa	FALSE
iphmannnaaaa	FALSE
ipikgdnoaaaa	FALSE
jimladomaaaa	FALSE
jinlpijiaaaa	FALSE
kcejhkmoaaaa	FALSE
kcgnleabaaaa	FALSE
knbacnceaaaa	FALSE
knbfjggiaaaa	FALSE
lifhmdpjaaaa	FALSE
lihanakiaaaa	FALSE
mcehbbcpaaaa	FALSE
mceobgeiaaaa	FALSE
mmfoebjkaaaa	FALSE
mmgdpfdoaaaa	FALSE
ngnjnfllaaaa	FALSE
ngoblkbgaaaa	FALSE
obhikfboaaaa	FALSE
objcjlmdaaaa	FALSE
omfbnbfdaaaa	FALSE
omfklnooaaaa	FALSE
pfnephmeaaaa	FALSE
pfnmeekiaaaa	FALSE
aaaofehipjkon	TRUE
aaclneipopnpg	TRUE
akglmhohcihnm	TRUE
akhalmhhannbm	TRUE
bekmnocjgjpmo	TRUE
belfieaaipikp	TRUE
bpjnebkjfpmel	TRUE
bpjonlgebbiod	TRUE
ckicnklmficmm	TRUE
ckkeagplhhkoe	TRUE
dfbcbelgkjfdh	TRUE
dfccjbachhfil	TRUE
eaaanhpmjfoip	TRUE
eaaanmhnlohia	TRUE
ejeeaabnealmm	TRUE
ejghmilmkpifh	TRUE
fdoipjedgmnkd	TRUE
fdpmpgabobken	TRUE
fnppoalkecnmi	TRUE
foaebbbekmgif	TRUE
gjageljpfbboj	TRUE
gjbmihpglbbok	TRUE
hdmccapcojaoj	TRUE
hdplhmkpjnhpg	TRUE
hnelkoedfnhbf	TRUE
hnfknocejgaee	TRUE
ihbaiefdodnbg	TRUE
ihblkgklifgan	TRUE
janpijcafjlec	TRUE
jaodpmdklnohp	TRUE
jkokcngicjcmc	TRUE
jkpenahfppibp	TRUE
keolafgnlbmfj	TRUE
kepaadeddogmn	TRUE
kphnfifpampjh	TRUE
kpjhpkiomgiam	TRUE
ljmhhikdjenie	TRUE
ljngkbfmbckpp	TRUE
meafieiiapghd	TRUE
medaflkjcmgmn	TRUE
mnfagfimcipcp	TRUE
mnfmfhjmhgpoi	TRUE
nhggeihjdpcjl	TRUE
nhgikepjaidnj	TRUE
oapmmikcbljgh	TRUE
obcdnoaldeebc	TRUE
olgfljgghdmpb	TRUE
olhppcpjamdlp	TRUE
pfenonboicmbp	TRUE
pfimlcmiinfbf	TRUE
aaapnfehiaaaa	FALSE
aacpjkonlaaaa	FALSE
akefjckplaaaa	FALSE
akemiliijaaaa	FALSE
bfbdiklalaaaa	FALSE
bfcnbnofbaaaa	FALSE
bpjholicnaaaa	FALSE
bpjphbpkjaaaa	FALSE
clcbnmegcaaaa	FALSE
clclbebbpaaaa	FALSE
dfceeambeaaaa	FALSE
dffjeijagaaaa	FALSE
eaaohbndmaaaa	FALSE
eabahblbfaaaa	FALSE
ejijlmineaaaa	FALSE
ejjahjbpcaaaa	FALSE
fdkmdkdocaaaa	FALSE
fdlclmgdmaaaa	FALSE
foadfphfmaaaa	FALSE
foahapdllaaaa	FALSE
gieodheheaaaa	FALSE
gigbdmbdcaaaa	FALSE
hdakjfihhaaaa	FALSE
hdbboiibfaaaa	FALSE
hmobpjedgaaaa	FALSE
hmpmnkdmpaaaa	FALSE
igpkckhhbaaaa	FALSE
igplkfoocaaaa	FALSE
jamnldhlhaaaa	FALSE
jaoclmlopaaaa	FALSE
jldbcjkbeaaaa	FALSE
jldcgjlgjaaaa	FALSE
kfpdahhgkaaaa	FALSE
kfpiigmamaaaa	FALSE
kpkajlmekaaaa	FALSE
kpkjcglcmaaaa	FALSE
ljalhmimkaaaa	FALSE
ljalnnjmhaaaa	FALSE
mdkklkaffaaaa	FALSE
mdknhfebpaaaa	FALSE
mmpncifngaaaa	FALSE
mnacjclbfaaaa	FALSE
ngekgiiaeaaaa	FALSE
nghikkefcaaaa	FALSE
obgecllbcaaaa	FALSE
obhpieodlaaaa	FALSE
olnjgopemaaaa	FALSE
olnmjkbplaaaa	FALSE
pfahgbbecaaaa	FALSE
pfajlfdboaaaa	FALSE
aaachfabdjffme	TRUE
aaadmlgipednjf	TRUE
alhiedafbhfmhg	TRUE
alhlnckomidoph	TRUE
bfgfnhakcjnigl	TRUE
bfhckbdpggklcn	TRUE
caafjodcgpmlja	TRUE
caaiafmmfebelk	TRUE
ckdfccpbkcdddk	TRUE
ckeefjohodbdda	TRUE
dddojkjchifjea	TRUE
ddegihghichoke	TRUE
dnhopnnpdckhhe	TRUE
dniccegdjcddfb	TRUE
egnkknkcglbong	TRUE
egobacbbgbdpka	TRUE
fbdlnappbbddkj	TRUE
fbdpfckmocflhh	TRUE
fldhigdmpjnfid	TRUE
fldodlpliegnem	TRUE
ggaceammpnheof	TRUE
ggafnccohfaoif	TRUE
gpkeldedmfjgap	TRUE
gpkopoibedgbil	TRUE
hjhgnhmanbcfha	TRUE
hjhhgjcbhfngmh	TRUE
iecgcjeamemckl	TRUE
iecpbhmapkpphb	TRUE
ioolaebhoipijo	TRUE
ipahfcbccigeac	TRUE
jiocedbhplmpbh	TRUE
jjanepgmenhnjd	TRUE
kdhcpomkeaoiaa	TRUE
kdhlobebbikekc	TRUE
knkaegkciphpgc	TRUE
knlbkhmoleajln	TRUE
lhlnbpkdpjjkea	TRUE
lhmmfncfejfccc	TRUE
mcgopbbjhjeocc	TRUE
mchjdihoflgbdn	TRUE
mnenlidbkfjbeo	TRUE
mnfoinhkgnopif	TRUE
nhedlbcanppdcp	TRUE
nheifamdljlmpl	TRUE
ocbbooikolodio	TRUE
ocbfmkdjciamln	TRUE
olkbipfdcjjhae	TRUE
olkhkfmhfdonkl	TRUE
pfkbhcgeihfmfn	TRUE
pfkiflipgmmlmj	TRUE
aaabhfabdjaaaa	FALSE
aaacffmemlaaaa	FALSE
alhknkjlooaaaa	FALSE
alioppcpboaaaa	FALSE
bfngabijecaaaa	FALSE
bfpleilnkcaaaa	FALSE
caaiedjoaeaaaa	FALSE
cabhkacgbdaaaa	FALSE
cjnnmodnniaaaa	FALSE
cjnohjablbaaaa	FALSE
ddijlplnalaaaa	FALSE
ddjnojgiaaaacc	FALSE
dnkfjkajmpaaaa	FALSE
dnkkeodfcfaaaa	FALSE
ehlnnmjaopaaaa	FALSE
ehmeffaoclaaaa	FALSE
fbdogkfceiaaaa	FALSE
fbgcmgohgaaaaa	FALSE
fllaoeddbpaaaa	FALSE
flllokkdfgaaaa	FALSE
gfoanldaoaaaad	FALSE
gfokgdbmbdaaaa	FALSE
gpjbcdiajfaaaa	FALSE
gpmjijpgokaaaa	FALSE
hjadfddmplaaaa	FALSE
hjdfanihklaaaa	FALSE
iejimnmijkaaaa	FALSE
iejpionpdfaaaa	FALSE
ioppmdgdofaaaa	FALSE
ipanfbipfaaaac	FALSE
jjhadcgciaaaao	FALSE
jjjjceifdnaaaa	FALSE
keknbohdneaaaa	FALSE
kelohijpccaaaa	FALSE
koagomcigpaaaa	FALSE
kocgpeifbfaaaa	FALSE
lhodgfnpmmaaaa	FALSE
lhofaajabpaaaa	FALSE
mcpeccfhkjaaaa	FALSE
mcpgjlifffaaaa	FALSE
mncemkopenaaaa	FALSE
mndabldmfgaaaa	FALSE
nhijobknfgaaaa	FALSE
nhipleojgkaaaa	FALSE
obkfoeppgiaaaa	FALSE
obkhnpfofaaaao	FALSE
olegljdhfiaaaa	FALSE
olggcefgodaaaa	FALSE
pejcbahlenaaaa	FALSE
peklmhjpdkaaaa	FALSE
aaaebbhpealkkgf	TRUE
aaaepjahinkjkfj	TRUE
akpfajllnhpeagn	TRUE
akpnpdpahkmmefg	TRUE
bfabeclanopkngn	TRUE
bfaepenkgplaaec	TRUE
bpefmhlbgdpnecj	TRUE
bpgdfgknoomhjag	TRUE
cjijhlgkgcepgbc	TRUE
cjkagjhhjlekiif	TRUE
decbhifganhlici	TRUE
decbkpbebkgijjj	TRUE
dpcjcciaojmbefh	TRUE
dpdonagdemdjbmh	TRUE
ejpihnjcplbdhgg	TRUE
ekbponjmppafaee	TRUE
fdlnefhipfehddb	TRUE
fdnfoeapbcpmcgb	TRUE
foknpalagkchhpo	TRUE
fomienmkomjjlhe	TRUE
giopmhbgfhannco	TRUE
gipndppicbapmfi	TRUE
hdnldeofehkpfkf	TRUE
hdnmmggijcmgiae	TRUE
hnoigadmgieaoig	TRUE
hnopmppefhlnefd	TRUE
ijdcgamoobnghbm	TRUE
ijdljibpbdokebk	TRUE
jdaklbikmddjlke	TRUE
jdbbfnmiolaoecm	TRUE
jmlmkcnoddinahe	TRUE
jmmaiiclanhpjmi	TRUE
kgcgbmjndpnglio	TRUE
kgdbcgmhmlakljd	TRUE
kplefphfhjifndf	TRUE
kpljciehpjecbac	TRUE
lkmkaonglmepnke	TRUE
lkngfeldkmacmlj	TRUE
mfalpoploiadbef	TRUE
mfapcbmojoecian	TRUE
mpgfkhcgnlepcmi	TRUE
mphidlpkbocfmel	TRUE
niaglchiinjaemj	TRUE
nibflnfbhoifinp	TRUE
ocebffipneofbik	TRUE
ocgemedipiefgfc	TRUE
ollomibnbhjamoj	TRUE
olmejmaiaohkhaa	TRUE
pfoejgnehbnamcn	TRUE
pfpfaehgcmhjaln	TRUE
aaadbbhpealaaaa	FALSE
aaadpkkgfjaaaah	FALSE
akkcpghfagmaaaa	FALSE
akmhccijkebaaaa	FALSE
bfpnhganmnaaaam	FALSE
bfppbgaieihaaaa	FALSE
bpgfkpbogpkaaaa	FALSE
bpglblkjdhhaaaa	FALSE
cjcadgocdbhaaaa	FALSE
cjcaphfongkaaaa	FALSE
deaiaagmhgoaaaa	FALSE
dealbdpepffaaaa	FALSE
dpckoohckefaaaa	FALSE
dpcnmffooabaaaa	FALSE
eikogiamjghaaaa	FALSE
eileigdjbabaaaa	FALSE
fegjbaonlojaaaa	FALSE
fehdniepopjaaaa	FALSE
fpendecemndaaaa	FALSE
fpfmoholehnaaaa	FALSE
gjjhobnpnbkaaaa	FALSE
gjlhfbelojpaaaa	FALSE
hdihflknjebaaaa	FALSE
hdijbjgccfcaaaa	FALSE
hoaofidaojkaaaa	FALSE
hobfdmoemifaaaa	FALSE
iijfllgjdjmaaaa	FALSE
iijlgcphgknaaaa	FALSE
jcmlhgoedaaaacd	FALSE
jcmnjdlafbdaaaa	FALSE
jmfebimbbanaaaa	FALSE
jmfgfkikoadaaaa	FALSE
kgihgbbhcifaaaa	FALSE
kgjnmjchangaaaa	FALSE
kpmbdpenjafaaaa	FALSE
kpmggjcbpkgaaaa	FALSE
lkojeomefgoaaaa	FALSE
llakhbpliegaaaa	FALSE
mfndlpbdjaiaaaa	FALSE
mfobfnkmbpnaaaa	FALSE
mpiplaaenodaaaa	FALSE
mpkgijpfelcaaaa	FALSE
nkflkjlkdfdaaaa	FALSE
nkganoapghiaaaa	FALSE
ocpnnlpddfdaaaa	FALSE
odbeekolndaaaal	FALSE
ollnhcadjmbaaaa	FALSE
olmmjeecngcaaaa	FALSE
pfjmcfekdmiaaaa	FALSE
pfkalhiodckaaaa	FALSE
aaagmnecekbbnjcd	TRUE
aacjobijppihpamp	TRUE
ajnffppgggicicip	TRUE
ajonnaagnmicdled	TRUE
beihoocafgiondfe	TRUE
bejdphdhplebkhlb	TRUE
boogpeehgelhdcnk	TRUE
bpagjpnmcgpoekkh	TRUE
ckoehkepongikkce	TRUE
ckpgdhojacnhbkmp	TRUE
dffppcanlflnhebe	TRUE
dfhdbmhpoaamombc	TRUE
dpgdhkjidhbnphlb	TRUE
dpgjihpbgfaddhfl	TRUE
ejojiiijhobcmkfb	TRUE
ekaadkadgbkgdpig	TRUE
ffaiknocnaholoph	TRUE
ffbpdljmlieebnnj	TRUE
fopbaflbmlldfoce	TRUE
fopimbkmbobdhbee	TRUE
gjfljhaeapfebhhf	TRUE
gjfmejdlglaialci	TRUE
heedegfdfkiekphi	TRUE
hegoiijnbliapgoc	TRUE
hnnhjilaeomemmii	TRUE
hnpepgalpgkgcmml	TRUE
ihpghgmcfohghblj	TRUE
ihpjibkfdpieeekp	TRUE
jdejhiljjeajaabo	TRUE
jdenapdcmdihcced	TRUE
jmlnonicpnhkmmjk	TRUE
jmmjlaenpnnlfcdp	TRUE
kgfpnpmljdaobjch	TRUE
kggodpclfngomkml	TRUE
lacocleejjfaagca	TRUE
laffgijhchdgjcbn	TRUE
ljnecfgmlolmngmc	TRUE
ljocfllnmeebdhkn	TRUE
mddmfbkfkdgkdnki	TRUE
mdeblmdkopocddcc	TRUE
mnjnajkbhdaaokpg	TRUE
mnmdonaggimiigpg	TRUE
niejocgahhfanhjg	TRUE
nielegoghiaikjbf	TRUE
ocmobcdohafpphme	TRUE
ocmolmpphbnbfpbc	TRUE
onacapdijehmenjf	TRUE
onapfdopcoiofjhc	TRUE
pgckgbblmhaihpfb	TRUE
pgcoaoepfnapcloe	TRUE
aacnginhbbbfaaaa	FALSE
aaddagkpipgdaaaa	FALSE
akhffjlnphfgaaaa	FALSE
akibfaoijdlcaaaa	FALSE
bedldngjbcemaaaa	FALSE
bedljgigffknaaaa	FALSE
bngiefdceodkaaaa	FALSE
bngnlncpepfcaaaa	FALSE
chncfccehlhnaaaa	FALSE
chojabhickljaaaa	FALSE
dddmbcngajfkaaaa	FALSE
ddeiddjcnakjaaaa	FALSE
dogacalkckeoaaaa	FALSE
dogmeelfmbfbaaaa	FALSE
eincgmfhokpdaaaa	FALSE
eipnmaohmighaaaa	FALSE
fdgecbknchjmaaaa	FALSE
fdgfeoambpjhaaaa	FALSE
fokgljgenfdlaaaa	FALSE
foladcdhilaaaakf	FALSE
gipejkdjkchjaaaa	FALSE
gipmmdlfhhkjaaaa	FALSE
hdblaalpofeeaaaa	FALSE
hdcpbjagpmimaaaa	FALSE
hnmhkgdlmecjaaaa	FALSE
hnmnfmhodhhhaaaa	FALSE
iiaajegmbfbmaaaa	FALSE
iiaocoaenpeaaaac	FALSE
jbeieanojpmlaaaa	FALSE
jbfgmmkllbegaaaa	FALSE
jlbigbjmampmaaaa	FALSE
jlchilfnnkjaaaan	FALSE
keokephhjjoaaaab	FALSE
keppcfdebgnjaaaa	FALSE
kohajpfjkdooaaaa	FALSE
kohcddodpbciaaaa	FALSE
limfbclbdpaeaaaa	FALSE
liokdbejfdkoaaaa	FALSE
mcoepheeedmnaaaa	FALSE
mcojjjhjcoddaaaa	FALSE
mmmamagjcmcbaaaa	FALSE
mmnimeokpofbaaaa	FALSE
nhofgacneajfaaaa	FALSE
niaahibcmbcfaaaa	FALSE
ocefnibpnbeeaaaa	FALSE
ocenodlhcnhcaaaa	FALSE
omaahcehojfjaaaa	FALSE
omajclbcpbdcaaaa	FALSE
pfkmhedeccjjaaaa	FALSE
pfmfpkiiiodgaaaa	FALSE
aacnginhbbbfdmagk	TRUE
aadipgdakjjlagnhj	TRUE
akflbeiepjpeolfaa	TRUE
akgahiefkpeidlbdb	TRUE
bekddgjbflokidkbd	TRUE
bekepgpjgbdmleale	TRUE
bobdcokomkobbfadm	TRUE
bobkeldaihendkgka	TRUE
cifmhahjhfjalkkjn	TRUE
cigcjaaghlphnffol	TRUE
dcpeieabbjgpmjcma	TRUE
dcphfjcnpegmoeggf	TRUE
dnlpfcecommckpnhi	TRUE
dnlpjieigdmeneieg	TRUE
eieenofpffckkjifd	TRUE
eiejckjefcemjeiff	TRUE
febdkmeajejeaohoe	TRUE
fecanoldimgnhddjj	TRUE
fooaaenpcbjenpbom	TRUE
fopfjdpdmjbgnjlke	TRUE
gioebghkfgnjplidf	TRUE
gipbpjcpnjjiadkbi	TRUE
hddpofpamnpolaamj	TRUE
hdebllgogmacljndk	TRUE
hnilaokkmbapdldgn	TRUE
hninfjdigcpednnmb	TRUE
ihbonaopbjmgaghil	TRUE
ihcfcjnobpppjnfld	TRUE
japopngjaljhonkmh	TRUE
jbdamhajfmjfppifc	TRUE
jllmpnihghjcchlhb	TRUE
jlmbnkgepagniingm	TRUE
kekkildifhgpipoib	TRUE
keloecagbifhppbed	TRUE
kohngmfkbgnafimgl	TRUE
koiaeaiplefefnhpp	TRUE
ljlphiopmjlejnfea	TRUE
ljmggaapibnojhibe	TRUE
mdgafcnpbnikacila	TRUE
mdgeapneeggnhmccb	TRUE
mndjlofllppaiholn	TRUE
mneagbcmgmblhccjn	TRUE
nhkkkmmehpccaebgf	TRUE
nhkpnjbhdcfjailmg	TRUE
ocgiejjficceaibco	TRUE
ocgknndfipklnignl	TRUE
ondplhafjgcpgcemg	TRUE
onehdpocfjboipnbc	TRUE
pfkeaplgelmcobgip	TRUE
pfppbljpfgimielhf	TRUE
aabccmaojdajnaaaa	FALSE
aabnceomeebniaaaa	FALSE
akgckhnfegdgdaaaa	FALSE
akihbhofofdbaaaac	FALSE
bfjelbdghhngeaaaa	FALSE
bfjggkknfnifnaaaa	FALSE
bpgjhcgbcihloaaaa	FALSE
bphpgocoadnkhaaaa	FALSE
ckbpdpmkbflihaaaa	FALSE
ckcdcihaojoahaaaa	FALSE
ddpgfhilceocdaaaa	FALSE
ddpnldcffjcpeaaaa	FALSE
dojkpbnjgiabdaaaa	FALSE
dojoofljhigafaaaa	FALSE
ejdeihmoohcidaaaa	FALSE
ejeceghihcmgnaaaa	FALSE
fdooigjegljgdaaaa	FALSE
fdpfgkdgkfgjjaaaa	FALSE
fodajopcbgeagaaaa	FALSE
fodhcibpnppcoaaaa	FALSE
giabldkdfejjpaaaa	FALSE
giagilkacgbhjaaaa	FALSE
hdebahodpfpkdaaaa	FALSE
hdedjpamcmfmdaaaa	FALSE
hnhboghhnhhnkaaaa	FALSE
hnieakbdkhlomaaaa	FALSE
ifpmkoinpanjhaaaa	FALSE
igceocngmmcljaaaa	FALSE
jacjdpfmapbdmaaaa	FALSE
jaebjbafofedoaaaa	FALSE
jlbggdiejkoehaaaa	FALSE
jlbjgaaocnenlaaaa	FALSE
kepbdnodkkogiaaaa	FALSE
kfcglefeiekaaaaha	FALSE
knkiffeplmecaaaao	FALSE
knmeajdignjnaaaaf	FALSE
liijgnmiifakjaaaa	FALSE
liimcicmfhpepaaaa	FALSE
mbenghellmoefaaaa	FALSE
mbfhejfgagiolaaaa	FALSE
mlamkibddihokaaaa	FALSE
mlbecfnlnnoamaaaa	FALSE
nfbndkcjcgobkaaaa	FALSE
nfcahfdcadikhaaaa	FALSE
npnjhpmooggciaaaa	FALSE
npnmfjclogaooaaaa	FALSE
okclmecmnaehaaaad	FALSE
okdadmhjlijbfaaaa	FALSE
pfnifhliidgobaaaa	FALSE
pfnjjmlblkmknaaaa	FALSE
aaaekneggmneplfodc	TRUE
aabjdpjaodflgocnoe	TRUE
akahnakmmjgeomejlj	TRUE
akamgaalbogigfmghf	TRUE
beemmehljhclekpfif	TRUE
befckollgdbbnffhhb	TRUE
boijfeacgnikbefpcd	TRUE
bojbkebblfebibnmkm	TRUE
cjbfhbamangobhjnbc	TRUE
cjbmnblkpjjoclgebe	TRUE
ddogflgmdodnbookic	TRUE
deacfabnclgnjmgjbf	TRUE
dnnipcfacmohicanjo	TRUE
dnnknnbepnbncgipec	TRUE
eijcaealccfpmjfnak	TRUE
eijkbbgbfmmlipkfae	TRUE
fdjidnmgfjhlfeeojd	TRUE
fdkejilbnopcacahpi	TRUE
fmlnmcljlgaingjpkg	TRUE
fmmmkflghpealjkdgf	TRUE
ggbdlnjceihcidkmgc	TRUE
ggdeielhkoplfhkeid	TRUE
hbbhdknblceeepebie	TRUE
hbbpbkeoofbakdlhhb	TRUE
hldbaogccddpldhilm	TRUE
hldoimocfjhgfkkcpe	TRUE
ifdnlkifljdioojcpe	TRUE
ifedmpknhehgopnioi	TRUE
iobkonngfbhdkepnjd	TRUE
iocnoeaocijmnegged	TRUE
jigbcohfjkpikpfonh	TRUE
jihfcecgijjodbjnnp	TRUE
kcihchpjekhajanemn	TRUE
kcjappbfkdghcfjoej	TRUE
knekmijbepfenehmgh	TRUE
knfbnmomoldnbpcnoa	TRUE
lgonjjdbnognaghmef	TRUE
lhajjopllaabhgombh	TRUE
mblaaodmdhignmjino	TRUE
mblkfommmkhggpgmgk	TRUE
mmddhfjljpifoipknj	TRUE
mmeckaaagljfkljmaa	TRUE
nglmgalngaggeneajo	TRUE
nglnpdechdmdhbodgj	TRUE
oafjbghfpdjnkllkil	TRUE
oafkhnoahidppmhcdp	TRUE
olbbhnbifjabbkhilj	TRUE
olbmabphnindjbmapk	TRUE
pflonnocamplcabeam	TRUE
pfnikhfbogbelfgmnf	TRUE
aabbiagjeanjohaaaa	FALSE
aabbpcklkoiacfaaaa	FALSE
akcmgleoglcimpaaaa	FALSE
akdfokcbecpcjcaaaa	FALSE
befocimllfmhalaaaa	FALSE
begokgdckeilmbaaaa	FALSE
bnobagapffcjecaaaa	FALSE
bnohocjkhcpcdbaaaa	FALSE
cjajnmincopaadaaaa	FALSE
cjbnaopjjnnohnaaaa	FALSE
ddpjijohklaoheaaaa	FALSE
deaapabkloooagaaaa	FALSE
docbajjmcibjhkaaaa	FALSE
doclfekdchnmhcaaaa	FALSE
ehmpmokablpkhlaaaa	FALSE
ehnjgfdiilciaeaaaa	FALSE
fblalpfgnjdognaaaa	FALSE
fblllbdnagfbphaaaa	FALSE
fmhmioalajmkfaaaam	FALSE
fmhpfflkbbhdhiaaaa	FALSE
ghgkncllghlbngaaaa	FALSE
ghhlpnanbiofblaaaa	FALSE
hcapefdafcklioaaaa	FALSE
hccahbcjfhhipkaaaa	FALSE
hlgglmejdhmickaaaa	FALSE
hlgkackjoafpmeaaaa	FALSE
iffbaabemmclodaaaa	FALSE
iffeppeongkpofaaaa	FALSE
jadpbbfpioecoaaaam	FALSE
jageabadjjepgeaaaa	FALSE
jkedhmpmfojbmpaaaa	FALSE
jkeeakngkofomdaaaa	FALSE
kenjjlhocnpkegaaaa	FALSE
kephekmkghpplhaaaa	FALSE
kpghcmhnmcadpoaaaa	FALSE
kpgohkfpjkbojlaaaa	FALSE
ljjdkhjjcpipdkaaaa	FALSE
ljjfloknidakknaaaa	FALSE
meechdhaodgacgaaaa	FALSE
meeeiceiocjhaiaaaa	FALSE
mnkioaclklajiaaaaj	FALSE
mnlbgcfcochkdlaaaa	FALSE
nhchakaddgeeokaaaa	FALSE
nhchnafnfjdlppaaaa	FALSE
obhjhjaieikgpmaaaa	FALSE
obimanidnhfgkkaaaa	FALSE
okfcdlgldbaommaaaa	FALSE
okhhblflmodphmaaaa	FALSE
pelokfmfpojhphaaaa	FALSE
pemfmciblaocjlaaaa	FALSE
aabbiagjeanjohcklko	TRUE
aabbpiacfhppjpdgppc	TRUE
akehooohlkgeffhkkfl	TRUE
akfclkgnjlepefiaiji	TRUE
bdpljfcdafaoggkgkkp	TRUE
beahmiepciljbpnfohb	TRUE
bnogdpbbkcplaoaeabp	TRUE
bnpbelndapmdpkadmmj	TRUE
ciphfpagadocioklekg	TRUE
cjagmcbdonejkjamamk	TRUE
debkhobljojapmagenn	TRUE
decblnkddgalnpepjda	TRUE
donpiehkenaoagnolif	TRUE
dooaheepebkmobhofgc	TRUE
ejebmdicmakpgmcefgm	TRUE
ejeehhgofkfapjjpfcc	TRUE
fcbfhipkpamkmfmfffm	TRUE
fcbhjiiklcfpalniddg	TRUE
fmioanokknfojdapgoc	TRUE
fmjbhkbkmlfkfmbokcn	TRUE
ghgdamfabaoenmdmhho	TRUE
ghgdgaogebmimfoljhd	TRUE
hbnmneonnggngdjmcoh	TRUE
hboamaopbefikcddcom	TRUE
hlbpclaillbgaloaefl	TRUE
hldcccfbpponablncmi	TRUE
igcipjipdokgpjbekpc	TRUE
igcjkafabcggjdkbjoc	TRUE
jaejfbpglidcfhfbbaa	TRUE
jaepekgddbgpahcejmj	TRUE
jkdglnmfnpidkdncocb	TRUE
jkdhjhddckphlknalgc	TRUE
kfeemmmannidnhfgkko	TRUE
kfegnommbinohdeicmf	TRUE
kpfakhamdgjobgkiaba	TRUE
kpfcdaigjhffjgijbaa	TRUE
ljnklgccobldoiecbgd	TRUE
ljobiimohlgeocopapc	TRUE
megedmlgjjmodbpadfa	TRUE
megligighpjljkhbmck	TRUE
mocfikdgifoafaepohn	TRUE
mocmeigamippeongcdf	TRUE
nhiplkhenodmebpeifh	TRUE
nhjaomeilgonccfejng	TRUE
obhmhpgeeenmelhcpnh	TRUE
obifnpgohookfobgcja	TRUE
okkcbdadnfpnoimlkgo	TRUE
okknojkiddkghklmfff	TRUE
pepehkekflicnpocdae	TRUE
pfajmlbgafpajkbbddf	TRUE
aaadnmelicdkpkeaaaa	FALSE
aaajlejcadbaldeaaaa	FALSE
ajbgcfpndkjachaaaae	FALSE
ajcmobphjoedclfaaaa	FALSE
bdffhabphgdncneaaaa	FALSE
bdhigipgnianbnnaaaa	FALSE
boccjbohhlnpppbaaaa	FALSE
boecpidfmepgeopaaaa	FALSE
cilphdkokaagffdaaaa	FALSE
cilpmcdenjhmkieaaaa	FALSE
dchmhbgadmdihedaaaa	FALSE
dchomjgdmnblphkaaaa	FALSE
dmmfekmdgeknicnaaaa	FALSE
dmmhlffgmnfpiblaaaa	FALSE
ehpmmciakdhpiacaaaa	FALSE
eibpeifcckanlbfaaaa	FALSE
fbinbnmcecmoeihaaaa	FALSE
fblajnmealejefdaaaa	FALSE
fmhdihadkejedobaaaa	FALSE
fmhomghopjjenaeaaaa	FALSE
ghmnddedfkmpjoaaaaj	FALSE
ghpldmbjfjhjlnfaaaa	FALSE
hcgdomcjaljlfmhaaaa	FALSE
hcgehfpnahnbcmjaaaa	FALSE
hnhkfiopccjnfooaaaa	FALSE
hninfokfcmglnajaaaa	FALSE
iiglgkedcfdgkehaaaa	FALSE
iihbfdhdhmmjjnkaaaa	FALSE
jdfopljiiokejipaaaa	FALSE
jdgjnbecdmfbhfaaaac	FALSE
jnkbpjnpliojlpaaaan	FALSE
jnkmhopmohodfogaaaa	FALSE
khjfmjgekefhpjbaaaa	FALSE
khlbfkpogmmpigcaaaa	FALSE
lcegpepemgigoagaaaa	FALSE
lcekdkagnhikhplaaaa	FALSE
lmhmmkfapdneadiaaaa	FALSE
lmjfklgghjmcmlnaaaa	FALSE
mgglgpjkgnlplppaaaa	FALSE
mggpnhjajlhgkndaaaa	FALSE
moneigedoeddelmaaaa	FALSE
mooibdmacoognanaaaa	FALSE
nimilofhokmbkegaaaa	FALSE
niphfmgbmknpjjiaaaa	FALSE
occdoginaoddnhdaaaa	FALSE
ocfmmhndebhdaidaaaa	FALSE
olpoefcpblapdcnaaaa	FALSE
omajljkiiakdggpaaaa	FALSE
pfmlbfepcbmbmpmaaaa	FALSE
pfpbmajlfnddepdaaaa	FALSE
