addfipmfdm	TRUE
adfpnhlomj	TRUE
alfdknehjo	TRUE
alflgohgpm	TRUE
bggolljocj	TRUE
bgilnlppph	TRUE
bphflgcfpf	TRUE
bphjcccmio	TRUE
cjjlgnjiek	TRUE
cjjmgllhaj	TRUE
ddadplggek	TRUE
ddahonjekf	TRUE
dmleilkmeh	TRUE
dmmfmlojcp	TRUE
eggccnjddi	TRUE
egghfjogma	TRUE
fakjpkdljn	TRUE
falgnednok	TRUE
flddombhhl	TRUE
flfhnllnpj	TRUE
ggamohoonn	TRUE
gganjjfeje	TRUE
gpmaemmjjf	TRUE
gpoobmcllm	TRUE
hkajjjoide	TRUE
hkapnpkphj	TRUE
idglenjgbf	TRUE
idgpjhaejj	TRUE
injfnfdgfb	TRUE
inlddafmkk	TRUE
jhkifcnpgp	TRUE
jhldnpljgi	TRUE
kccpgefgng	TRUE
kcdcfhccoj	TRUE
kmpolcjfhj	TRUE
knbjepglol	TRUE
lgmnlenfdd	TRUE
lgnjeeioci	TRUE
mbkjclongn	TRUE
mblmcmnmin	TRUE
mmnneocafo	TRUE
mmnnnoccbg	TRUE
nhhfonedmb	TRUE
nhhogeilin	TRUE
obieelfili	TRUE
obihmlmpoc	TRUE
omcinkgkef	TRUE
omdangljnh	TRUE
pgefefjphd	TRUE
pgfhmlepog	TRUE
aaamibineo	FALSE
aabigochbf	FALSE
ajnokbakml	FALSE
ajpmcidali	FALSE
beiajbliam	FALSE
beijadibmc	FALSE
bpkpelhebf	FALSE
bplhmoblah	FALSE
cjaidncobn	FALSE
cjfofcleba	FALSE
dddgihkcba	FALSE
ddgfehnmbd	FALSE
dmjjmocfac	FALSE
dmklblfggd	FALSE
efnfennfbb	FALSE
efpfnigjaa	FALSE
fakmiagcjg	FALSE
fakodoglab	FALSE
flenkpbndc	FALSE
flficehhbd	FALSE
gfhldombea	FALSE
gfihlnllbb	FALSE
gpofoligac	FALSE
gpohlkgkab	FALSE
hjfadngjgb	FALSE
hjffpfeoab	FALSE
idbcmpbjjk	FALSE
iddhhmnbgd	FALSE
iniegbnbmo	FALSE
injaonhhbk	FALSE
jidkoakpmc	FALSE
jidkpdbfca	FALSE
kcbegcmhna	FALSE
kcbpobdfde	FALSE
kmiojhajda	FALSE
kmjdohogbb	FALSE
lgohpmkkbb	FALSE
lgppgmdfac	FALSE
mbjcfngckb	FALSE
mbjgifpalo	FALSE
mmgdbdgkhg	FALSE
mmgmkabnhh	FALSE
nfnedendab	FALSE
nfnmbjafdf	FALSE
obbknckeoa	FALSE
obcfhfnlfb	FALSE
okkoedjmba	FALSE
oklbmpnihd	FALSE
pgejdegbfb	FALSE
pgfjfiknac	FALSE
addepipdijh	TRUE
addgmmdglgk	TRUE
aldolknjnig	TRUE
alenklmokdg	TRUE
bgomopekjhm	TRUE
bgpfogjmjce	TRUE
bpeocjmncke	TRUE
bpeooeelfhc	TRUE
cijcmidjbch	TRUE
cijnpikmkhk	TRUE
ddfmmfjfjhl	TRUE
ddhepdoinad	TRUE
dnddknalohd	TRUE
dndolpbffjf	TRUE
ehgfaeellog	TRUE
ehgipnfclol	TRUE
fblgjomcmfh	TRUE
fblngokchic	TRUE
flbjkniglni	TRUE
flcdocoenni	TRUE
gfijbgpnogg	TRUE
gfioicghopf	TRUE
hainfomfkhi	TRUE
hajmhoogmjf	TRUE
hjpeciajfek	TRUE
hjpjbglcoci	TRUE
ifhbhmpcpcg	TRUE
ifilmfclbjn	TRUE
ipinmhcempc	TRUE
ipjgjpbolfp	TRUE
jlendnaejpk	TRUE
jlhgoenmcco	TRUE
kgahnjfkdhg	TRUE
kgbclpnikgg	TRUE
laedjkmfdfg	TRUE
lafpmnggono	TRUE
llakjemelnj	TRUE
llaknjfhohh	TRUE
mejinehflbm	TRUE
mejomiioehc	TRUE
mpafifkpiil	TRUE
mpbipemjmgi	TRUE
nikaoonolgj	TRUE
nikdajjeokm	TRUE
odnjopgbcoc	TRUE
odpdefjphcl	TRUE
onddpkmoang	TRUE
ondhgcfdkdp	TRUE
pgkfpanpdel	TRUE
pgkpeipfoco	TRUE
aaaajdgphpa	FALSE
aaaeedijnla	FALSE
akjddkldifa	FALSE
akkbdgjgffk	FALSE
beieenioocb	FALSE
beilfpafnmh	FALSE
boohcponloa	FALSE
boomcabjgem	FALSE
cihoibfeapa	FALSE
ciiaknmdeag	FALSE
dddndammclk	FALSE
dddoefciobd	FALSE
dnjgneohmaa	FALSE
dnjnpjoaomc	FALSE
ehabcgidjni	FALSE
ehdcafnndec	FALSE
fbcpkgbpoel	FALSE
fbddbmejlgn	FALSE
flbkkkcghnb	FALSE
fldgklpmoba	FALSE
gfmjknmdkaa	FALSE
gfmmdkenlbd	FALSE
hahhccocafn	FALSE
hahloagcehe	FALSE
hlkemfjpjbb	FALSE
hlkfbggflha	FALSE
ifdmcecnobd	FALSE
ifekopmajmb	FALSE
iphhjkoglac	FALSE
ipjcfmjlmbb	FALSE
jleajnjploc	FALSE
jlgbnbeadkh	FALSE
kgbaepapndj	FALSE
kgeimbklodo	FALSE
laahligdcee	FALSE
labomfkgafk	FALSE
lkhbjoielaj	FALSE
lkhgeichjbd	FALSE
mfpoddeepbd	FALSE
mgaknoblcei	FALSE
mopdohofcac	FALSE
mopfppgoiba	FALSE
njghfbkgdek	FALSE
njhbolhhiod	FALSE
ocpoknninac	FALSE
odaidhkonma	FALSE
omlfajgaehi	FALSE
omlmbifhhdf	FALSE
pgkmndmkjaa	FALSE
pgllapcidbg	FALSE
addfidhopjmo	TRUE
addfomijmond	TRUE
akooinfffhkh	TRUE
akpmohhlkind	TRUE
bgccfhnmhken	TRUE
bgcgepogphgl	TRUE
bollmfcngnii	TRUE
bolplhljoioh	TRUE
ciailfgenndo	TRUE
ciakeiemdegh	TRUE
dcmiemlbopkf	TRUE
dcncjgoaidmo	TRUE
dmhficngojdh	TRUE
dmhfinfcokle	TRUE
egbmchlfnoic	TRUE
egcfijncnchn	TRUE
epoploakonmd	TRUE
fadenenljdld	TRUE
fjkjaoifghdh	TRUE
fjllganljmhn	TRUE
gegcllimmhea	TRUE
gejgkihmhcgo	TRUE
gopeioncdiga	TRUE
gopiledbcgpk	TRUE
hihohckedbol	TRUE
hijbomlphlie	TRUE
ickfchbpkoec	TRUE
icllieenikmp	TRUE
inijekhkdplm	TRUE
inikoeojnmjg	TRUE
jicjjmkjlpai	TRUE
jidiehppdnae	TRUE
kddhcfalmekk	TRUE
kdeikaeddekh	TRUE
kmlfmcfocfof	TRUE
kmlknhbehfoh	TRUE
lghekgjdjnlp	TRUE
lghfbeglkghi	TRUE
mbnminhloegn	TRUE
mbnnfgpoeoic	TRUE
mmeeololepka	TRUE
mmemgapfmfdn	TRUE
nhaonfeglhhp	TRUE
nhbimckmiijj	TRUE
oaipgljelffe	TRUE
oakkjphefidm	TRUE
okpmdagliheg	TRUE
olaknfmpfidg	TRUE
pfcbgfnnccll	TRUE
pfcgiefcnfbo	TRUE
aaajpaohefcf	FALSE
aaalhdaoiepe	FALSE
ajfolbkgllll	FALSE
ajielfokadjg	FALSE
bedinpfomcpb	FALSE
beeackehnefh	FALSE
bnnnojcdmpno	FALSE
bnofdepelonk	FALSE
chlamhhddplc	FALSE
chllagkhblpe	FALSE
dcjoehoodhab	FALSE
dckkbgbchllg	FALSE
dlioohhmjbcb	FALSE
dlkdlckkkebb	FALSE
efkkjegfapbd	FALSE
eflnmdlpemab	FALSE
eppkngilanmb	FALSE
faajlddcgdcl	FALSE
fjkjegnejhba	FALSE
fjlchlaeglmb	FALSE
gdlcpfenebmb	FALSE
gdljkmjinpab	FALSE
gojjiohibhnd	FALSE
gokiacmgbfpe	FALSE
hipginnlcoac	FALSE
hipnjcpoefbb	FALSE
ickgpinfalmc	FALSE
icklogmhhlbd	FALSE
inammakdeffb	FALSE
indfdghhdaja	FALSE
jhpkdggaaobc	FALSE
jiachblapepg	FALSE
kcmghjiednab	FALSE
kcpbohpjdcjc	FALSE
kloeeoibkhja	FALSE
klogoandhnkb	FALSE
lhhafcgnhdab	FALSE
lhhaopdmhfhb	FALSE
mcjnjdpopbod	FALSE
mclhhdfhcfbd	FALSE
mmojppfnaefc	FALSE
mmoogjdjnlbb	FALSE
ngiokbkbehfd	FALSE
ngipelhcghaa	FALSE
oappgnlldibl	FALSE
obaenedckekj	FALSE
okkibofcmpid	FALSE
oklkemcadiob	FALSE
pfjgablnondm	FALSE
pflgagoeonkb	FALSE
adddgjgkffmgi	TRUE
addfljjlglfpk	TRUE
alfdlppiflhoi	TRUE
alfjogndekpkm	TRUE
bgpopefmjkicc	TRUE
bhcojcgmkjghe	TRUE
bopoeeohcooji	TRUE
bpfhmknogfcjj	TRUE
cilhoibnjknff	TRUE
ciliddnlefakm	TRUE
ddccpodfmjgmm	TRUE
dddecldaodpgk	TRUE
dndiillhenidn	TRUE
dndkpeehhfche	TRUE
eghcbmcgeljkh	TRUE
eghkaklhdipem	TRUE
fbcfgoknohnop	TRUE
fbejljehpgihg	TRUE
fmbkccgcpimhg	TRUE
fmchioiianddp	TRUE
gffbpcjhgpijj	TRUE
gfheepcemdefk	TRUE
gpfdjfieockoo	TRUE
gpfjlafnninjn	TRUE
hkfjeljlffhjj	TRUE
hkgehphphjfok	TRUE
idpplhjcbipgn	TRUE
ieagjgekfmhgp	TRUE
inoolkgijklol	TRUE
inphppcblmoig	TRUE
jhgekdaddlomi	TRUE
jhhfnnigokebl	TRUE
kbcncnocpggil	TRUE
kbfcpmhinjkek	TRUE
klofpicphkhdo	TRUE
klombhhoikcep	TRUE
lghlcdnhjgbjp	TRUE
lgiimfmikagek	TRUE
makonhnldlhlk	TRUE
mamkglfhfinpe	TRUE
mlfbnnocgokcp	TRUE
mlgafieiipode	TRUE
nfblhggphfnci	TRUE
nfcjlklbhpecj	TRUE
npkcimmdjombk	TRUE
npkpibkjhkokk	TRUE
olkifecnmplgg	TRUE
olkofdbgcnnll	TRUE
pgakgfhiejelk	TRUE
pgcaflhdgfmdl	TRUE
aaagmdfollbgp	FALSE
aabnokjjekoga	FALSE
ajnjpijenepob	FALSE
ajohndmaadgnb	FALSE
befoffhekopca	FALSE
begccfaejjdle	FALSE
bomlgdfaednje	FALSE
bondfoemiifkk	FALSE
cieiceileceba	FALSE
cifaljeomdlcg	FALSE
ddcaahdgbgpmi	FALSE
dddgcgooldjba	FALSE
dmopkojlfobob	FALSE
dmpbeinefhila	FALSE
ehafdakopelnj	FALSE
ehanpojkiddna	FALSE
fbdlnadbinghe	FALSE
fbdoahieaofmb	FALSE
flplpemkenjbd	FALSE
fmaeainannped	FALSE
gfjclpjjpmpbb	FALSE
gfkchdkjhgaob	FALSE
gplgkojjgnmbd	FALSE
gplgnddiecpbb	FALSE
hjjdggllkchac	FALSE
hjmbcomkeeoib	FALSE
iedhagnjlhemc	FALSE
ieenfeleidiaa	FALSE
ioelmcpbhkmnd	FALSE
iofnhkkkbiobk	FALSE
jhbpbkoojljpn	FALSE
jhccjiogceeab	FALSE
kbjdohmhglhfe	FALSE
kbjicfpahdgje	FALSE
klogoinacigmi	FALSE
kmajapgpbaemn	FALSE
lglmbfgcoljdf	FALSE
lgloljleefoac	FALSE
makhjjimdhoic	FALSE
malbjokbegbba	FALSE
mkaheekpdbheb	FALSE
mkbcpgcbohldb	FALSE
nfgkfnhgabake	FALSE
nfhblgofcbchk	FALSE
npoegknmgohaa	FALSE
npopnokooidbd	FALSE
oknpgegoddmbb	FALSE
okpobaedaglao	FALSE
pglkkaembfaab	FALSE
pgmpojlbdmaok	FALSE
adddgjgkffmgil	TRUE
addfjjlglfpkpi	TRUE
alenlfggofhpfm	TRUE
alfjdmdeknmikh	TRUE
bfpjcljhkhpklg	TRUE
bfplihplncemhh	TRUE
bpcilhgiejoicj	TRUE
bpckkomcpfchmp	TRUE
cifcfcjhmhfihn	TRUE
cigngcioeeldpb	TRUE
dconcmamgnghoi	TRUE
dcpecbphhgokpk	TRUE
dmgnkgbomlecij	TRUE
dmlamhodljepmi	TRUE
ehajjgjmnmlkgg	TRUE
ehajojgflnkgde	TRUE
fbcllejmkcocip	TRUE
fbeihchefpigeh	TRUE
fllnjghbpophkp	TRUE
flmlbonceomgkj	TRUE
gfkbnmilhfnocf	TRUE
gflkfgkdaejmod	TRUE
gpjiahdhooendf	TRUE
gpkjomhfilmppd	TRUE
hjokbghohgjmcl	TRUE
hjpbkkehillfoc	TRUE
iegflgagkfjlph	TRUE
iehlahjidpkonm	TRUE
iobmiokenlmkil	TRUE
iobmklkpohojcp	TRUE
jibolpmjfijplj	TRUE
jichllhlfolhjc	TRUE
kbgicjihijefjp	TRUE
kbgmplefmpnjkj	TRUE
kmfmeincihdane	TRUE
kmfpiekfpfmhcg	TRUE
lgggblhhkckllp	TRUE
lggpfhcbplkhei	TRUE
majddkjnkfdmgm	TRUE
majkojpejeimpd	TRUE
mklledchkojknn	TRUE
mkmkcifnpaiihh	TRUE
nfmhpkjbhoehfe	TRUE
nfmipbiinhkoih	TRUE
npjnakihfllejg	TRUE
npmehfapgelekk	TRUE
okpbjgpkhfpipp	TRUE
olagphpilpklio	TRUE
pgebjnincifpnl	TRUE
pgflmfccbkhngk	TRUE
aaamedgoginalk	FALSE
aabdbfnedilidc	FALSE
ajfcpgkllkhdhj	FALSE
ajfnnejkhhenia	FALSE
bdflhdjiahaflp	FALSE
bdgiopmjmdaoob	FALSE
bmehhcilehmdgk	FALSE
bmhcpdhboiflgi	FALSE
cgkccmbkhheebd	FALSE
cgkfoffjpmgnaa	FALSE
dbhjkilnfihbpa	FALSE
dbhjmnhommimha	FALSE
dmglkpokehpkab	FALSE
dmjacbahppfkdd	FALSE
egpnnaiflmjnag	FALSE
ehakehplianhec	FALSE
fbakjbocmgmajc	FALSE
fbbkbkfdmbemlf	FALSE
fkliblogocpifb	FALSE
fkndmnnomdgnba	FALSE
gehnoglojmdlba	FALSE
gehoijdipgcgaa	FALSE
gopcgophljkpab	FALSE
gopnkfkbnajpcj	FALSE
hjjokgjckakaba	FALSE
hjkedhfjgkdibb	FALSE
ieblgbjgajedig	FALSE
iebpoabmdhjaih	FALSE
ionenaohcjkmog	FALSE
ionkehcfdboobb	FALSE
jjaifjildeikcc	FALSE
jjdnegloplphac	FALSE
kenpgdgdfepcbb	FALSE
keocbccbldmccp	FALSE
kpinfnaeffibab	FALSE
kpkcicifdaigpc	FALSE
limglaaelaelhc	FALSE
linkiflhehcbpb	FALSE
mcfienppnfocbd	FALSE
mcfioaidglbkhh	FALSE
mmaddkpmphgfdc	FALSE
mmafignfdjaeog	FALSE
nhdilmapdfgila	FALSE
nhdogdeemihfbd	FALSE
obiinjfhhippma	FALSE
objhjloihbbedk	FALSE
oljnbpdamjgjgm	FALSE
oljpffnllmnoac	FALSE
pfedokoacgmnlk	FALSE
pffnjfamijnfco	FALSE
adddjkhpomdeepe	TRUE
adddlgemkolgiem	TRUE
akmedhfnojmihil	TRUE
akmjkdnjnpipojd	TRUE
bgjklngenfjfohi	TRUE
bgjmipffokfjlce	TRUE
bojigglnpffocph	TRUE
bojneiolkggjkfn	TRUE
cigdoefhgekooag	TRUE
cigfdhkjdjejoif	TRUE
ddmgiemcheahdjm	TRUE
ddmjkpnlbfofjpo	TRUE
doljaipnjkdjoeg	TRUE
dolkkhphglboggf	TRUE
ejdbpenmipfckln	TRUE
ejdnfinbjnhcefm	TRUE
fdfgiddcgfppgfn	TRUE
fdfjpammjoelood	TRUE
fnknookngdkkkoe	TRUE
fnmmgdojhjocdmj	TRUE
ghbipcehggelfec	TRUE
ghcghijaoonmphg	TRUE
hblpjkeoojiecmk	TRUE
hbmigipopoocjjo	TRUE
hlckakegnoejmlj	TRUE
hldbjcimengngpm	TRUE
ieppamgfjkghjoi	TRUE
ifadnjodehgdiko	TRUE
ipkelenmehnjgfl	TRUE
ipkpikbinkjocpk	TRUE
jjfiepmjgenallo	TRUE
jjflgkpiggbefcm	TRUE
kdpkpjbfgelhnge	TRUE
keadjnifmjgkmij	TRUE
kpccnmpajkjefnn	TRUE
kpeadohkgmddnjp	TRUE
lkbckcjjijofnmp	TRUE
lkdakiipmlpgopf	TRUE
meecmijkggjcmbm	TRUE
mefpjgiekalihlg	TRUE
mninifpkhbncipk	TRUE
mnioidocfbfihkn	TRUE
nhninidlldpmpai	TRUE
nhnpgmbchffcloh	TRUE
ochbfhenonfjmhf	TRUE
ochgcbholofkjlo	TRUE
omepokjgdafdmdp	TRUE
omfdjkilidmdgjp	TRUE
pgggllccpjmoein	TRUE
pgjniedjnpjjknc	TRUE
aabidhdgfhjgcpp	FALSE
aaciflcinodinoa	FALSE
akdepjpgggfghea	FALSE
akdliflbeificoe	FALSE
bdpnafoghpdjhfa	FALSE
beakilcllifmana	FALSE
bobbdppmkgpndkg	FALSE
bociplodpocehlm	FALSE
cinicogelonkhbb	FALSE
cioeeoioljldcbd	FALSE
ddnkkpodbkcpbbo	FALSE
ddpcdjidkkkfcac	FALSE
dpdcngmlecklnab	FALSE
dpejojcoddjkfba	FALSE
ejmdkhphglblnnd	FALSE
ejnhfjakhfpnodb	FALSE
fdcahljapbfkhnd	FALSE
fdchdkpbpopfefd	FALSE
fnbdjeelppleoao	FALSE
fnchpcijdlcfeba	FALSE
ggmjmdcfmlihfaa	FALSE
ggmpjijfebjgiga	FALSE
hbpkbmlbkfnjeem	FALSE
hcapdagnbkkioma	FALSE
hkcfofademfcomj	FALSE
hkcjhegflnnhlbb	FALSE
ifbjbmlbgcpnpml	FALSE
ifcdopaghgepmjc	FALSE
ipeeahgdpoipmoa	FALSE
ipefmhcdebheanh	FALSE
jjcgajclomlkncl	FALSE
jjdcnjdacnncngl	FALSE
kdonolabdiijkbo	FALSE
keaoboogfjngbnl	FALSE
kopeniofdkmiabj	FALSE
kopjhahpgaciapo	FALSE
lkiemhonkfbeola	FALSE
lkjmpnjgejnokab	FALSE
menfkgekhhjleaa	FALSE
mepfdjhniinicba	FALSE
mnfemkdagbhohga	FALSE
mnfpbbbpndjolmh	FALSE
nieibjdinkjnfkm	FALSE
nigflehjekplaaj	FALSE
ocgblgjldjnphgi	FALSE
ocghikpgbhhbgbk	FALSE
omcabgpjdfedmia	FALSE
omckaceoodgjdpc	FALSE
pganpijifagmhpk	FALSE
pgbhlmpagehhpfi	FALSE
addjpdnekmdengio	TRUE
addnejjdeekiielf	TRUE
amgdnfnmghlejehe	TRUE
amhigmoggnokgpgl	TRUE
bhopfpgfeckcljpi	TRUE
bhpimhlelghhmili	TRUE
cafofofhdepjhfnd	TRUE
cagdipljpdpgolml	TRUE
cjindjhggpgjoegd	TRUE
cjipobcjlicplhjh	TRUE
degikgbkneglepen	TRUE
dehfbmgklfennhgo	TRUE
dojonimaofiphmpk	TRUE
dokkkdjnddfkdfdf	TRUE
ejejnmgmgjegelmm	TRUE
ejekhhjipbfcmjgg	TRUE
fdocaekhiiknlpde	TRUE
fdohdjbfjflpenkn	TRUE
fnadhfplodddkmff	TRUE
fnaempfongoidmop	TRUE
ghaliigjikihnpin	TRUE
ghbpgfghlfipmnmh	TRUE
haipkjgkgdgepphk	TRUE
hajifhojlfkhjklg	TRUE
hkhmjekhkhmkmbfn	TRUE
hkhokmaoiihmdmdd	TRUE
idhhbeelijgipejl	TRUE
idjgplhjkpckjllb	TRUE
iocfboonknhnniio	TRUE
iofcgiilmlikilop	TRUE
jhjnjbpfiklnglpc	TRUE
jhkbpihioeockmfp	TRUE
kapomgiiphlpimgg	TRUE
kbchjmlokiigefcm	TRUE
klmnojkcfhlflmhi	TRUE
klnjlajhfmlehokj	TRUE
lfecjebklncikpgg	TRUE
lfghhfokobhpoeol	TRUE
lpnnbiojooigojcn	TRUE
lpofpejagdfjhnpf	TRUE
mklmhfejflomkbje	TRUE
mkncioeahkejgeni	TRUE
ngbgomigikpjhcpn	TRUE
ngbhijjchkgicohe	TRUE
oakghginikpjgpel	TRUE
oakiophogphejpdd	TRUE
oljlemfmonlpgdbh	TRUE
ollcmgfikpnohhoi	TRUE
pfmepocmjjmochfk	TRUE
pfmkhgephamioeff	TRUE
aaalnfmkphhnanef	FALSE
aaboaekmkfckilan	FALSE
alehlhnimoiheegc	FALSE
algpolmelmhikhec	FALSE
bglneclehgepgebh	FALSE
bgmbganoelccgnjb	FALSE
cagdmpoodagenbdh	FALSE
cagjjhihjjgmhhoa	FALSE
ckbcgfmnoebfanma	FALSE
ckcojgjpgmilfkab	FALSE
decgjbdagahbchnh	FALSE
decmcfmnmlogjnab	FALSE
dojeboamololejoj	FALSE
dokcccahfinmcmhg	FALSE
ejmdmledgfifdibd	FALSE
ejmjlgjaleoljdoa	FALSE
fcloalekjgfniiga	FALSE
fcmgciclbjjofoid	FALSE
fmppljjeomlgplbb	FALSE
fnajfpnkegpblgnk	FALSE
gheojenhcdbnoalk	FALSE
ghfapeaodjohcifa	FALSE
hajlphiddagbpbdi	FALSE
halckeglpjpempfe	FALSE
hjpmmibcomiojepb	FALSE
hkbknfbgodfoibip	FALSE
ieeepoedggkjdjbd	FALSE
ieelinkdjlgpmibd	FALSE
innilmbnoljmioca	FALSE
innpnknhcgmbhkpd	FALSE
jhdcobjlkllpbnok	FALSE
jhdehkfkchbikina	FALSE
kbioaepicpmgkfmh	FALSE
kbknkhkponnfahdp	FALSE
klfbccpbnenllcgf	FALSE
klgandcmcellhojh	FALSE
lfcgildblglhdpfi	FALSE
lfecdjkodgclcjaa	FALSE
lpmghhpcmiidlmac	FALSE
lpnckebilipifema	FALSE
mkcgljjkpkjbgbbb	FALSE
mkegfngploichnac	FALSE
nfgbaponaenhjkmd	FALSE
nfgcnhplfckeoacf	FALSE
oafpolbgofgeodpj	FALSE
oaglbcibfpjhoeop	FALSE
olemckmkodpcnnaa	FALSE
olfmgoklgjfneamb	FALSE
pfmhogkelpakokjc	FALSE
pfohibghdoccmecn	FALSE
adddigkolopgkifeg	TRUE
addlnkglhpdemhden	TRUE
alkjheplfhonmkodk	TRUE
alkmmoggppglpinji	TRUE
bglenfioeengchcoo	TRUE
bglhfmklgghhpofhj	TRUE
boggmnckefjnhfhmp	TRUE
bohigloiinjgfojgf	TRUE
ciifimpjalfdpjmfn	TRUE
ciihkpafnklmojnom	TRUE
deafdenjnodmgkofg	TRUE
deaglleepnjmkggeo	TRUE
dnpcbpnnfkfmonimn	TRUE
dobcnicfmhhjmpkhe	TRUE
eicojchampgikmmpd	TRUE
eidgkpemgfdbehhjm	TRUE
fclecdgolameekdgn	TRUE
fcmaefmnidlffigon	TRUE
foaedoigmfeijgokg	TRUE
foahiioomdhgmdjml	TRUE
gigiaohjdhkdmhekj	TRUE
gigjcobieighcinho	TRUE
hanjlfomghnpogddi	TRUE
hanjppkfdehllkhph	TRUE
hkdbklngicikkhlfp	TRUE
hkdhnlnjnepmgchgd	TRUE
iedidknagpodnipoi	TRUE
iefjjnkpieeihhhhp	TRUE
iokbnjccoelelkpmm	TRUE
iokkbpmlgekeigjcj	TRUE
jjidpkeaoiedhhmej	TRUE
jjjdcbpjfpolkekch	TRUE
keeonnpapoeeofpjp	TRUE
keffhehlfbkomgkim	TRUE
koejakmmieheejfhj	TRUE
kofahfhjlnkhedlme	TRUE
lifnhknkbeccppgll	TRUE
lifnnhannkkpjlnfo	TRUE
mcjhaefkonlmfkflk	TRUE
mcjhcejhoaehholnn	TRUE
modhdkjmnkecahokj	TRUE
moeilclhjdehailgo	TRUE
njjfecpfoebcelnee	TRUE
njjoghoemdamnjpod	TRUE
ocpkdagfkpjpgddmh	TRUE
odaeondmfdkilmdde	TRUE
olpmnbihgjngcjhif	TRUE
omadfhojnjnejlhhh	TRUE
pgnihiikcoamghinp	TRUE
pgoealfplofnnmeih	TRUE
aaahkjoclpomcnlin	FALSE
aabakbfnncbickmjd	FALSE
aldlkloclamkcmnbn	FALSE
aledajdhmcadgbdog	FALSE
bggidepklobdpfadn	FALSE
bghdbggabpcjopppk	FALSE
cafbkielfahjkcmgd	FALSE
cafndnfkjkjlaffnm	FALSE
ckbgepbmacklgoicp	FALSE
ckbjpfcbppfgohiah	FALSE
ddhdflbpmfipfdgjg	FALSE
ddhlckpgbjlkfbbmi	FALSE
dnfdddcjpgmfeklaa	FALSE
dnggfjnkopkapoogc	FALSE
ehpngnpoiehheflab	FALSE
eiaabghgoapflfgmm	FALSE
fcnfggodphnoddhac	FALSE
fcngoicdifnfkpibb	FALSE
fmafkfkoifbjnchea	FALSE
fmagjpcjdioalanbk	FALSE
gfnkalpekffgdodmc	FALSE
gfnpopfalcbboanli	FALSE
goppdlbofalahifpp	FALSE
gpbglfagbkolcdhln	FALSE
hjfngbmoghinhekcd	FALSE
hjgkcbccmlcbiahfh	FALSE
idimadkpncmnojiil	FALSE
idiofkohhkoimnjaa	FALSE
ioahebddneohlhpak	FALSE
iodfmkcelljmfabnk	FALSE
jjeicnfonghcolibd	FALSE
jjfaafnpdjlhfngmn	FALSE
kdijdbooiehpdolka	FALSE
kdnjodnahmbhfjdhc	FALSE
knkefnhpjgefcdeba	FALSE
knkgnejhlomldecab	FALSE
lhhjhmhkmkgmhldbb	FALSE
lhiepdggpjlnmpmba	FALSE
mbjfcdbikamdncdhl	FALSE
mbjobanpdkhnmklim	FALSE
mmpkcpkigmalheclb	FALSE
mnbikiipfonpgabaf	FALSE
nhdlgpcefgdcfhjac	FALSE
nhfbjebhgnmefoalf	FALSE
obfpfifnckdempkng	FALSE
obgkniomcfagnkhlf	FALSE
onbhlbcdgidbpfeao	FALSE
onbjhimcojcfacidn	FALSE
pfpfljkhbcekkgcfa	FALSE
pgbedkigppbbfhkme	FALSE
adejmhllfffimedglh	TRUE
adgenpnhfmgpjmeolf	TRUE
amgphojndphefdmnph	TRUE
amhfddfjejodigojon	TRUE
bhgllojmhphfhjjmip	TRUE
bhgnfhhflnmpppcipn	TRUE
cainokgdhmdiodgjof	TRUE
cajhogfggphgifhmof	TRUE
cjilefaegkmghhihoo	TRUE
cjkmpihcbikimijpfo	TRUE
deedbclmemklomojjk	TRUE
deeomanmllgijnhdek	TRUE
dnhjcjjpmhmadilkjd	TRUE
dnjebpmnilegppccln	TRUE
eholjblkefnjmokfli	TRUE
ehonadpojhmhodeiho	TRUE
fdloofpkmikpgnfpak	TRUE
fdmccfdojjdemfbghg	TRUE
fmecididhijnmbfglk	TRUE
fmenenijchjpmecfnn	TRUE
gffcmgpnjjmgkhcjma	TRUE
gfffbocpeinfllkpmh	TRUE
gopkbjfknhpllhnmek	TRUE
gpbhgfjlimmjinccee	TRUE
hiopbjeejfnoihcimm	TRUE
hipbmpnhopcgnjhkpm	TRUE
idjmpeilligllpaope	TRUE
idkhillappnfjpmnhh	TRUE
iohghhihbifnjffgml	TRUE
iohjhkpbnhngkmfgem	TRUE
jjgidjodbijlnohkjj	TRUE
jjgmgdfodocmhdngeb	TRUE
kdahhfnjlmendifmkm	TRUE
kdainjpopjmfoddhpn	TRUE
knclbeehogfnikfllj	TRUE
kndehajmpnnghfindf	TRUE
lheefcgnfflogeknnf	TRUE
lhfaiohjokomeffpff	TRUE
mboieeonmjonennopj	TRUE
mbomkffpikggcoljoh	TRUE
mncfebefonmcpjgjle	TRUE
mnclndkfldnkigbmkg	TRUE
nhieohdinphapnpmdf	TRUE
nhimkljljphnkpomhf	TRUE
obilkmfipljkooohmm	TRUE
obinhehlglciecfmjm	TRUE
omknkhdefjdofpjpdc	TRUE
omldipflelmibpohlo	TRUE
pgmdlnimgfpalojfki	TRUE
pgnjaenpnmojjlfkni	TRUE
aaacbbgdmbpahojkej	FALSE
aabhdimeonhghloklj	FALSE
akljmnndpdkebppchd	FALSE
aklkmcabfikefccnbi	FALSE
bgcdappggldkmnnpjh	FALSE
bgcfgkhpbhhjmaemjh	FALSE
bplhaffnbmacppfida	FALSE
bplkcdhapieomjkgom	FALSE
ckdicbgbdfdimikflh	FALSE
ckecaldkpngmnpfbpo	FALSE
dgfpmocfkmdkakjkhb	FALSE
dghbljagmnoohckajd	FALSE
eaoojaoemeknefflnp	FALSE
eaopbjaphiohpoohjo	FALSE
elknofmiplmjmdamma	FALSE
ellelkdahofkbpgmie	FALSE
ffoliekafgeplgihkc	FALSE
ffpffjngobjoickcpb	FALSE
fphodhkocmkmljliab	FALSE
fpicdnbffbjkfphfkk	FALSE
gjdigcfglfeajnfkma	FALSE
gjeeeikdeglbhhbdll	FALSE
hcfcpgeaabdclaknjm	FALSE
hcfmocomkajphppgch	FALSE
hncdcdagbadbfdkfid	FALSE
hndnbmgmpkcdpicgjb	FALSE
igocmcijeoflplkabj	FALSE
igokkdbndojmhnjfid	FALSE
jbbbaghdkidkaglpfj	FALSE
jbcgogmjcfikjgbocj	FALSE
jkmagbcnpggfhnpmkj	FALSE
jkniiicjcjkafmdkdc	FALSE
kekdgmlpjdonajnbbm	FALSE
kekffmfjheeaomipka	FALSE
kpjbncibndbhhokadd	FALSE
kpjgjllpimhhphjgba	FALSE
likbdlilkkdlahlpeg	FALSE
likfnfopmiihglopac	FALSE
mbonpilplpghkcicma	FALSE
mcbadfcailoiknhdfe	FALSE
mmhpekbcdaeddobonm	FALSE
mmiokpamjhgieibkfb	FALSE
ngadcmbemlanacmhgc	FALSE
ngalcapmeoggegbdfh	FALSE
oajopcbbekpjdbnilh	FALSE
oamcbleaodpfjcfldd	FALSE
oljnchmaomamaneiop	FALSE
olkncfplfcijhokpba	FALSE
pflnbjikmmgpmpkdja	FALSE
pfmocjcphckpjceajc	FALSE
addflpjkphhgjdopnen	TRUE
addhoioekpkfpggffop	TRUE
alikjgllpgenfhhepdn	TRUE
alioillnpdjmfkjpkoi	TRUE
bgkgglgppjemehjohif	TRUE
bgkojhkjnkohgifipji	TRUE
booijnifgnolnmgojnp	TRUE
bopmpciopcfnpjcnejk	TRUE
cijihhhdgfiedbmjhfe	TRUE
cikcdiblhfkcmklnkgc	TRUE
dcnafghpiidlmiomllf	TRUE
dcnalhhhgmjimllmned	TRUE
dmgcilgjgplbjehipco	TRUE
dmgifgpegmgjnfiepce	TRUE
egknclmeloaphhkgogl	TRUE
egllhoobjhklfgmhiin	TRUE
fbfejkhggnhjppnmknk	TRUE
fbfhkjmomehcnhlcimm	TRUE
fmibnpiemjigejiekmj	TRUE
fmjdecelcpoiapljomn	TRUE
ggfnlpcjoheemjoplpn	TRUE
gggbgkpljglhhoklpci	TRUE
gppgamknnmiliojmneo	TRUE
gppgefdnddadgkioegd	TRUE
hlajmpkfgjdfedplffh	TRUE
hlamfpllnhkgjegojhf	TRUE
idipalpdeeemhpklijh	TRUE
idjdjfojdnamhohnnop	TRUE
iocgplkhidobeohlkfc	TRUE
iodcelffhdiicjjojcc	TRUE
jhbekkhoiifhfjlcngm	TRUE
jhcadjjpidodekkmkop	TRUE
kbnhgenhmmfpfpgjhnn	TRUE
kbojojmjmkfhjmekfff	TRUE
kmbikogcfofpmkohjph	TRUE
kmcjcddfijeflmjafgf	TRUE
lgfmnomafpimehkfopf	TRUE
lgjbkfgmhjmpmgnpokm	TRUE
mbopmnjjepgjfphcjef	TRUE
mcafdfdhmhighoookfo	TRUE
mmhgepihnhbgheklglo	TRUE
mmiljbhllkhleojpljf	TRUE
ngbepocfgceonmlpmhh	TRUE
ngbojphpnhlcilkilpo	TRUE
oaijmeopmgngnlhfoge	TRUE
oajdpknfonngkgggigf	TRUE
omgdchajndkjfpeipip	TRUE
omhbiglelpomplhgcch	TRUE
pfjfdlbllienkkimlnk	TRUE
pfjfmjfnbljeiielcpi	TRUE
aaajklokmmccfpkbgkc	FALSE
aabafimleapikdgjlfo	FALSE
akocjclfgbemlcpgili	FALSE
akoecpgmkebmopghadn	FALSE
bheoocfhkdobpbfhgna	FALSE
bhhajcfnhgcclgjnffe	FALSE
ccdgadpplplecckpflh	FALSE
ccdjlodcclphaffbhbe	FALSE
cmaokcfjbakdgkjbkgn	FALSE
cmboajkliphaahompbe	FALSE
dgohdndnkaaihemimle	FALSE
dgpgjidmjkilpeijhaa	FALSE
eamnmpcddkbdonileld	FALSE
eandbcmpmggcocgckne	FALSE
ekdmnjjecnldaghncob	FALSE
ekecmognbbfokobeohk	FALSE
feamhpaajpjckdkchfa	FALSE
feanmgldjohkdiggimc	FALSE
fnhobbjpiglbpoglmfg	FALSE
fniajflldpldaohgfhl	FALSE
ghmglkbnhkpnjabnpkn	FALSE
ghnlojjegppccikapak	FALSE
hbghndidikbiinlmidk	FALSE
hbgplpkoggfbhchjcbd	FALSE
hkjhmnogkchoghmmnac	FALSE
hkjoipanajildpocggk	FALSE
iegnhdioihfmndgckbd	FALSE
iehjjbpcckgnfdcnjbk	FALSE
ipbnblfekheaofcjaod	FALSE
ipcfkhhbajjikcdpemd	FALSE
jjfonhagdkachjnehmh	FALSE
jjhmdpbdjhfdchampgj	FALSE
kboomfijohppfonfdmf	FALSE
kbplnjeadlaikjgoiap	FALSE
klmohmfahcoiahkiama	FALSE
klnjgedojfkagneidma	FALSE
lhpdnimjjdpancmcjhc	FALSE
lhpggjmagigbbbjiejj	FALSE
mcmhpdakodffgachigp	FALSE
mcmnjgojgpddppfpoab	FALSE
mlkadaebodlhibjllpb	FALSE
mlljnjadeekfahheahi	FALSE
nffpfghdgcdelgkknbb	FALSE
nfglcpjehmelgcgncac	FALSE
obagipmbmlocknncogk	FALSE
obcnchhbpjajpclamjh	FALSE
okmapeelmnbdabiddfh	FALSE
okmchejnbfhbnbekaob	FALSE
pfeahdnaclldpfhnhli	FALSE
pfebeaceoloomapghao	FALSE
