addieedkdp	TRUE
addimliooi	TRUE
aldplfnhmp	TRUE
alehlnehlp	TRUE
bepgmkamjg	TRUE
bepiahhmkl	TRUE
cajhflfffp	TRUE
cajmkpnhmf	TRUE
cmhhkadmjg	TRUE
cmhilkamdl	TRUE
dhjdianhpf	TRUE
dhjegmjano	TRUE
eapdfeooml	TRUE
eapfjgonhn	TRUE
ekkoochmej	TRUE
eknodkpfio	TRUE
felcegnidl	TRUE
felcoaefdo	TRUE
fpkkojbdeh	TRUE
fpkokeahef	TRUE
gjpenkljaj	TRUE
gjpmlffkgc	TRUE
hdohmmejff	TRUE
hdpbllgand	TRUE
hompnobfko	TRUE
honbkmganm	TRUE
iijlcckphj	TRUE
iijnnnchbk	TRUE
jchejcknfi	TRUE
jcheopoekg	TRUE
jlmahlkoln	TRUE
jlncdhdalp	TRUE
kgccfcbocm	TRUE
kgcicfpmdn	TRUE
lafojkoheo	TRUE
lagdinmihm	TRUE
lkjdmonobb	TRUE
lkjgpallio	TRUE
mejhglmnai	TRUE
mekngkbpjj	TRUE
moenociijd	TRUE
moeobdpmci	TRUE
njglhifclb	TRUE
njhpgpglhn	TRUE
ocpljfdafh	TRUE
odbincgajg	TRUE
omnccpmobg	TRUE
omndbgajji	TRUE
phcjefcpoh	TRUE
phdnhkhipo	TRUE
aaakpeihjo	FALSE
aaappokopn	FALSE
ajjllbdoai	FALSE
ajjpebpedp	FALSE
bfdhgehlaa	FALSE
bfdihhcdaa	FALSE
caenegnkia	FALSE
cafhkdijba	FALSE
clliggflaa	FALSE
cmaanbanbe	FALSE
dghkpmdbaa	FALSE
dghmffhfac	FALSE
ebdbnnmhaa	FALSE
ebfcelbpac	FALSE
eldnhadkga	FALSE
eleaceemee	FALSE
ffcioohiaa	FALSE
fffhgmikab	FALSE
fpneoipkaa	FALSE
fpnhkgkbaa	FALSE
gifihkgjaa	FALSE
gifijcooac	FALSE
hdoophegab	FALSE
hedkenkgac	FALSE
hokkacnmfj	FALSE
hoknlpecaa	FALSE
iipcjdcmab	FALSE
ijahnbmpmf	FALSE
jcfknooanc	FALSE
jcflgecoaa	FALSE
jmaicldchl	FALSE
jmbibpmlaa	FALSE
kgafmnkaff	FALSE
kgbabpilhc	FALSE
ladpfnhona	FALSE
laeaiodkjf	FALSE
ljebjedcab	FALSE
ljfmnknhab	FALSE
meeggojdaa	FALSE
meejpodoaa	FALSE
mogbieaeal	FALSE
mohcigpjac	FALSE
njgemnmiaa	FALSE
njgkphgnab	FALSE
ockgnhldaa	FALSE
ockmdfgdaa	FALSE
onioaiogdc	FALSE
onjcbilcaa	FALSE
phbgojpoaa	FALSE
phcfdchcaa	FALSE
addieedkdpl	TRUE
addimiooigl	TRUE
alfmhlihgfm	TRUE
alfmnkpfeof	TRUE
beedefnhkec	TRUE
beekneokkpe	TRUE
cahfghoplhg	TRUE
cahllmfeljm	TRUE
clhgmggffbj	TRUE
cliidmgklcf	TRUE
dhdolepahnj	TRUE
dhefnjppejp	TRUE
ebahgdfklle	TRUE
ebballgoipm	TRUE
ekehmicfgbp	TRUE
ekfadngkmfd	TRUE
feoomnngbfa	TRUE
fephpjchajh	TRUE
fphbbbbaigh	TRUE
fphjbdhmhme	TRUE
gjlbcmbnmok	TRUE
gjljdjolijh	TRUE
hdpcjdjiajp	TRUE
hdppdpcgafl	TRUE
homkdickggh	TRUE
honkcbpdeff	TRUE
iipikoffpha	TRUE
iipjakjhnil	TRUE
jclbcagnfmo	TRUE
jcllfpkcmkc	TRUE
jlnminlnpco	TRUE
jlodpgmfgfe	TRUE
kgfobnfmlcb	TRUE
kghfccakigp	TRUE
lakmfhedppd	TRUE
lakmloididn	TRUE
ljmbcpceaoh	TRUE
ljmdhnjhkeb	TRUE
mdnbiadidnn	TRUE
mdognohmbai	TRUE
modgmdbelag	TRUE
moebnkdgbah	TRUE
niffigkjmho	TRUE
nifgolbhcjp	TRUE
odbgfohkike	TRUE
odgcpmhlajf	TRUE
omhdnpogffg	TRUE
omiiejdjddo	TRUE
pfmpbchkfin	TRUE
pfpielfgfch	TRUE
aabckifkdoh	FALSE
aabfbniapin	FALSE
ajoajhfldpe	FALSE
ajohajecpak	FALSE
bengkaihcgp	FALSE
benoahmokma	FALSE
boogknjfbab	FALSE
boolbkeliaa	FALSE
cjfnndpgkab	FALSE
cjfojpahgfb	FALSE
deonciefnaa	FALSE
dfcggpfmfaa	FALSE
dokealbablb	FALSE
dokmkepfaja	FALSE
ejgoffnjhac	FALSE
ejinlcdclac	FALSE
fdagjipefgc	FALSE
fdcclcpedab	FALSE
fnmmfbijlac	FALSE
fnnhglcdmac	FALSE
ghgfkkgjnab	FALSE
ghgjddbddab	FALSE
hbdjjpigoab	FALSE
hbeehnigpac	FALSE
hlhopblkeab	FALSE
hlifjloelaa	FALSE
ifbnpijkkab	FALSE
ifdhdendeab	FALSE
ipkmoomakca	FALSE
iplmbdalahj	FALSE
jkhpodlljaa	FALSE
jkjglckfbab	FALSE
kelhekileab	FALSE
kemdnefmiab	FALSE
kolpbmjlpaa	FALSE
kondijgmoac	FALSE
ljkjcjlijab	FALSE
ljlomanmecb	FALSE
megnadmckhk	FALSE
mehjobjlgaa	FALSE
mojdhaeoacl	FALSE
momjahancga	FALSE
nicghhgfdac	FALSE
nichlmbgfaa	FALSE
obimeheeoaa	FALSE
obinggkdaaf	FALSE
olacchhlpil	FALSE
olafpgpikpc	FALSE
pgcnkfodnac	FALSE
pgdlcfeimac	FALSE
addjodinjhnh	TRUE
adefejpdgind	TRUE
akpkililpkji	TRUE
akplnpdpjhgl	TRUE
bepookiehndb	TRUE
bfbhfaidddph	TRUE
bpbeojphajfj	TRUE
bpbplgodglef	TRUE
ckelaffldddh	TRUE
ckfameipopno	TRUE
deiphkegakef	TRUE
dejohpcnllfi	TRUE
doppjffdcalj	TRUE
dpamodoiojee	TRUE
eingjdiageoh	TRUE
eioglfppahek	TRUE
fdgnnngdpcop	TRUE
fdhanhkmhpjm	TRUE
fnnaigikpoki	TRUE
fnnfbafknleg	TRUE
ghgicccahpng	TRUE
ghgmdepfefan	TRUE
hbdmjfendkmc	TRUE
hbejkejhgdao	TRUE
hknjhijbdmhh	TRUE
hkocmndhpgka	TRUE
igccoccjmkng	TRUE
igcieipakhnl	TRUE
ipjhnpfnniil	TRUE
ipkghehdjned	TRUE
jkchlbbmhhil	TRUE
jkdhmilbahfk	TRUE
kekjogineahk	TRUE
kelmdmmkejag	TRUE
kojannelklig	TRUE
kojnenjjfhkk	TRUE
limddikeeeee	TRUE
linldhaneiid	TRUE
meapdpeppion	TRUE
mebdlnjcbkih	TRUE
mofolbfdninm	TRUE
moibeoihanjj	TRUE
njdfhdmandnl	TRUE
njdnadloloep	TRUE
objgihiocnlo	TRUE
objljaigmoef	TRUE
olbjeandjhoi	TRUE
olbnfegpmbah	TRUE
pfghgodhodih	TRUE
pfgkcdeboafe	TRUE
aabckifkdohe	FALSE
aabfbiapinen	FALSE
ajnndehnjigb	FALSE
ajoekoknccal	FALSE
becfjpnjkeab	FALSE
bedkflcjdpaa	FALSE
bonggiaoclol	FALSE
bopllgaonlpc	FALSE
cjgolkbdbiac	FALSE
cjjenlfbccac	FALSE
dempeoclnfaa	FALSE
deohnblpnjaa	FALSE
dofggfhekiac	FALSE
dokgghlfcpac	FALSE
ejdljaoheeai	FALSE
ejdmnieliakb	FALSE
fddopmljciac	FALSE
fdemdenkilac	FALSE
fnnipmpcchab	FALSE
fnnnbdbdlhab	FALSE
ggngnehnigac	FALSE
ggnlmljkpfab	FALSE
hbecnimhbfaa	FALSE
hbenigkhajaa	FALSE
hlefddhldhaa	FALSE
hlendaahnbmj	FALSE
ifeobmfbgeac	FALSE
ifjfjigfnmac	FALSE
ipjcbgfpabnm	FALSE
ipjjpdngjiaa	FALSE
jkfjikpokdaa	FALSE
jkfpaleigjna	FALSE
kekiobdocmaa	FALSE
kelphljebeac	FALSE
koglkcafcdbi	FALSE
kohfjgdlfoaa	FALSE
likcaicehhhn	FALSE
limcdgkdpdaa	FALSE
mdnllocdiagc	FALSE
mdnmnbkfmjac	FALSE
mohecgcnapob	FALSE
mohlkhdgable	FALSE
niiahciejnik	FALSE
niidhkenlpab	FALSE
obefhocfdcac	FALSE
obeimlafidpa	FALSE
okofpekamndc	FALSE
okoppjgbccac	FALSE
pfhanbanafok	FALSE
pfiimclhcdaa	FALSE
addokpeldflpp	TRUE
adefhnofdfopf	TRUE
akpjkdofdpeoo	TRUE
akpkfpdfndgpj	TRUE
bdmogkbaogglf	TRUE
bdoapeinnjihm	TRUE
bncepfladnjll	TRUE
bncjkhlkpkihk	TRUE
chmecfpnjnaih	TRUE
chmojfiihmmei	TRUE
dcbdbhljjnjkj	TRUE
dcccccdpkmlbo	TRUE
dmdifddjljedf	TRUE
dmejhpdlfmcch	TRUE
ehcmbcgbbbejh	TRUE
ehcncgoilnmaf	TRUE
fcgbgnbchkobi	TRUE
fchlkgppeefpk	TRUE
fmnjbomnpcilk	TRUE
fmpcglhpbfmif	TRUE
ggjcckbeijlkp	TRUE
ggjkmflhchean	TRUE
hbpdonegcffla	TRUE
hbphikaliklmg	TRUE
hlcffnnegfpgp	TRUE
hleappkoeppij	TRUE
ifgohilfcgchl	TRUE
ifgpnegagedgf	TRUE
iplnakjmddphp	TRUE
ipmeeaiijdlgp	TRUE
jkckldghcfomd	TRUE
jkcledflodmlb	TRUE
kfdmhnlajpikg	TRUE
kffkgoiaglkeg	TRUE
lakigfndjpeon	TRUE
lalhhfhfmfofn	TRUE
lldcajmfegogk	TRUE
lldghkdmfgmpa	TRUE
mfeohklpmkgen	TRUE
mfiepmijilakl	TRUE
mpdphjcphpffd	TRUE
mpfokebmdgdmp	TRUE
nidhjnelknalj	TRUE
nidlgeafinfnk	TRUE
obidobpaifmli	TRUE
obipdbpohbagl	TRUE
olekmaokndffg	TRUE
olfdgghcpnpho	TRUE
pfpdmnokialjm	TRUE
pgaemnjjpejpj	TRUE
aaagfcfglonop	FALSE
aaclfpmeegmjb	FALSE
akbgphgccallh	FALSE
akcfcnllpmdpc	FALSE
bebfhkeaaebhn	FALSE
beebhmgihdjab	FALSE
bmmmnalaflhja	FALSE
bmohlaiifnfpc	FALSE
cibmhaaagiapi	FALSE
ciccipjlggoac	FALSE
dcmiicbbkalja	FALSE
dcmjfbclmaioc	FALSE
dmdljbklfkdac	FALSE
dmdnpldehkmaa	FALSE
egiebalcionfb	FALSE
egiipchppaoeb	FALSE
fcdkkljnghlaa	FALSE
fceohleikffab	FALSE
fmfffkiijccaa	FALSE
fmgdcldffmkab	FALSE
gibamihcajbom	FALSE
gicncilkcglab	FALSE
hbijdhoomhkac	FALSE
hbijkefmledaa	FALSE
hldplcbgplgac	FALSE
hldppmioffdab	FALSE
ifbdiiogoakpb	FALSE
ifbdnaolbmplf	FALSE
ipkmaecpnlgpd	FALSE
ipkookaigkacp	FALSE
jkckandinkgha	FALSE
jkdbklolcooac	FALSE
kfgpcdepfkkab	FALSE
kfinajbmbcdpc	FALSE
lakldblcfdeme	FALSE
lakppjdidobbp	FALSE
llaalfmfmiahf	FALSE
llafdkngaopoe	FALSE
mfckpiidcbjac	FALSE
mfddbiedkbeac	FALSE
mommhlodbbmac	FALSE
monlcmllpllac	FALSE
niiinmomadjeb	FALSE
nijdehhlikpab	FALSE
obobalifpblbe	FALSE
ocadbkpojhbih	FALSE
olfkkjniecgac	FALSE
olflhankddfnb	FALSE
pfjcjjphhihab	FALSE
pfkllcplecfab	FALSE
adeiefoimopfeg	TRUE
adgdhlejjkdgof	TRUE
amemkkfjkefonl	TRUE
amfeekonmgiggh	TRUE
bfbmeojkfjmmlm	TRUE
bfbmndpbpgdmgl	TRUE
bpkajffkfmnggg	TRUE
bpkblpehihmbbg	TRUE
ckeffofaplnook	TRUE
ckejkmfhomdlan	TRUE
dfclcadjgddjfn	TRUE
dfdekienbhnmka	TRUE
dphoigkbggjcph	TRUE
dpimooaignikek	TRUE
ekcdhlfgcgjeoh	TRUE
ekebjjpimpehma	TRUE
feidchadhimplh	TRUE
fejhmfhaoegdik	TRUE
fplmfkholelegg	TRUE
fplnjlhnoebind	TRUE
gjplggaiodngie	TRUE
gkbimagfpimhil	TRUE
hdfoepdldgaedl	TRUE
hdgilehkeolhhn	TRUE
hoimnkofkmpokp	TRUE
hojgkdecdnjflc	TRUE
ijlkfdafkepdng	TRUE
ijphchhggbfhom	TRUE
jehbfakokimhfh	TRUE
jehdgapiflpifo	TRUE
jokjajlihingil	TRUE
joldbemnpafdoo	TRUE
kigejbefanlfdd	TRUE
kiggegdniooflh	TRUE
lcnfionjakkplg	TRUE
lcpecnhlcdodjl	TRUE
lndlchdfkbdjop	TRUE
lnfebkbdnjiedi	TRUE
mgfhgaekihhdeo	TRUE
mghkpjfnhjnbig	TRUE
najdjemfompioj	TRUE
najfenegiefiie	TRUE
nkgflbepcingpe	TRUE
nkgikjofnaeogf	TRUE
oddakolfelgjhi	TRUE
oddbeccjpppanm	TRUE
onamonmfgonige	TRUE
onapejgglgndmp	TRUE
pgggamompkjdmg	TRUE
pggimijehbnkgn	TRUE
aaamodhkdgbkop	FALSE
aabbhhkhkaolln	FALSE
akfbgdomjkbdep	FALSE
akfmclkdlnhdac	FALSE
beengbdellkcac	FALSE
befcjfpdlikfaa	FALSE
bpipdgiimkppab	FALSE
bpkgmbgpeaoelb	FALSE
ckdahfhnlpgpcj	FALSE
ckemdefcdcbdac	FALSE
dffdigjmmmboac	FALSE
dffpbpgfbengac	FALSE
dpilmblhjifcab	FALSE
dpiokemmaonlnc	FALSE
ekckjahfnmoenb	FALSE
ekdkfifciniiab	FALSE
ffbidiclplemac	FALSE
ffbknbgbdeleab	FALSE
fpincdkjcadjga	FALSE
fpjklejpogppac	FALSE
gjecakklebpfco	FALSE
gjgfdkhfkdhpac	FALSE
heanmekegffeec	FALSE
hecbjlbemiceaa	FALSE
hojfjiealjhocg	FALSE
hojikoahihfgca	FALSE
ijpmilmhgiieaa	FALSE
ikaeeideaohihb	FALSE
jeapkonkibfgif	FALSE
jebgjjfcfpciac	FALSE
jofehmhajpbmmg	FALSE
johplpkkfphmaa	FALSE
khmpefkoljogab	FALSE
khnglaoajmakmi	FALSE
ldadnffkhlkhla	FALSE
lddmicnbbfhpac	FALSE
lndkhlpnieblac	FALSE
lneeedheehjfac	FALSE
mggmcminlhkmaa	FALSE
mghhndngeeaihc	FALSE
nabnaelkdhgbaa	FALSE
nacconidgppbhe	FALSE
njbphhgabhfeep	FALSE
njcalknpjfnhjb	FALSE
ocnmpgbjomkgab	FALSE
ocokjcpdkmbmab	FALSE
omgehealpbmdne	FALSE
omglfcihgahhcg	FALSE
phaoiooeojnank	FALSE
phbblbbejkmiac	FALSE
adedeljgoppdjio	TRUE
adejlodfeljmnge	TRUE
akoljgkdelinopm	TRUE
akomideipmmdlod	TRUE
bdpcifcpjifidce	TRUE
becdklnafjfgfmo	TRUE
bodgdofhfkahhnk	TRUE
boecpbnicmafjgf	TRUE
chnaegnfgjoddok	TRUE
chnaeonloodngmf	TRUE
dbnbphjjgjggcdp	TRUE
dbncbkhihgpaihp	TRUE
dmebjnoekopocen	TRUE
dmfeikbkckdoeah	TRUE
egnckoofeolapki	TRUE
egnpgebhmchlioc	TRUE
faifmleipknnidp	TRUE
fajgikhofmklmmd	TRUE
fkoilaggmlgklhm	TRUE
fkpadfllfhfeigk	TRUE
gehmfdihkjokgoo	TRUE
gehnkjifmffbfca	TRUE
gplglkjnooecbhk	TRUE
gpnfoppcamhmkdk	TRUE
hkkicjngedlpfae	TRUE
hklpcnpofdkeoeb	TRUE
iepninilfaifplp	TRUE
ifanddoephkkgpe	TRUE
ipmejjnhjgoijkg	TRUE
ipnjaphmggopefm	TRUE
jkcblcodoiepfak	TRUE
jkeajlnfelpmofn	TRUE
kemmaohikgejpii	TRUE
kemmidjgmhkjcbg	TRUE
kokkgjciiefjbbn	TRUE
kolddipjpphehoh	TRUE
ljfpjklpoapelgg	TRUE
ljhgamhmkehgkmp	TRUE
mdepeihcaifiopl	TRUE
mdfbdcamnmpkkmg	TRUE
moikhcbmiifepnj	TRUE
mokmldpnfnimamj	TRUE
njegcdbgemajfip	TRUE
njehbbffbdnofgc	TRUE
odmbjicaiimkjfj	TRUE
odmbkpmkmofidnn	TRUE
omhpadodhlmdkpk	TRUE
omikochfcghdehk	TRUE
pfmdobilmeppihl	TRUE
pfmpdhhgaofngml	TRUE
aaaelcbpkohfgfg	FALSE
aabnigbjjobhlli	FALSE
ajmihkhnehehjap	FALSE
ajmoihhdjipkppb	FALSE
begehjdhagoppca	FALSE
bemdpllfodchbac	FALSE
cakfjcbiaaogpee	FALSE
cakmjidcjejdneb	FALSE
ckkcjgifmdcfaae	FALSE
ckkpeeppdbpdcac	FALSE
dfbepgfocdefgaa	FALSE
dfcojclijllebab	FALSE
eabdagcdgkfehop	FALSE
eaehoalbjmjmfjp	FALSE
ejmmmlbomhcpgaa	FALSE
ejomnicaiglpnbk	FALSE
fdhhjpmfjimmcab	FALSE
fdicckfddblkoaa	FALSE
fopiojcifgnmiaa	FALSE
fpacnbbkfplionn	FALSE
gkoendgabkakign	FALSE
glbaomdmebbjdkl	FALSE
hecimbkgfgfacdl	FALSE
hedbjnlfbmhbhac	FALSE
hnfemjmocgbjgab	FALSE
hnfhajgaakgpbnh	FALSE
ihfljapdejhiieb	FALSE
ihjljkiknmhjjab	FALSE
jappdigejgemneb	FALSE
jbaanagmfempkbl	FALSE
jleafnejgkpnnha	FALSE
jlecjimibiikcab	FALSE
kflbifoepaemdkc	FALSE
kflcolmfkicceab	FALSE
lakjimecjnfilbo	FALSE
lalgmpbdbhmaogo	FALSE
lkaopanimgplfep	FALSE
lkbheajjbhjklmp	FALSE
mfjiiomjbfodgab	FALSE
mfkkieccdkmebaa	FALSE
mpjgffmlchocmab	FALSE
mpjgfiffgdcpafa	FALSE
nifbkaocpfkggfh	FALSE
niggbecdglfhgab	FALSE
obcgpoojlmeocab	FALSE
obcpkfpkahckafg	FALSE
oleimcefmnhelaa	FALSE
olekmpkpijhbnab	FALSE
pfkenfjhbifgpaa	FALSE
pflnahibholfecg	FALSE
addhjmlknmddmlji	TRUE
addhomopdgmlfmmh	TRUE
alfgdkhefhelhedl	TRUE
algddilmgemnokfj	TRUE
bfaeomlnoldeidde	TRUE
bfbeehpnomljmpig	TRUE
cakeppdhhdikljnm	TRUE
cakhegfhkgphpfij	TRUE
cknobmbccfjhkfec	TRUE
ckokhccbpkdllbpd	TRUE
dfcealgoohdjooee	TRUE
dfdfcccmpfbfagfe	TRUE
eadeofonkmjmlegp	TRUE
eadhjognflgflefm	TRUE
ekcmclehallfkkme	TRUE
ekcpipbgdoadihne	TRUE
febpcpnajnehfknl	TRUE
fedadeeodjkkeloe	TRUE
fpgiffhffihgmiel	TRUE
fphhopdaolmehgmh	TRUE
gjgfejecolbeagpe	TRUE
gjgfpfdebicjkefe	TRUE
hegbdfkekmgndnmf	TRUE
hehfmijalooimfon	TRUE
hnmcamnfljmilmpo	TRUE
hnmglkffakpgioeo	TRUE
ihdekfkjgijfjpkh	TRUE
iheeidclbbfdejjb	TRUE
jbdlkfciahijplkm	TRUE
jbeglbjeobblncja	TRUE
jkpnpgepfahppnkg	TRUE
jlahmgkdilgnodng	TRUE
kfimogfdhgpnaeon	TRUE
kfjffedohimekoej	TRUE
lalimmmjngfegepj	TRUE
lalpkldpdpmeojom	TRUE
lkmebnhokmookadg	TRUE
lkoicppklobinpbc	TRUE
mfijbcoekpndjdfb	TRUE
mfindphflokceooi	TRUE
mpephbmcgpfcdhgc	TRUE
mpfhcmgkbfhobibg	TRUE
nieagnmjdmokioep	TRUE
niehjeimlicaeihh	TRUE
obbnnkjpemdmglbo	TRUE
obbnnkliedhoclji	TRUE
okhlglgjbbjlandg	TRUE
okigbjpilciednje	TRUE
pfogkgcfdiaimoep	TRUE
pfpjknffmibafnij	TRUE
aacagkemfggmlmep	FALSE
aacepanjpebckobn	FALSE
akgfbahfnkoegnnc	FALSE
akghpegeljplmjgb	FALSE
bemcikipmigpoajb	FALSE
bemiiaiinaclodfj	FALSE
bpdddnfnfblgnoab	FALSE
bpdhapocihibfehe	FALSE
cjgkngcffeohniac	FALSE
cjhmhndlihdeoiac	FALSE
deececjaglnokjfa	FALSE
defjiifdcanjebnj	FALSE
dpboihologgojkaa	FALSE
dpcjenaekegldibc	FALSE
eigdhogahhpnjlda	FALSE
eihgmppjmfncpcaa	FALSE
fchimjgdgmibdiac	FALSE
fcjmghhplbcdbgac	FALSE
fmohofmkccdijmac	FALSE
fmomhmdaebhfafaa	FALSE
ggjhlfeijmflcoab	FALSE
ggkjbaljgeaklbij	FALSE
haoaopipmmghokah	FALSE
hapdjkpkgmoocmll	FALSE
hknmodcdldcemjab	FALSE
hkolaeoampelbegf	FALSE
idoiabboepefhmff	FALSE
idpppppfnohmlkac	FALSE
iopolehdonmbcdac	FALSE
ipacnooamiaglfoo	FALSE
jjcmplbcfklcfmaa	FALSE
jjdlajbmimaddlnh	FALSE
kddmjnehiddikmab	FALSE
kdeklccmjijbomac	FALSE
knfhokjnlabhfipl	FALSE
knjmnjbcfcfoaaln	FALSE
linebfinpbmafgga	FALSE
liodjbepbbfjooac	FALSE
mcphmhdpamlnhdjc	FALSE
mcpjiakahohahgbi	FALSE
mnipmcgdbdigmiaa	FALSE
mnipmfhicolkkbaa	FALSE
nhfonhnaijimlhnc	FALSE
nhfpjlhmlcddcbac	FALSE
oaiojekgmloobkab	FALSE
oaldlphcebbgmaom	FALSE
olkjidddndflnafb	FALSE
olldfenpmddaampn	FALSE
pfkefojdggcmldab	FALSE
pfkkhafgbdgedllh	FALSE
addhfodejlimfdiop	TRUE
addjhhfpdilkndlip	TRUE
almkonlgnedneikje	TRUE
amdfdkinhnpnooepd	TRUE
bfjijgdnanmlpikjg	TRUE
bfldfhiapnkgolmkd	TRUE
bpddgbfamkfjeplpm	TRUE
bpdglnlilheblbhan	TRUE
cidjefjnnmbiifgak	TRUE
cidmdagkedmdfjhjf	TRUE
dddnjllohhhcmlkfd	TRUE
ddedlmaeldgofffpp	TRUE
dojnedmmcennfmice	TRUE
doncdkkkhkdmogbem	TRUE
eihaeoehienhjlnnm	TRUE
eihggnemadgphfjjf	TRUE
fcfebflajmgmnpodf	TRUE
fcigeblhbnmgffnep	TRUE
fmjakoenfnhdhnpfn	TRUE
fmjklpgcljciiaogi	TRUE
ggkpihlliglbjkcnk	TRUE
ggnhjinddhaphhjif	TRUE
hapfgeffpeenhdgkm	TRUE
hapfglkjmpippljpk	TRUE
hkcmemmocmofjflnl	TRUE
hkddlhklponfindhm	TRUE
iehpmnpoiflnnlidg	TRUE
ieifbbkfdnffjokhg	TRUE
ioodiihdkjpbgfmpe	TRUE
iopbfmjblmpnggohb	TRUE
jjjblhkmakkfoeije	TRUE
jjjlmjbnnljjbbpco	TRUE
keakhliejfejnglhe	TRUE
keappkpmnfofhfjog	TRUE
knnbklcgmbjpkghkp	TRUE
knnhaejjlkelpekhi	TRUE
lhncoemhcokmhcold	TRUE
lhoginimajdnpnnnf	TRUE
mdllnddfiiljibfed	TRUE
mdlohcjcpcgnikgel	TRUE
moapnfdenoigomkoo	TRUE
mobedbeipoajgnhjn	TRUE
nhegeinecgeljjhjo	TRUE
nhehejhmkegpeoopn	TRUE
oakmnfijgljiienmk	TRUE
oalkefmhkkomgkjgk	TRUE
olcinaolnlfhpmjdo	TRUE
olcnknleligoejpld	TRUE
pfdekemdckbafojkj	TRUE
pfenllgcnolmoddjf	TRUE
aaaaoeagflecbdphh	FALSE
aaadmhdndifmaabgf	FALSE
akdmlpmmeklohgdjb	FALSE
akehldldoedhcbmbi	FALSE
bfpkgpbhcccgcbcab	FALSE
bfpljcdcbhhfhdbab	FALSE
bpogkkconfpepehab	FALSE
bppfgnfomhejfjiaa	FALSE
ciphghbdobgpgkoaa	FALSE
cjafjenaopajfmaao	FALSE
dcdbdoknkojdginac	FALSE
dcfacgakpnejmkjbf	FALSE
dmghidpnkbahkoikc	FALSE
dmghligpdojjdceaa	FALSE
egjpmaplolcebfafj	FALSE
egkfnplkjkhdaneaf	FALSE
epndedfolimdhcnab	FALSE
epngjnlbpnmohhpac	FALSE
fkebmimheaaokbkbj	FALSE
fkehedpjhebelamhc	FALSE
gehcjcobngopongab	FALSE
gehgaelkkdbbhcfjb	FALSE
gpifcpapfahpcfbap	FALSE
gpkmaejpikaglglno	FALSE
hjooekeklchconmab	FALSE
hjopfmhncodgnciac	FALSE
iffgkiofdhfbpahga	FALSE
ifhggacpehiajhlph	FALSE
japhpecngdnbnfdma	FALSE
japkomgllceigbkea	FALSE
jkicfdnfeinhmldab	FALSE
jkiikockbihimakha	FALSE
kdmeonjocahnhjamj	FALSE
kdmlcnoamhbaeenkd	FALSE
koiinfmdlmlgmigab	FALSE
koikneccmdebgacag	FALSE
limfhehlbcdjflgaa	FALSE
limjkponbchhfelac	FALSE
mcongacddccdphgin	FALSE
mcoogilfkbepagllc	FALSE
mmjpmanclmdhljfdo	FALSE
mmlloemekcengfkac	FALSE
nhdhnhcaijileknfc	FALSE
nhdoncejmmhgmdpac	FALSE
oapccffdljkgfijpd	FALSE
obbdgjjcjkmeiljab	FALSE
okjojcomkhofafeib	FALSE
okkblipdebfakgioa	FALSE
pfkgplajijnlggfea	FALSE
pfkoljbclgahcfene	FALSE
addfpkodlomnoomdne	TRUE
addgidpmiofdimfmdg	TRUE
alfkdmfdgidfpljnem	TRUE
algfhgggoppfejoikh	TRUE
beenpaofopphddnoeo	TRUE
begcoecakgfjjiejeo	TRUE
bndfaimieghgigedni	TRUE
bnecbdmodokfeifaod	TRUE
chebjmgmdmlclfhimf	TRUE
chejdhmhbajomgpdpe	TRUE
dbcjmddocbdobgnjjc	TRUE
dbdibbbahnidipnjml	TRUE
dmjapkimnidhpdpjno	TRUE
dmjkgkkoimfghginba	TRUE
egmcdciehkagjijfjo	TRUE
egmjhhmcgkcpboopjp	TRUE
fahmpkopkffdhjkdpf	TRUE
fahpfophlghggnpiin	TRUE
flgfjmfalngomefpih	TRUE
flhknaokjeplilopjh	TRUE
gfgkncadkeimogdmpp	TRUE
gfgpjopelfappkffnp	TRUE
gpbbekonlefkhmadlf	TRUE
gpbgipnjimgicldlim	TRUE
hjiiipogkhcflikjal	TRUE
hjjnnfgckklboheage	TRUE
idgdcdieogheobdifd	TRUE
idgelkhcjdmmmbkemo	TRUE
inhkkcpeceljpphoge	TRUE
iniadjjilpfnfgmnhh	TRUE
jichnllhknoapehioi	TRUE
jickffahggimnelfpi	TRUE
kbokolafioleeloiko	TRUE
kbpocinkakphendkig	TRUE
knegcmjofedopnjeel	TRUE
knfmbfikgjajhfjnen	TRUE
liiigngjeokcomjhif	TRUE
liimjjjkhdlggpmgoh	TRUE
mcnafhelofeopjgpej	TRUE
mcnakehoeliggijfnn	TRUE
mncmojgfbhjidmiijd	TRUE
mncocklcfjnhehmhlc	TRUE
ngiagopmikflhlgfkh	TRUE
ngjpfhiailjljfgigd	TRUE
obphfjgbinncocdebm	TRUE
obpifgdhgmpaiionho	TRUE
ombmhhogbjepkiipop	TRUE
ombnpobhhikeofodge	TRUE
pfjppajfljojdjimki	TRUE
pfmjkolbddnbicmdho	TRUE
aaadggbiikkngccfih	FALSE
aabdindblaldamekgd	FALSE
alajcdjcekglnjdcdo	FALSE
alcgenogijeklgphjp	FALSE
bfgcjbjipnbpcklpac	FALSE
bfhhcnnenhmdkmmhaa	FALSE
cafeapimmehpnbcddj	FALSE
cagcmfecfbomiafein	FALSE
cjollnhgjafpikhklc	FALSE
cjpkbaicaomfedhbae	FALSE
deoblkchgdggckdeab	FALSE
depphibiggojcgigac	FALSE
dphfkigomhocegbjab	FALSE
dphiafdafinpekampe	FALSE
eikeaekgodklkfmpjb	FALSE
eildlmngaajnbbhnjd	FALSE
fdiokekommccepipac	FALSE
fdjadljeelkfchdpap	FALSE
focimiejkcghjdjbac	FALSE
focinklflekjkimfaa	FALSE
giggjfedgjijainicd	FALSE
gihlapkldmoklomddc	FALSE
hdejcbgjobfpfdciaa	FALSE
hdfkhnobecanlfoblo	FALSE
hmcgldjnlmgioodiaa	FALSE
hmcojjigjdnoodfjaa	FALSE
ighdaedkfghjjbefhe	FALSE
ighgbefnhoononehab	FALSE
jbefjgeppobpjkniaa	FALSE
jbegjiflpfmfldfmac	FALSE
jkcccfjndnnndbjdaa	FALSE
jkcpgknfaoaajdfpaa	FALSE
kdbogjjoilkfjmebac	FALSE
kdcbajcfceimbldgok	FALSE
kmoaangaeamjifgpoo	FALSE
kmpcahabkcdbceiafd	FALSE
lhnieekinjlaadjepn	FALSE
lhnipodmcfeaidgepa	FALSE
mbpnokmegemhmnciab	FALSE
mcaojpjldgnmiidkoc	FALSE
mmiikdcnonpkdfcmac	FALSE
mmjdlhebghlcgonhaa	FALSE
nhfbfalmdginombfln	FALSE
nhhebhiclkocbafgcl	FALSE
obkjdmeaglocdkdkdb	FALSE
oblbnhbnfgnafiagfk	FALSE
olcoicapmikfndhdla	FALSE
olekfdiokcndhmbaag	FALSE
pfnkbpildlnmehlgac	FALSE
pfodknoflecbgcncaa	FALSE
addhepnmnngmkjgjlik	TRUE
addhmdknhhimkninoom	TRUE
aleldfjomjgnnfjkjkj	TRUE
alfimhenjoelkdodofm	TRUE
bepgljljaklmmikdjjk	TRUE
bepkcpoppennceklfei	TRUE
caijonkenpjfljlpmli	TRUE
caiofdnmggfkjmogldl	TRUE
ckeohdknpmbkpihamdm	TRUE
ckfhlocipenakolimjf	TRUE
dehncnahomflfomolpg	TRUE
deiphbkaeeffopmdome	TRUE
dpggadeopphogmidmgn	TRUE
dphdmmkfmfjkbmnmhpd	TRUE
eipboofhmppkpphjime	TRUE
ejbejkfhkggmlbdnofc	TRUE
fcnknhadjfdhfodjplg	TRUE
fcnkpiomcjfbiamnnhd	TRUE
fnlppkicfagdoooponf	TRUE
fnmpfedeeoeeblbepbc	TRUE
gidicgpfefbdonbcbdg	TRUE
gidomlolhofmhjobkph	TRUE
hdeobamkiklnkpkogkf	TRUE
hdfhcodcmaohdkeijml	TRUE
hmhglgklfonfanddofe	TRUE
hmhilchipnmcpmpcbcc	TRUE
ifplggbdhfakmhofnnn	TRUE
igaempmdimdknndoeln	TRUE
jandlngonfndikhljlg	TRUE
janefmifpgjejgonogm	TRUE
jjilcmobmpohcchngjl	TRUE
jjipcgnjamppnnlklog	TRUE
kcjhainmjjddjgdmlhj	TRUE
kcjlclhnifaddflopfn	TRUE
kmdkgpofjgdnpppmpdg	TRUE
kmeanpkleddkphkjnoj	TRUE
lglfjkjjhoiedgphnep	TRUE
lgloofocbbllfkjnhie	TRUE
mcggogeengdpahkhonm	TRUE
mcijclckdjjlmjcojpp	TRUE
mmkfhaeilllhefpjghn	TRUE
mmkiokmkonfjemjonhn	TRUE
ngkjddbagedhmfnejhd	TRUE
ngmddngcnccclhjkgpc	TRUE
obiddjppbaoohedphkl	TRUE
obijdplmidgjennbjho	TRUE
ollmgnbblgjdfpjcjof	TRUE
olmfjdmfojjlcomgkgj	TRUE
pflmfegincibpcckhce	TRUE
pflnjhjcdfoailhpnii	TRUE
aaabhiphehbcnkldfci	FALSE
aabnppgakijabkcfnoi	FALSE
akboildnjcfelfcapdc	FALSE
akcbcfmknkbafojgmmo	FALSE
beoidplpgmchobmjdac	FALSE
beooinnellfmndgfoac	FALSE
bpafibpmpfhapjoknkd	FALSE
bpagmggiaahnlfgpnbi	FALSE
cjghcnebliacmpgfpna	FALSE
cjgolfjfobhmpedppab	FALSE
deejjceofbkbcjekdaa	FALSE
deenpojkkddlfclmiac	FALSE
dojekjangmdkpkfljkc	FALSE
dokffgepojoekglmeac	FALSE
eihdbnkjcaphhmpgajp	FALSE
eihdcgcdpnccfajnofc	FALSE
fddibanedhocepgnjmj	FALSE
fddjhefhfobmpfbgeab	FALSE
fncckeeemdnlbggdpac	FALSE
fndcgdgkgbfinfonbac	FALSE
ggkiiphaeeenikicdcp	FALSE
ggllbpgeihimfbkkiab	FALSE
hbknabpdlbiojgfbfpe	FALSE
hbloneobdopfhfkjpab	FALSE
hmolinnkgifaeclbgcc	FALSE
hmopeeniahkppalemki	FALSE
ihdialgmfocnemdndgi	FALSE
ihdjfapaoaenhhiambk	FALSE
jbaclbdaehpndgccdmf	FALSE
jbbmopoecielapaafci	FALSE
jkkmanfapaakkhoiobh	FALSE
jkknkalnjmgcebhcgfk	FALSE
kdklcjclnogfecjjgaa	FALSE
kdkljonlnjghckmapma	FALSE
kobgbglmoailackkknd	FALSE
kocnmkdnpnagmhffjhb	FALSE
lihdkgpjfhlpdnainbj	FALSE
lihfhaohgmckeeikjpc	FALSE
mclcdfphieidmofkmab	FALSE
mcmdkacmihpklljgllc	FALSE
mmmllcppdofimfplgac	FALSE
mmnfhlfnpchnlanknjb	FALSE
nhalhmjojghemfamgil	FALSE
nhamjelmdpkcfojfiog	FALSE
ockkhjghobojpgnjgac	FALSE
ocllphnganhhmolppmb	FALSE
omolbfplpcjmmfgncac	FALSE
ompfnjheanfokdkdbhn	FALSE
pgehegoeanigbdnkbne	FALSE
pgehhbpchfoikfaneea	FALSE
