aacegngcpl	TRUE
aaedfofmoh	TRUE
albpffenno	TRUE
alcheemcom	TRUE
belfmmeihc	TRUE
bemjopgifb	TRUE
bockbddihe	TRUE
bockpmofah	TRUE
ciemimhidn	TRUE
ciendlmmcl	TRUE
dehlglllka	TRUE
deilljdbmf	TRUE
dojinhnkdp	TRUE
dokfagmled	TRUE
eikpohcmbd	TRUE
eilccmhpfm	TRUE
fdcnfnafje	TRUE
fdeopgnifh	TRUE
fnnngajbni	TRUE
fnocmkphji	TRUE
ghgoefdnba	TRUE
ghhegonhno	TRUE
haknehmlfg	TRUE
haknfkccaj	TRUE
hldjifpjma	TRUE
hldkfjikmo	TRUE
ienkpjbmad	TRUE
iepfddcoga	TRUE
ipcpkplooi	TRUE
ipffgpbbfo	TRUE
jjpbbcabcl	TRUE
jjpkccicgo	TRUE
kedmabijog	TRUE
kedncfnppj	TRUE
kniojcgdco	TRUE
knjdgkpalp	TRUE
linilbfcdc	TRUE
liohgdifmc	TRUE
mdhdllibck	TRUE
mdiggnnipe	TRUE
mpacgmhpbk	TRUE
mpajiennko	TRUE
nihlagmjfm	TRUE
niihdedfff	TRUE
obogadcckb	TRUE
obolagjcea	TRUE
omghnmnkee	TRUE
omgnnidhkp	TRUE
phjfklacih	TRUE
phkafdecml	TRUE
aacegngcaa	FALSE
aaepldfoaa	FALSE
alalodffaa	FALSE
alchikfbcd	FALSE
bfhfkidbbb	FALSE
bfiecckbbb	FALSE
boeclpidcd	FALSE
boeeljgbbb	FALSE
cimdooopcd	FALSE
cinaaggdaa	FALSE
ddggcfbdcd	FALSE
ddgkjcndcd	FALSE
dofdjlcdcd	FALSE
dohfaldaaa	FALSE
eipdkncdcd	FALSE
eipnpcdgcd	FALSE
fdglhmaaaa	FALSE
fdhjnfcdcd	FALSE
fnijkicdcd	FALSE
fnjijibbbb	FALSE
ghjpkbfbaa	FALSE
ghldkaadaa	FALSE
halnmkebcd	FALSE
hambclhfpd	FALSE
hlkfklcdcd	FALSE
hlkhjbjbbb	FALSE
ifogohcdcd	FALSE
ifpmljcdcd	FALSE
ipbnimobaa	FALSE
ipcdfhapcd	FALSE
jjlagjoaaa	FALSE
jjmgfobbaa	FALSE
kdmddcmdcd	FALSE
kdmeadpbcd	FALSE
knpepncdcd	FALSE
knpfahpaaa	FALSE
lijlgkabcd	FALSE
lilhhfaaaa	FALSE
mcobnfldcd	FALSE
mcocigidcd	FALSE
moolccabcd	FALSE
mopkhgcdcd	FALSE
njfknfbbaa	FALSE
njhfnnbbaa	FALSE
objjnbliaa	FALSE
obkbkegfaa	FALSE
ombpcpabcd	FALSE
omdpncbbaa	FALSE
pfheoocdcd	FALSE
pfhfcehdcd	FALSE
aaaiikjpoih	TRUE
aabhjcbobkc	TRUE
akbdgfpnenc	TRUE
akbpcphlcbn	TRUE
bddichceele	TRUE
bdepkienjgj	TRUE
bmbdnagmoge	TRUE
bmbkacedejn	TRUE
cfnegmajhne	TRUE
cfoaoggplkn	TRUE
damddgbjlda	TRUE
damjnbnooci	TRUE
dkmdpildfkd	TRUE
dkngfcmalgj	TRUE
eglpbhgnfdk	TRUE
egmfmafphfi	TRUE
fbcafdagaff	TRUE
fbcmehnmfhj	TRUE
flojpfalbgm	TRUE
flpbblmjhkb	TRUE
gggoneeikmo	TRUE
gghoncjpgch	TRUE
haoojoahoah	TRUE
hapogdhkefc	TRUE
hljojppailn	TRUE
hllgpfboihm	TRUE
ifiobcmhahe	TRUE
ifipanhbifm	TRUE
ipfpfkogeah	TRUE
ipgbimldoci	TRUE
jjhkbpnndcg	TRUE
jjhkonelhdp	TRUE
kcgjcdnfeoo	TRUE
kcgncojfoki	TRUE
klplibomkki	TRUE
klppppjghha	TRUE
lhhkmilhfea	TRUE
lhienkeajpo	TRUE
mcabphkddec	TRUE
mcahhggcggd	TRUE
mmfkeemejho	TRUE
mmiffjfbipe	TRUE
nhammiiecmc	TRUE
nhanjmanoad	TRUE
oaoknfeddhh	TRUE
oapejobhppk	TRUE
olldgmiglpb	TRUE
olnablkmiod	TRUE
pgbchpcnaop	TRUE
pgbdkapnknm	TRUE
aaahhjionha	FALSE
aabghjcbnbb	FALSE
akddmjlnbab	FALSE
akdmifkhbcd	FALSE
bdjohgogbbb	FALSE
bdkllnflbbb	FALSE
bmneinbkfaa	FALSE
bmnejobbeob	FALSE
cfofemikdcd	FALSE
cfohbojebbb	FALSE
dagclcoabcd	FALSE
dagehhkibab	FALSE
dldlfcapbcd	FALSE
dlebkpnlbbb	FALSE
efoaaphhlaa	FALSE
efoecnckdcd	FALSE
fbojndhabab	FALSE
fbpcljndncd	FALSE
fmdcabckjid	FALSE
fmejpoblbaa	FALSE
gggjdemcdcd	FALSE
gggjldfabcd	FALSE
hamdmikebab	FALSE
hankpiihaaa	FALSE
hlhnjnkcdcd	FALSE
hljhkcjjdcd	FALSE
ifgjomfaaaa	FALSE
ifgojonbbaa	FALSE
ipgaedfcdcd	FALSE
iphffeibbbb	FALSE
jilofcnhdcd	FALSE
jimjnjdaaaa	FALSE
kddoeappbab	FALSE
kdebnpdaaaa	FALSE
kmidnjnabab	FALSE
kmihbjccdcd	FALSE
lghbchmkdcd	FALSE
lgkihdfaaaa	FALSE
mbmahacgdcd	FALSE
mbmnlblphbb	FALSE
mmmmdjfabcd	FALSE
mmniaepdaaa	FALSE
nhaececahaa	FALSE
nhalejccbab	FALSE
oakofnhdaaa	FALSE
oambdkmhhcd	FALSE
olmhhgdcdcd	FALSE
olmpgglcdcd	FALSE
pfdceemedcd	FALSE
pfdcjjhodcd	FALSE
aabpebjmfngp	TRUE
aaccmamjiike	TRUE
alfgmfohfkfc	TRUE
alfpcalnkhkd	TRUE
bgdmbmfpefka	TRUE
bgdojmhbgmdp	TRUE
cbfbmcdomkjf	TRUE
cbgiflbbjjne	TRUE
clmkhhnbohih	TRUE
clnehefcfhld	TRUE
dhecgmhaegcp	TRUE
dhejcemcdlol	TRUE
ecagpeefdgic	TRUE
ecdjfdcojcgl	TRUE
elnchbbbiogg	TRUE
elnlilklbkdm	TRUE
fgdlmblmjjpa	TRUE
fgdmbcfcfdhk	TRUE
gaoaooclpgli	TRUE
gapeobmbbgao	TRUE
glhbmhlpdbki	TRUE
glhfcpdkhoke	TRUE
hfonjenmldmf	TRUE
hgbbgaebjmgk	TRUE
hpldpejfjcgn	TRUE
hpllflfebeii	TRUE
ijekkjkhhamf	TRUE
ijgageihpmbe	TRUE
jbppcbpbjlfa	TRUE
jcbfdhlihiol	TRUE
jlffgaaajflb	TRUE
jlfmnpbabmke	TRUE
kfmoololbjpn	TRUE
kfmpepliemjj	TRUE
kpaflpjlglif	TRUE
kpbeefglcnbc	TRUE
limapnjlhhpk	TRUE
linefemfecnf	TRUE
mdieoblmnkin	TRUE
mdifemakpjen	TRUE
mmmenlddaeeh	TRUE
mmmmpldkccgi	TRUE
ngeeiadpbcop	TRUE
ngfgaonegohi	TRUE
oamcobfdpajl	TRUE
oamgenkanpog	TRUE
okjlpkbnijib	TRUE
okkjjklhdddo	TRUE
pfjmcmcoahnb	TRUE
pflcalbecnib	TRUE
aabpebjmfncd	FALSE
aacckmapliha	FALSE
alekmmpkfbab	FALSE
alemiocpbecd	FALSE
bgalgbehicbd	FALSE
bgbbhmgkeddb	FALSE
cbgplcblijbb	FALSE
cbhcjdkjaocd	FALSE
cncobonffbbb	FALSE
cndeihailfcd	FALSE
dhbdfpofbibb	FALSE
dhbeagmlobab	FALSE
ebnlfdohjbbb	FALSE
ebnoeldalbbb	FALSE
emiohnkgbbaa	FALSE
emjolcofhdcd	FALSE
ffochnmcbdcd	FALSE
ffpnhfppbbbb	FALSE
gakhlfmaedaa	FALSE
gakjmfglajaa	FALSE
glamlebcjfjd	FALSE
glcknkjibbbb	FALSE
hffkbkkpabbb	FALSE
hffmnnelcdcd	FALSE
hpkihmjnbbbb	FALSE
hpkjobllcdcd	FALSE
ijajolkmlaaa	FALSE
ijbjpkakmbbb	FALSE
jblcmkcnbeaa	FALSE
jbngjdmjbgaa	FALSE
jlobmmfoebaa	FALSE
jlojbghoobaa	FALSE
kfijfcdoipcd	FALSE
kfkfolajkbcd	FALSE
kpbnmagbhabl	FALSE
kpccnbokpbbb	FALSE
ljbkangdebcd	FALSE
ljbpcdlmkecd	FALSE
mcniilbnkdcd	FALSE
mcnkfjciadcd	FALSE
mmoimgfbebbb	FALSE
mnabbbdhedib	FALSE
ngjbkmnhibaa	FALSE
ngkodecghdcd	FALSE
oaofdnhhoaaa	FALSE
oaopejdjbhcd	FALSE
olcnkeadcood	FALSE
oldefdhmcdcd	FALSE
pehgokbicbaa	FALSE
pehjeaggoaaa	FALSE
aaagbdkidgbhe	TRUE
aabcacoimicme	TRUE
ajihhkfokipbb	TRUE
ajiipjaammbgm	TRUE
beacngcmdfflf	TRUE
bebidehgmkjmh	TRUE
bpeeflecbaoje	TRUE
bpfekpipaidpg	TRUE
cjfoomjooadol	TRUE
cjgealibkdemk	TRUE
ddlfjkkaphmkp	TRUE
ddlghfcicnegf	TRUE
dmnfcldkadpma	TRUE
dmnjignocckjb	TRUE
efgogoihgaoph	TRUE
efgojnkemikei	TRUE
fabmaecejejjc	TRUE
facigfhgdpdph	TRUE
fkageobimlpbj	TRUE
fkajopcfpnijl	TRUE
gecmncdpfbeji	TRUE
gedfdjigngllj	TRUE
gomooppmgimgd	TRUE
gonadliifkgfi	TRUE
hjhkfmlfgpogj	TRUE
hjilpampfkajl	TRUE
ielhpdoejgobd	TRUE
ielmonoinglbg	TRUE
ipakmomaklhmc	TRUE
ipbcckjppagfm	TRUE
jjnbnljeioain	TRUE
jjnjgdlcfahea	TRUE
kelleddlpbphd	TRUE
kelopcmaepplp	TRUE
kpihdbaopdlja	TRUE
kpiilifniliea	TRUE
ljcongmcpfnej	TRUE
ljdpgigdgiffa	TRUE
mdfmafgoenbho	TRUE
mdgdakabhamkl	TRUE
mndendjleeneh	TRUE
mndlghomclpci	TRUE
nggpgbjlmlcle	TRUE
ngijckcbibmee	TRUE
oakpmflinadhd	TRUE
oalnddcdnkemc	TRUE
olfcffonfefkn	TRUE
olfpjimgplacm	TRUE
pfjfeofhmokbi	TRUE
pfjihhhojakab	TRUE
aaafacjhcfagd	FALSE
aabcaaplfjfaj	FALSE
ajhjifgocdecd	FALSE
ajiaabopennja	FALSE
beldfdfmdpbaa	FALSE
belggiiblnaea	FALSE
bpamgadlejjaa	FALSE
bpcdgjcijmcad	FALSE
cjdfdcmnifgod	FALSE
cjebpipjmbgbb	FALSE
dekgblipgnbbb	FALSE
dekkohconodcd	FALSE
dmjbmadfkoaaa	FALSE
dmkfflkcgpdcd	FALSE
egdmefhhobbaa	FALSE
egehhfeaejaaa	FALSE
fablaankjmogb	FALSE
fabnlhbogllaa	FALSE
fjkeilmndbbaa	FALSE
fjkhljoiobbbb	FALSE
gebefgpfegbbb	FALSE
gecjjejjbjbaa	FALSE
gofnfanpdebcd	FALSE
gohodjjjeaaaa	FALSE
hjabblgkpigaa	FALSE
hjajbmkodpmcd	FALSE
ieehglclcodcd	FALSE
ieheombdagaaa	FALSE
ipbkakcogfbcd	FALSE
ipdpbbpcceebb	FALSE
jjploobdonbaa	FALSE
jjppinglbgbbb	FALSE
kdijljijoaaaa	FALSE
kdjkeebdaoaaa	FALSE
kphknfmpmabab	FALSE
kpknfkpcbbjaa	FALSE
lkcihiichbdcd	FALSE
lkddhiccpgdcd	FALSE
mecmjddbedhcd	FALSE
medoheaihakaa	FALSE
mnbojcgabajga	FALSE
mnccejdfhidcd	FALSE
nhekliiidabcd	FALSE
nhgapidemmbab	FALSE
oahpmjdanfhaa	FALSE
oaiifeeijaaba	FALSE
okkiedgmdcdcd	FALSE
okknaamedacia	FALSE
pfkcmdmppjecd	FALSE
pfkibbdmmdibb	FALSE
aaacnifjbegnlp	TRUE
aaadhgfjecdicg	TRUE
ajooejnkalikln	TRUE
ajpdfoeoolfjjj	TRUE
bdcckafaiiclde	TRUE
bdcifgenadngia	TRUE
bmkihpkmpacekm	TRUE
bmkopgghjfmcbo	TRUE
cgajkknpoepace	TRUE
cgbecfkcogbhgg	TRUE
dambcohchepnem	TRUE
dapfgonpogfllb	TRUE
dkjijnmdhfbngn	TRUE
dkjkiofgnhkiga	TRUE
egmgmcgmkhmnhd	TRUE
egmnbmkdcgnajl	TRUE
fccpfbbidfpgjn	TRUE
fcehcgjdepfnkj	TRUE
fmphplamhjaogc	TRUE
fmpockbeokoeec	TRUE
ghmadolbeonpei	TRUE
ghncoliajihelh	TRUE
hbcgaagmompeli	TRUE
hbdmmncihdglpn	TRUE
hlomiojhdcknec	TRUE
hlpfndjcmdkbbl	TRUE
ignhinofbakkab	TRUE
ignomafnogiice	TRUE
jaibnnfnoljbgb	TRUE
jaieeedidfanjn	TRUE
jkcpjlcmojgdbb	TRUE
jkekjlfceknmgo	TRUE
kffgkfgegcjaln	TRUE
kffnafpdimckmm	TRUE
lbdaibiobcjlmm	TRUE
lbdbpphidolgih	TRUE
lkhkbbfcdbihhe	TRUE
lklggafooochbf	TRUE
memcgnbejhgadp	TRUE
memlgpblklcdnh	TRUE
mpcgclfccfmhek	TRUE
mpeajfgfkdoeje	TRUE
nkakfdhakicjii	TRUE
nkdnifbammpimm	TRUE
oeapoekdmllblh	TRUE
oebjniljgldgmc	TRUE
onopnidcmekdle	TRUE
onpieaiedijkgp	TRUE
pgjnlenbcfeokd	TRUE
pgkejbpghohdnf	TRUE
aaabnmheipadfm	FALSE
aaackopgfeidba	FALSE
ajmhfkncingdcd	FALSE
ajniilcbjdoecd	FALSE
bconcfcjjpfdcd	FALSE
bcpkbcldkahoka	FALSE
bmgbgpngnkbjcb	FALSE
bmghgpmplbfpaa	FALSE
cglgjcjbngaaaa	FALSE
cglmhmaihljdcd	FALSE
daimffidclhdcd	FALSE
dajkbhhemdhdcd	FALSE
dlldmcnjamkaaa	FALSE
dlmlkdpnmcidcd	FALSE
ehjpcfnoifedcd	FALSE
ehkmgdkclojdcd	FALSE
fcmfefdaclbebd	FALSE
fcnchagmnbaoib	FALSE
fmpijkepaedbab	FALSE
fmpphibbobgbcg	FALSE
gglfllcpaaiaba	FALSE
ggmaejchjimdcd	FALSE
haocjlkkkgpdcd	FALSE
haohlkgokppaaa	FALSE
hllaeilciealaa	FALSE
hllmapjmpnbhcd	FALSE
igjaeadfhppjaa	FALSE
igkjbcciajmaaa	FALSE
jamocfcdnjkicd	FALSE
janbhidplkniab	FALSE
jkkjdipmbbnada	FALSE
jkkndalcmejdcd	FALSE
kfmibjbkeicpbb	FALSE
kfmpmocglhldcd	FALSE
lbhajadmgahahi	FALSE
lbhhknignnnbaa	FALSE
llhpjjaniogaaa	FALSE
llibliipgmbcaa	FALSE
mfkifjffjjcdcd	FALSE
mfkjbgapdebbeb	FALSE
mpiegbepmfjbbb	FALSE
mpjfhcfccnndcd	FALSE
njijdkmejkbbaa	FALSE
njjabinenjldab	FALSE
odnckglbldjncd	FALSE
odnojekhaaokaa	FALSE
onpoflfhllcdcd	FALSE
ooakgmkoldlbcd	FALSE
pgbcfglalphdcd	FALSE
pgdemgcncaebcd	FALSE
aaachbfdongpdne	TRUE
aaadddcgdclbnmk	TRUE
akafcpmeddoelco	TRUE
akbehpamelcigee	TRUE
beckmokpnmpceee	TRUE
beddlbpahmmjcof	TRUE
boleaifncjmahgo	TRUE
bomcahpfodefkak	TRUE
cillnacidljnhil	TRUE
cimdogolimblbbf	TRUE
dcangaafbpejdcm	TRUE
dccfilielojmjla	TRUE
dnfdhblenfoegae	TRUE
dnfdlalppfdkmko	TRUE
eicbdagllekgbje	TRUE
eicepbjbbpjoeje	TRUE
fccipfpkhohbmld	TRUE
fcebhekmgomcfej	TRUE
fmlipgfnenicpgm	TRUE
fmnbbejbnpimmog	TRUE
ghfmemcfodbjhfm	TRUE
ghgclagaclcnfkj	TRUE
hbbcaomknikdofl	TRUE
hbbihkppkhgcaig	TRUE
hlgnocicngbbifk	TRUE
hlicolehdiadhdn	TRUE
igaalliipmaeiof	TRUE
igcldbinedobefi	TRUE
jbaehicnbiinghp	TRUE
jbebpcnnchicefn	TRUE
jlgdohpghpchhbe	TRUE
jlhfimiifmjjdbp	TRUE
kfkanihfnkcbjgk	TRUE
kfkgdbhhmikppab	TRUE
lbcbefhfdnjlima	TRUE
lbcgbbchgonogig	TRUE
lknielonbedkian	TRUE
lkogebdjpcbmjab	TRUE
meemkcmfkaajnpo	TRUE
meepnkfjkjmhham	TRUE
mohbineompoplol	TRUE
mohcmkchjnpilno	TRUE
nhnknbepejjdeeo	TRUE
nhoabidblkhdgkf	TRUE
obbhcnphaklpjki	TRUE
obcdepgfgphmkba	TRUE
okkbgmbmdcflcee	TRUE
okkbicidlopakcf	TRUE
pffjpiidmgggken	TRUE
pfggjddabpmofai	TRUE
aaabgaecnmfocmd	FALSE
aaacccbfcbjoalo	FALSE
akcbfgemkebjjbb	FALSE
akceegnkobijnab	FALSE
bdpphafinbpebhb	FALSE
beahbhajgpledka	FALSE
bogmekjkkkhpbaa	FALSE
bolkmaaopocacba	FALSE
cjidlbjanalfgaa	FALSE
cjjaedbkalmebka	FALSE
dcbdkjgpjljfgcd	FALSE
dcbpnngglehabcd	FALSE
dndidjaedighaaa	FALSE
dndnobllbmaaddd	FALSE
ehncimccppfkdcd	FALSE
ehnegficdhbhjcd	FALSE
fcdediihkkedbcd	FALSE
fcdgcbjlchjcfld	FALSE
fnbhipfpkhohbbb	FALSE
fnbmmldbhekmgaa	FALSE
ggniohlpmeoabcd	FALSE
ggnlnmpahfmpbab	FALSE
haomiknjplfpbab	FALSE
hapdaaglnbhoila	FALSE
hkpadcojfdnpjcd	FALSE
hlaegddebbaklmb	FALSE
ifbgpfjdaiceaaa	FALSE
ifcfihepgflodcd	FALSE
jbchmfknapcapaa	FALSE
jbclcaohefjndcd	FALSE
jkmmgbnpbaiogbb	FALSE
jkmoebjlojdabaa	FALSE
kfoeebdncjnaaaa	FALSE
kfokphoiianlbcd	FALSE
lbagikbipcnjbkd	FALSE
lbapebejchbepib	FALSE
lkjikcmeadamdaa	FALSE
lkjjoikdbclibaa	FALSE
melhmeeedohabcd	FALSE
melpibmepacbebb	FALSE
mokgdcedgbhnocd	FALSE
mokglilcobgkbaa	FALSE
nhhdjkigoigcdcd	FALSE
nhhekbnfjlilbaa	FALSE
oaoheiildhipaaa	FALSE
obajcangbjkdlcd	FALSE
oleifkngogmbbaa	FALSE
olepinoadbbbjdb	FALSE
pffehjbcpgabdaa	FALSE
pfffppoanamkjaa	FALSE
aadbcnklljfjnool	TRUE
aaedffjmfokhglkl	TRUE
ajodenjnilpooihi	TRUE
ajpdajnmlhpklcfm	TRUE
bedegpbennfkgnij	TRUE
bedilmfdnfnngeaa	TRUE
bojjfggjchbkjfec	TRUE
bojlfclacgekpmpp	TRUE
cjpceklbblncoegl	TRUE
ckaebbbkimjjgomp	TRUE
ddgckdcellbboimo	TRUE
ddgolgolomejhbkk	TRUE
dnlmnpakijpiapid	TRUE
dnmlpmmnfigcoiin	TRUE
ehegiaojdgfeocln	TRUE
ehelnkklaejonhoa	TRUE
fboabkcjjpmnmcmi	TRUE
fbpcmmagdcbkmlbe	TRUE
fnffcmdifjjphddk	TRUE
fngkmgafdkondcbp	TRUE
gibojgbaokbonimj	TRUE
giclfifkhfmgliee	TRUE
hbpikgaalhaldolc	TRUE
hbpilnekaobciiln	TRUE
hmeodldmbhollgki	TRUE
hmgodainfkbaoapj	TRUE
ihcdegmiacjknoka	TRUE
ihcnpnbalpojogpg	TRUE
jbpbadgbfmijkpfo	TRUE
jbpgpoimnmcdhhom	TRUE
jlleigldinlhmage	TRUE
jloendkalhomihhj	TRUE
kfghakcdkcnhflcm	TRUE
kfgjphjjepnkkcmd	TRUE
kopdlccoigjboceh	TRUE
kpafmbancaecnimc	TRUE
ljdcgebnjpmaboem	TRUE
ljdmmphhmfngipfb	TRUE
mcigfedkkocoecif	TRUE
mcjgojedghoolbbe	TRUE
mmmadgmlbhkfmink	TRUE
mmmajiejpgkahlic	TRUE
nfmhndhfgkfomjfd	TRUE
nfnmikoccfffojkd	TRUE
npbmaanbhomhdhde	TRUE
npcdancmmhkklafo	TRUE
ojpadpppmidfgpfk	TRUE
ojpcdpeifeliciml	TRUE
pfcjmgknnfhlnllk	TRUE
pfckpjfmickddglo	TRUE
aablhingdcnccped	FALSE
aackogpibdncjged	FALSE
aklphldoggambckd	FALSE
akmdnmlnonkppaaa	FALSE
bffahbcflkeelkcd	FALSE
bffjhgjnpnmmcbaa	FALSE
bpnafiijajdipnaa	FALSE
bpnhenhcjpbfnmaa	FALSE
cjmgjhmgiclfhdcd	FALSE
cjmhphfdiainnjcd	FALSE
ddajjikciojjbfab	FALSE
ddbhoipebphbaopb	FALSE
dnnhjfnciedakpcd	FALSE
dnoeaabjinihlchd	FALSE
ehidkfhbfcklgbaa	FALSE
ehjhkkebplldjbbb	FALSE
fbfbjgajopalphip	FALSE
fbfcjcfndnemngcd	FALSE
fklglbhojnfbhgbb	FALSE
fkmglnhibfdbjdaa	FALSE
gejdheipkaggiaaa	FALSE
gejhbofmnhnbhjbb	FALSE
gonppfjafgdekbcd	FALSE
goolbblfmnagemaf	FALSE
hjfoleokaoljobcd	FALSE
hjgfigpoiabelkcd	FALSE
icpnjjkcpmphedcd	FALSE
idbheekaaenciiaa	FALSE
imocnolnfjlbaaaa	FALSE
imokcklkbljcedcd	FALSE
jhkekdadffckedcd	FALSE
jhkklemajmilmbab	FALSE
kdepohpbeiogobbb	FALSE
kdgkffjlafembdcd	FALSE
kocaibdmefgngdab	FALSE
kodidamapbjaeehb	FALSE
ljkfiolacfijpaaa	FALSE
ljlblnllcemngdcd	FALSE
mdgogidniaphlbcd	FALSE
mdhdbibbmjdlehpb	FALSE
mmhfopcmmdnplacd	FALSE
mmhkaefniddcfbcd	FALSE
ngjkcbkdinjbblfb	FALSE
ngkdndgoobbanfla	FALSE
obgpghbepnihcgaa	FALSE
obhcgieemoclaaaa	FALSE
olfkfiemhpgmaaaa	FALSE
olgljhpdegbdgbbb	FALSE
pfdacfdnplehgfcd	FALSE
pfdmafhgijdgacaa	FALSE
aablhingdcoccflph	TRUE
aacpibdnckhfbnbkn	TRUE
akkohaoackcohgjkb	TRUE
aklcipbfamajkmejp	TRUE
bejdgjbgakibfdeio	TRUE
bekpedhlkbenhnmno	TRUE
bpkpnieaciningdic	TRUE
bpmojmcoanmgdipnj	TRUE
cjaffkbakpfoangml	TRUE
cjdannlhhleokdben	TRUE
ddffhibiafmaflfhe	TRUE
ddfljiifdnofiebac	TRUE
dnobdacdkfhbfclmh	TRUE
dnobgcmohlkkebpll	TRUE
egcjdficepgbmpfec	TRUE
egdglcnjlidpomein	TRUE
fanjholhlneipppnk	TRUE
fankdplambhmhjmdb	TRUE
fkjjnhobnphdgipej	TRUE
fkkcancabdfejcamf	TRUE
gegmpifpplcbahnll	TRUE
gehdnndickcmbpmgm	TRUE
gokeoodhjieloaoml	TRUE
gomapjbgpnhdnfdhf	TRUE
hjopnpmjfghjfkihn	TRUE
hjpfdcnacnaakjjkg	TRUE
ieckbepmmipnkjaab	TRUE
iecojddbjpapcfjkl	TRUE
imoochbjlbjalopip	TRUE
impokbjecocmkmmoc	TRUE
jhnagljkaeknjanol	TRUE
jhpocbdegabakkdmp	TRUE
kcpkilgdidjhgpoak	TRUE
kdaoncihkkkichgck	TRUE
koggpompmofccpmfo	TRUE
kogihpmomngkmmjga	TRUE
likbflohfegobioie	TRUE
likgohafhpacchlbb	TRUE
mdmlmodcokgodjmgo	TRUE
mdnhpknialelkoglk	TRUE
mmlbedkfmkmcolpjf	TRUE
mmmkjjclaajebkhon	TRUE
ngghjkaahgjopflei	TRUE
ngibmdcnmcfcljkpc	TRUE
obfigopohkpkcpiek	TRUE
obglghnbnmdbgjddo	TRUE
okcfjobbbpdeleldp	TRUE
okcflakppajedpgfj	TRUE
peigojfiolaccbgmh	TRUE
pejbphkbfilnhfccg	TRUE
aaadoocbmlpkcbgba	FALSE
aaapcdpfoncdjmjcp	FALSE
ajmaelhccpamgkiba	FALSE
ajmmmnmoabfdpjoaa	FALSE
befdnmomimbeompbb	FALSE
befliemljfpagmaaa	FALSE
bojhikojbdplefaka	FALSE
bokfklpgonlgfjbbb	FALSE
cjacbglddcjlbhhid	FALSE
cjajaejmbdidjnfcd	FALSE
ddjeohafdaknlkdaa	FALSE
ddkdnabpdilkagfeb	FALSE
dpckdiedmiboahkcd	FALSE
dpdhclmoendennkcd	FALSE
ejdfmphkeniddaaaa	FALSE
ejekaoalhekfojnaa	FALSE
feeakboeflfffoocd	FALSE
feebpaocgidbphgaa	FALSE
fnnedmbdhmbjnomaa	FALSE
fnomnbgbgoepmkhaa	FALSE
giimdclckdpfmlkcd	FALSE
gijadefpiofbfhhcd	FALSE
hdbcdgempfibbjlfb	FALSE
hdbfjoeiogbcnmhaa	FALSE
hnhmngmicipmdkgcd	FALSE
hnifgjpkmeginabcd	FALSE
ihnkonapeflgbdfab	FALSE
ihphoabcijmligamb	FALSE
jbcjappmnfelpkaaa	FALSE
jbddoolfhcpgbodaa	FALSE
jklfjedjnjlmmbbbb	FALSE
jknmengkmkjlhcdcd	FALSE
kfljiemkfhmlkaaaa	FALSE
kfllfbmljfeghebaa	FALSE
lacmldflhlaelmlaa	FALSE
ladeglklddidmfaaa	FALSE
llblgjhmjjdadlbaa	FALSE
llccjhfobcnhpldcd	FALSE
meapcbjnilkdddgcd	FALSE
mebfblcikcpakaidh	FALSE
mnplmgaminblikpab	FALSE
moaieieaamajjnfnf	FALSE
nigakbnfhifdapbli	FALSE
nigbodedhholnjbaa	FALSE
ochadcefjjidgbnem	FALSE
ochingclkkfimfdcd	FALSE
omolnicoekobhebbb	FALSE
ompbecblkelgjcgaa	FALSE
pgmdkcnmjfhfkdjcd	FALSE
pgnlnlambdkebdced	FALSE
aaamkgblnopfpjeckp	TRUE
aacgbgnaccimfefmcp	TRUE
ajpmdkmlhdghghjcll	TRUE
akaojkmjikcogadgjf	TRUE
bdoikhhmakpkgfjpgj	TRUE
bdoklgoaoeaokfifog	TRUE
bnncfhkfdonlnmcjji	TRUE
bobifmagnddhjpiien	TRUE
chhjilbcchifadbhkk	TRUE
chhnecmfmenbiddcbe	TRUE
dchoipgdmcebonnnlp	TRUE
dcipmhdekplhcopbfb	TRUE
dlnjchbdomecihpfej	TRUE
dlnmniigokajagddce	TRUE
efncgneohhgciapbgd	TRUE
efoadlmgkemmkgkanc	TRUE
epamnfjmfbfnpcpopl	TRUE
epbnbdmffmkbpgjejf	TRUE
fjnddalgihbleocihj	TRUE
fjnknjokmbaeknihmc	TRUE
geodaelfolfglmlgbi	TRUE
geodngojeiammcgllo	TRUE
gomhhnmnmopokkcbpo	TRUE
gompiiloijliplcigl	TRUE
hjpcfkjmjekbfepeao	TRUE
hjpcnkhpffoobdldma	TRUE
ifhccfnanpimcaleco	TRUE
ifhmdjmnleoeekkblm	TRUE
inpehbkggkjdommjmm	TRUE
inpooeadehaeplacco	TRUE
jihnnocpdhjdmkmbka	TRUE
jiihkjekiafmfieaok	TRUE
kchmfpcfcokjpfibon	TRUE
kchmimoahndgjbailc	TRUE
knmhpejdcokdbengga	TRUE
knmiojcfjjcljnaikc	TRUE
lhenfibkhiogcnlkcl	TRUE
lhgbghglmhjfhiileg	TRUE
mahdldjopkepllhbhm	TRUE
maicgnikfpclmflinh	TRUE
mlejgmiipnaicphkfo	TRUE
mlekkiddcjfhojcfao	TRUE
ngdjhikjogafbofkdo	TRUE
nggggdmoijpenjihek	TRUE
obhhipepifcoggmffn	TRUE
obidkdbcbeckjcagjg	TRUE
okpgmgkpigjbcnfncf	TRUE
okpinoafblnpeooeco	TRUE
penfglfkhabbngpnep	TRUE
penjlpanamgfbjakhd	TRUE
aabgbhbfagddcbmlje	FALSE
aabhhpenehinhfdpcd	FALSE
akgiaejhphdekbpjab	FALSE
akhkogaojneechnpaa	FALSE
beckmmlggkgaehnaaa	FALSE
beecbplljkempmipbb	FALSE
bolbaemlgbbpeacpig	FALSE
bolfbgekdfgbkcgenb	FALSE
cimebdjhkbmmonfhbb	FALSE
cimgfeamchfgoiibab	FALSE
ddbmijbfofamckghpa	FALSE
ddcbcdpeompboedjaa	FALSE
dmpolakbhnebobeeob	FALSE
dnaimlfgodeoiniaaa	FALSE
ehnognjnligagncaaa	FALSE
eicignfocemhmgbdcd	FALSE
fcaokkbdkjdbpnchid	FALSE
fcconmmfcgkpjkkdcd	FALSE
fmffbpnhkccadolncd	FALSE
fmgpinpgphknhhcdcd	FALSE
ghacciddkcinecebpd	FALSE
ghajinbdlncbhlanea	FALSE
haabofjpgfhaoomilb	FALSE
haalpfbkjeamignhai	FALSE
hkcnjahecnpjenidcd	FALSE
hkdjejgdlafdbmngcd	FALSE
iejgpldaapblfipfab	FALSE
iekeegebnnadkbaiob	FALSE
innjjahafdmhbdhkab	FALSE
inofmianggnlhfhaaa	FALSE
jhgbojfdfgghmmobbb	FALSE
jhghjomacfpanoeaha	FALSE
kbggaemheemjdcobcd	FALSE
kbhikafeahhdaghmja	FALSE
kmakpbcogopfaljggb	FALSE
kmaoocghbflhjdhhcd	FALSE
lgbnkihnhebhlohmbb	FALSE
lgcmhcdifpfnjfnfcd	FALSE
mbchogdcdkeehcgged	FALSE
mbcjkfgjnompcfibbb	FALSE
mlmclodmjjjpabnkcd	FALSE
mlpbaikgalommgfnaa	FALSE
nfhgmajpibchmbecld	FALSE
nfhnnhbpecelfbcgbb	FALSE
nokhbddfjlgkeembaa	FALSE
nomcpkdkgkidoccafd	FALSE
ojofjdknhjhldlbbbb	FALSE
okabolbkcbnemonafb	FALSE
peijnhilbgbmedncbb	FALSE
pejibfpddfhacgfdcd	FALSE
aabgbhbgaiffedonlgj	TRUE
aabhpenehinhfdpjgek	TRUE
aknffcmakhekdknfpka	TRUE
aknflfhomoekiglhlao	TRUE
bdpcngngekacfndoedh	TRUE
bdpkbehljjohiihmnal	TRUE
bnlgelidpphpkhbbfph	TRUE
bnmkddgbpcfcppodhph	TRUE
ciikgnekcicjcfdbobo	TRUE
cijbdhjbjfpieohkkbf	TRUE
ddgickmghfgmaamglkc	TRUE
ddgipbhepnfijoaoifp	TRUE
dmpcpjinfedkjhmnfle	TRUE
dmpmmlidoomkgfkjgfo	TRUE
ehlbleiihhfpkfplmbh	TRUE
ehljeijphmjbmeipena	TRUE
fbnaodkmaakfpnlbogp	TRUE
fbnmbcppoaoepopokoo	TRUE
flpolhfmeopfhjfgekd	TRUE
fmabfdhffndjboaelcg	TRUE
ghfibbppfajihfnhhki	TRUE
ghfiploodgpokmchaam	TRUE
habdjliahmjokmefcfn	TRUE
haciefcpghncianclip	TRUE
hkipbelnakgkembeofl	TRUE
hkjebbfldgjckemhnnh	TRUE
idnpmoejpcicnmcmchj	TRUE
idohdgelgmldpohlpbm	TRUE
inphmbgfhclheeiaepm	TRUE
ioaoongdgldlejjcjmh	TRUE
jibkogbpkkmbghpcnef	TRUE
jiblceimeddmkifijdc	TRUE
kbhjnnichoickpepack	TRUE
kbhkjagmnpjoconnpfb	TRUE
kmdndejoffbjckbianl	TRUE
kmeihammkegcecpjiea	TRUE
lgibggmhpohjhfdajmm	TRUE
lgkajbbogoejhlgcoal	TRUE
malppjdklpfebcckbgm	TRUE
manejmedknlmijkbaig	TRUE
mljhoamjledoefgdakg	TRUE
mljnhojdmepebheknjm	TRUE
nfkkbjecjboamicckoo	TRUE
nfkoabhdoijfohkilib	TRUE
npbbgjgfankdfpmjdbc	TRUE
npbmnmeklilnenpmoco	TRUE
ojdhkieglmkkefiodkk	TRUE
ojdkckiopgagfcckpig	TRUE
pepklcpdkkjgjfdodol	TRUE
pfaabfjmdlnkongakep	TRUE
aaaogejonjmbbfpenea	FALSE
aabkbcofghihbmocben	FALSE
akgelpckdlchegjmdcn	FALSE
akihgehfakjgnemkeaa	FALSE
behcdmoaenojkekpdcd	FALSE
beionijopllgidhpbaa	FALSE
caaagldjjejmkiiiica	FALSE
caachhdnkkgddfepjaa	FALSE
cmjjejmkcjmfcnagaaa	FALSE
cmkiamljcdkokiipdcd	FALSE
dgldmapnjnhcdjgjkcd	FALSE
dglfkianhhbnkeekiab	FALSE
ebfglaioblfjlokomcd	FALSE
ebflgabnnnkenmgjada	FALSE
eknigkbkkgnkjpjdbaa	FALSE
eknljcoeepecjdfdgcd	FALSE
fedglhbmgcgicgbbdkb	FALSE
fedjnjmajhnhjmjjbcd	FALSE
fokijnpiohnhopkcdcd	FALSE
fokkcbbdbpmnehidocd	FALSE
ghihlhpcnekglbfhdcd	FALSE
ghinknlelfbohfhobbb	FALSE
hbgbbjlmpmicdjjjidb	FALSE
hbgniooohlpncnlndcd	FALSE
hlomhhcobogkikjcbbb	FALSE
hlpblnabfogbcdijhkl	FALSE
igicojolaphbinplhcd	FALSE
igihgbdbbgdghmpjbjb	FALSE
jaloloofdjniaekmnaa	FALSE
jamhefeibcodifgpmkh	FALSE
jmaampidndiheodbpcd	FALSE
jmaanppcjgoeiaddiba	FALSE
kfgnfpkooeoacmbgaaa	FALSE
kfifkckecbglgjmcbaa	FALSE
kpclmfondineljclifd	FALSE
kpcmbgfhmgkaadjicld	FALSE
ljlkjmlgeomhmcbmbaa	FALSE
ljmapcpohhnhchgjdcd	FALSE
mefbgkhcbnhhdfhkcfd	FALSE
mehhaahephbaphkopeb	FALSE
mnoanndpmdhaighelaa	FALSE
moccgkificjghafjdcd	FALSE
njpoiaoapcimbhcbnld	FALSE
nkbgemkfniobfeajgla	FALSE
oeafnhfhniadeahkbca	FALSE
oebdbaphfcmlcjpcaan	FALSE
omkjbaggmibpnhhhjaa	FALSE
omljcnojddiihmlchid	FALSE
pgklggbfjmigdmeebbb	FALSE
pgljnejiehgfkembbbb	FALSE
