abbcdkgfbe	TRUE
abbinobbnm	TRUE
akonjfnhpc	TRUE
akpciechbf	TRUE
beolpmmcfc	TRUE
bepefdlenp	TRUE
bpnkdclebp	TRUE
bpoiajbjhi	TRUE
ckepljepie	TRUE
ckfjfbohhb	TRUE
ddilhnbmfc	TRUE
ddjfaieijl	TRUE
dmpndaofoc	TRUE
dnbnjacioj	TRUE
egihdkfcgo	TRUE
egjfbgpknh	TRUE
fbgebcdhbg	TRUE
fbgjcnfcjm	TRUE
fljpbjekkg	TRUE
flkgdbcnan	TRUE
gfjohoogkc	TRUE
gflekkegho	TRUE
goojhfbpbb	TRUE
gopelagdbp	TRUE
hjfacpecnp	TRUE
hjggghclhm	TRUE
ieclikkiij	TRUE
iecmeemoad	TRUE
inklgeecja	TRUE
inkoejbblc	TRUE
jjdmeolpci	TRUE
jjecogepoa	TRUE
kdllielfjl	TRUE
kdnhgclaob	TRUE
kogfmpeagb	TRUE
kohmccfejn	TRUE
ljicmnedbp	TRUE
ljiedcohld	TRUE
mdjlclgdpg	TRUE
mdjphpjngo	TRUE
mmofialnlp	TRUE
mmpflibggo	TRUE
nhhcpmjled	TRUE
nhicfcahbg	TRUE
obdmbpadln	TRUE
obenofpahp	TRUE
olgkdijbpf	TRUE
olgpemllcm	TRUE
pfkogjmicg	TRUE
pfkomjeini	TRUE
aaaiifahbh	FALSE
aaanhjnlld	FALSE
akippiikma	FALSE
akjcneflea	FALSE
beifjkoeaa	FALSE
bekbehcdaa	FALSE
bpnhagjaag	FALSE
bpnmddciaa	FALSE
cjooaojfpa	FALSE
cjphgahaon	FALSE
ddimabipca	FALSE
ddjngckdaa	FALSE
dnbipjglaa	FALSE
dndedfnlaa	FALSE
egpodlfmaa	FALSE
egppaajimo	FALSE
fbgbihmmaa	FALSE
fbghmfidaa	FALSE
flbpligdaa	FALSE
fldjmlgeaa	FALSE
gfgcdnlcaa	FALSE
gfghhbonaa	FALSE
gpjcmlaakj	FALSE
gpjkfmaofa	FALSE
hjodkkckaa	FALSE
hjojiomdaa	FALSE
idphgfadka	FALSE
idpnjjnfaa	FALSE
inpfpnfaca	FALSE
iofcnpljaa	FALSE
jiliciigaa	FALSE
jimcefplaa	FALSE
kedmifdhaa	FALSE
keehflpbaa	FALSE
kojbakihda	FALSE
kokedgpnaa	FALSE
ljcpkoenaa	FALSE
ljdfdninaa	FALSE
mdnfgcfkaa	FALSE
mdoadmpfga	FALSE
mmomehocaa	FALSE
mnaccmgkca	FALSE
nhgblpciaa	FALSE
nhiieldmaa	FALSE
oankmahhje	FALSE
oanpdgffda	FALSE
oldpfkbeaa	FALSE
olfichkjaa	FALSE
pflaemaaek	FALSE
pfmhbiajah	FALSE
abbijmgippm	TRUE
abbmjkmeojn	TRUE
akknpkioomi	TRUE
aklfcdbnlpi	TRUE
bejjmkdbjea	TRUE
bejjpccchjl	TRUE
cabhnjmgcid	TRUE
cablgilbgcl	TRUE
ckajddjmlkp	TRUE
ckbfgodfjea	TRUE
denadifghnf	TRUE
denjmmeakch	TRUE
eaegmkeekcm	TRUE
eaghegikbpb	TRUE
ejjgbmefbjm	TRUE
ejjhkbednii	TRUE
fcigjiocmpd	TRUE
fckfjfacmnf	TRUE
fmlmgoeehei	TRUE
fmmnalfphee	TRUE
ggeegbnlelo	TRUE
ggegekejchn	TRUE
hbcaibecfgg	TRUE
hbcbijpfhai	TRUE
hlkiomaclpg	TRUE
hlkngikggff	TRUE
igpagdbndgf	TRUE
igpginiilca	TRUE
japhdconomg	TRUE
japndojnhcb	TRUE
jlokbjgnnmp	TRUE
jlookkdpbbl	TRUE
kfnofieohfe	TRUE
kfpeakmmlig	TRUE
kokaclocbjd	TRUE
kokgengaenk	TRUE
licgkdhjeph	TRUE
lidilomlijh	TRUE
mbjjmhnlkfg	TRUE
mbmednphlno	TRUE
mlgchfacleo	TRUE
mlgjacjedcd	TRUE
nfnefoiepja	TRUE
nfpjeoajkgo	TRUE
obcbnbcoghj	TRUE
obcmfgjjefe	TRUE
omcepmbbend	TRUE
omdjmbboajj	TRUE
pgelgeidjii	TRUE
pgfaimgohdl	TRUE
aabmjaaeenl	FALSE
aadnbbfkhli	FALSE
akdohbpaamn	FALSE
akgcmofhcga	FALSE
bepnibbpkaa	FALSE
bepnkkaggca	FALSE
caajalnnofk	FALSE
caakdnhplkg	FALSE
ckoclibdlaa	FALSE
clapmbkiagn	FALSE
dfhplokooaa	FALSE
dfijedohkaa	FALSE
eahahkokgln	FALSE
eahcijgfmla	FALSE
ekaedmhilda	FALSE
ekagekennha	FALSE
fchhighbpaa	FALSE
fchhmkdolaa	FALSE
fmhbcagjban	FALSE
fmhcllejmaa	FALSE
ghaijiijkja	FALSE
ghaipknnhpa	FALSE
hbkgllahmea	FALSE
hbkgohlhkaa	FALSE
hmkialmoamg	FALSE
hmleahhaccp	FALSE
igekmjagkfa	FALSE
ighipnfieaa	FALSE
jaifcccpifa	FALSE
jajecciieha	FALSE
jmecmopbfaa	FALSE
jmghadahmjp	FALSE
kgecbfmjjaa	FALSE
kgeedphebaa	FALSE
kooaegpnmoa	FALSE
koodldmjjaa	FALSE
likkojcmgaa	FALSE
liloicfkjaa	FALSE
mbhgngaigma	FALSE
mbhlhhaipla	FALSE
mldmdgckjaa	FALSE
mldpliflpaa	FALSE
nfdhoioomaa	FALSE
nfdkcekflaa	FALSE
oajbodpdkla	FALSE
oajdhikpbca	FALSE
omilcfekoaa	FALSE
ommhopfanpa	FALSE
pfjpjlledaa	FALSE
pflfnijlpaa	FALSE
abbijmgippmj	TRUE
abbmkmeojnjj	TRUE
akmljkpbnmgk	TRUE
akndplheghch	TRUE
bfanfcefkemm	TRUE
bfaoefnkfkjc	TRUE
cabcmehedfpi	TRUE
cabeollgflei	TRUE
ckmdbokibhip	TRUE
ckmjioocmhdk	TRUE
dfjikocgehbj	TRUE
dflecimpcbdb	TRUE
eaehgkdbdidn	TRUE
eaejfkcmicbb	TRUE
ejgdonbaldmi	TRUE
ejjfdacppjbi	TRUE
fcoaoikilofd	TRUE
fcohfgcofkfk	TRUE
fmhjhloefgdk	TRUE
fmhkcncdokam	TRUE
ggnbhmbjijnk	TRUE
ggngmjnmmema	TRUE
hbphkjpbokga	TRUE
hcbmiccfppkm	TRUE
hmejggjgdfni	TRUE
hmekeddbagdl	TRUE
iggfdcjllghl	TRUE
ighdjadigild	TRUE
jalccdjbfoll	TRUE
jallcejkhdpn	TRUE
jmamhocghfci	TRUE
jmbhamjjmeec	TRUE
kfjnihbcdhkb	TRUE
kfkbgbhmhgdo	TRUE
komigjpfcgce	TRUE
komjfcbnbooe	TRUE
lihbmeplfhcc	TRUE
lihibgngolkf	TRUE
mbgondgkopmg	TRUE
mbinnemjpngg	TRUE
mlalffpomkfn	TRUE
mlbnoednajgk	TRUE
nflbcofbieki	TRUE
nfnljpiknfbl	TRUE
obakhcjhdhjo	TRUE
obbmbikbbgcb	TRUE
omgomlgjfbfh	TRUE
omhpkhfadmko	TRUE
phdmddobhadb	TRUE
phebeagimeec	TRUE
aaaeamhlipfe	FALSE
aaagjhmodjan	FALSE
akhlcokpghba	FALSE
akihlapealcg	FALSE
benloggeekaa	FALSE
beogojcljlaa	FALSE
caomhigkhgag	FALSE
cbapngegjpla	FALSE
ckfclhofcbaa	FALSE
ckhjppdlbiaa	FALSE
depnlbmhofaa	FALSE
dfabdlhefeba	FALSE
dobffldohiaa	FALSE
dobibioodoaa	FALSE
eikmhmpbmcaa	FALSE
eilgboofehaa	FALSE
fddoiahhnadm	FALSE
fdedojpdohaa	FALSE
fnikgdojfdaa	FALSE
fnkjaaaghoph	FALSE
ghlednickada	FALSE
ghlhgegaihga	FALSE
hajpbpgkfoea	FALSE
hamkdikefkfa	FALSE
hkjaioknlhpa	FALSE
hkjliblklfaa	FALSE
iegjahmccfia	FALSE
iehalnplaaag	FALSE
ioojhadklifa	FALSE
ipbgimlepoaa	FALSE
jjlpnnpgnjaa	FALSE
jjmndncikoaa	FALSE
kclimhaimcma	FALSE
kcmmobmomcaa	FALSE
kmnbglhbbkaa	FALSE
kmnbldnaldpa	FALSE
lgffkjipfjaa	FALSE
lgfknhacjkfa	FALSE
mahimjnepgga	FALSE
maiamjciiphd	FALSE
mkckiiaigaok	FALSE
mkdnlihammla	FALSE
nejhoolenhaa	FALSE
nejjoobddnaa	FALSE
oacdjkmfpjoa	FALSE
oackpdoofaeh	FALSE
olgnfidjpaja	FALSE
olgpokooeaca	FALSE
pfffechpomaa	FALSE
pfggdkkmnana	FALSE
abbceegnopipp	TRUE
abbeckjnjlnjj	TRUE
akgdjembkejei	TRUE
akggjknilphjj	TRUE
beonplmmkjnop	TRUE
bepadjbkndeei	TRUE
callbejofhddn	TRUE
cambkjencjdme	TRUE
ckiofbjmojcoa	TRUE
ckjajppcnmpdj	TRUE
depgbochekijo	TRUE
depknkpagjfdj	TRUE
dohkkgoagpjoc	TRUE
doidflbclbngn	TRUE
eimdfhnjpldle	TRUE
eimdimcdladie	TRUE
fdjcfofeahlno	TRUE
fdjganblnkled	TRUE
fnmlgjjhkngck	TRUE
fnnecagpcoike	TRUE
ghlcdfokfgmjk	TRUE
ghmgdbjbkhmkb	TRUE
hapngchkpekbk	TRUE
hbciiolgmnako	TRUE
hlhkakcdbbffh	TRUE
hlhmdpcdlgmdd	TRUE
iejamkcigloce	TRUE
ielimagjfhmll	TRUE
iopbcipgmijkh	TRUE
iopjbjepmbipm	TRUE
jikolofmgadmp	TRUE
jilgndmnlnpki	TRUE
kcclmigikncfj	TRUE
kcdajhdlphfbl	TRUE
kmgghefpbpoom	TRUE
kmihdfmdckpej	TRUE
lhajpjkifppfl	TRUE
lhbjljehgdmdl	TRUE
mancpphicllhp	TRUE
manoekidbjgdb	TRUE
mkkjclahhijnh	TRUE
mkkkgackhcbbb	TRUE
nekmcdmflmnem	TRUE
nelejlnbobjmg	TRUE
oaecdnbkffcof	TRUE
oaednengobjje	TRUE
okfimdbkjcfho	TRUE
okfknkeopegck	TRUE
pfohkmjnkmdjo	TRUE
pfplbipcbfimh	TRUE
aaaomijknngii	FALSE
aacbkeacjdaaj	FALSE
ajocbabeklmhm	FALSE
ajohfonkifmma	FALSE
bclobildmggaa	FALSE
bcmhgcpfepfaa	FALSE
bncghecbegjaa	FALSE
bndfidccbpcaa	FALSE
chaakafnnjpcc	FALSE
chakkbghjegha	FALSE
dakijilmlccoa	FALSE
dalehekgpdpia	FALSE
dlncnbcogpfaa	FALSE
dlnljhhgpnfaa	FALSE
egekolllfhlaa	FALSE
egelodohhggaa	FALSE
fanfhlejbchda	FALSE
fanjgdidkohja	FALSE
flcobnojhicaa	FALSE
flddmliciekaa	FALSE
gfmjlhbigmgaa	FALSE
gfokchfcjapia	FALSE
hapeoaceofddc	FALSE
haplpmaocgfpn	FALSE
hmkmepooiehaa	FALSE
hmlgicpodioaa	FALSE
igjmmnannpoha	FALSE
igjponpakalnc	FALSE
jaikfiinffdea	FALSE
jaimoekdlfamh	FALSE
jkcmeiddlmeaa	FALSE
jkejlknidmjaa	FALSE
kdmmolihhjhaa	FALSE
kdnilpiijdmaa	FALSE
kpaaahbcfijil	FALSE
kpadidmhjhdda	FALSE
ligepgdbgnfaa	FALSE
ligmdepcmafja	FALSE
mbdghemjcfapa	FALSE
mbeahdbaaljmj	FALSE
mkkjnmcamdnga	FALSE
mkkonfgbaalbf	FALSE
neopbcddkjhaa	FALSE
nepjifcaplbna	FALSE
npopikjdmhgaa	FALSE
nppjoljdfghaa	FALSE
okfbgbjicpdaa	FALSE
okfiecnhgeaka	FALSE
pgenlololmjaa	FALSE
pghdjljopjoaa	FALSE
abbfhldfjfpfnk	TRUE
abbfjciefibdkn	TRUE
akedclkcifncci	TRUE
akeonnledjbegn	TRUE
bcohoadlphdgbj	TRUE
bcomamkbjopiei	TRUE
bmmpgbeieaphdi	TRUE
bmnjlelcadnmcl	TRUE
cgadfgdiccfkhc	TRUE
cgbpjgffaebpji	TRUE
daillgjclobcok	TRUE
daklfihidcpfml	TRUE
dlolccodnjlmph	TRUE
dlpbjlikbpefmb	TRUE
egnmicjldcioki	TRUE
egolconjddjnjp	TRUE
fakikbjkdgknjh	TRUE
fakkbginijenjf	TRUE
fkpmbkpjkkpimm	TRUE
flbadlmecohbin	TRUE
gfjggkneckging	TRUE
gfjkdfbfodbaen	TRUE
hbcdblmdebijid	TRUE
hbddppgiadjdgo	TRUE
hncbhcajkijknk	TRUE
hncibcooijbacb	TRUE
ihmfceclecjkbh	TRUE
ihpikkaggpfmbl	TRUE
jalekdogkbekbl	TRUE
jalgfpfkdpiiml	TRUE
jjpldoldijfdej	TRUE
jkambhojhopdob	TRUE
kdilejkjeojmlj	TRUE
kdjdbjbndecnfp	TRUE
kohahdkfgnjold	TRUE
kohnackgiookjd	TRUE
lidbdfgladdgfo	TRUE
lidbfngoniadcl	TRUE
mbhgpahjfjncfn	TRUE
mbhlcegkjidbdk	TRUE
mlbfdgfpohlnmc	TRUE
mlcbidpdbkibpb	TRUE
neobnenmmojmnh	TRUE
neocblpmmhpcjd	TRUE
npmnaeniichlhp	TRUE
npnefboppfbbnk	TRUE
oknknlbgodkadm	TRUE
okofpnhfcjdkii	TRUE
pgeniacfcidmpc	TRUE
pgganohkghkpeb	TRUE
aaahlpgjplhkdl	FALSE
aaaibenbndifbd	FALSE
akdieiaemkjdfa	FALSE
akdnebjfkmimoa	FALSE
benlehclclgoaa	FALSE
benokmbfijplaa	FALSE
bocdmedenohnaa	FALSE
bodjphpgdkjfaa	FALSE
cijgfhhnkjfbaa	FALSE
cijjfpenbngeaa	FALSE
dddcmnpoclgcaa	FALSE
dddeaombldidpa	FALSE
dnnjpefjmoilaa	FALSE
dnpomdbhgceiaa	FALSE
eicbfcknedibaa	FALSE
eicikcllpleaca	FALSE
fcjeafckjcplea	FALSE
fcjhoiigedkdaa	FALSE
fmobddnloamfca	FALSE
fmojmhdkfcffaa	FALSE
gglfbakepiaclj	FALSE
gglfoghgnmkjaa	FALSE
hanmidkbalmaib	FALSE
haoalpppdkppeh	FALSE
hleefnidopjfaa	FALSE
hlgaliakoembeb	FALSE
iggfehdhhpgmaa	FALSE
iggkckojngeiaa	FALSE
jajlnfgfkpidka	FALSE
jakplnbkalkifm	FALSE
jlkadnmalepkpo	FALSE
jlmddghoelhiaa	FALSE
kiabpajbjmkfib	FALSE
kiagcodianljeh	FALSE
lbhgnfhdkbcdaa	FALSE
lbilbafkbjmlma	FALSE
lkpkhflmlechaa	FALSE
llbghjkkdhelaa	FALSE
mfiailgpbidfap	FALSE
mfibjmeffboaca	FALSE
momfffeoejdhaa	FALSE
mooaiplnecgjja	FALSE
njaplackhbcfgi	FALSE
njbeaaocbdikan	FALSE
odlkeffhjajeao	FALSE
odlnfkdaibaelj	FALSE
omjkpdhlcpimaa	FALSE
omjodikeimfpaa	FALSE
pgockpbnmmbcaa	FALSE
pgokibpmghnnaa	FALSE
abbdmgbhbcbepbl	TRUE
abccmikgljmbpjj	TRUE
akdflpmpfjcoieg	TRUE
akdmnjnincicjgl	TRUE
bdfakfpddidfdgd	TRUE
bdhbbfofngdfbko	TRUE
bojjlgckigdgeop	TRUE
bolbehecbhcjldb	TRUE
cigmafohlpjkekb	TRUE
cigpaiklepgibgi	TRUE
ddhpehlfnhdlago	TRUE
ddjaogonnllnnge	TRUE
dnkmjcekjkolmpo	TRUE
dnkngdgcangmnof	TRUE
ehifkldnnabjnkh	TRUE
ehimbbckodoidol	TRUE
fdbkpjkgihgodmf	TRUE
fddfeljhnpinhih	TRUE
fnblilicdckggli	TRUE
fndfjleljpanehk	TRUE
ggmcbppaelohnep	TRUE
ggnchpclebfcjmc	TRUE
haobcecolillmjb	TRUE
hbadkcbihoppcmj	TRUE
hkpjpjndjhdhgpj	TRUE
hlacehfcbdhjckf	TRUE
igngfhicgigchep	TRUE
igngglagpokfmnj	TRUE
jakcjmoogijgojm	TRUE
jakphfkddbffblp	TRUE
jmagcclgnnmdngl	TRUE
jmanehocbeielli	TRUE
khejhpgkcklljoa	TRUE
khgmkhflmbnebhb	TRUE
lbghekbdkhekoah	TRUE
lbhcccpmgpapjkf	TRUE
lmabmnedcejbfii	TRUE
lmapnmknpfhmegl	TRUE
mffflfpgigbihhm	TRUE
mffjjlaedbicnmn	TRUE
mpefnbbgccapibk	TRUE
mpekannehilfeij	TRUE
nkfemkclomdcgfp	TRUE
nkfpaemncfnnicn	TRUE
odfgbfdehmccgbn	TRUE
odfkjefkihdplkk	TRUE
onmlfpihfpekjec	TRUE
onnfaiedmdegllg	TRUE
pgmghldbafhnmng	TRUE
pgmofhmejpghhlp	TRUE
aaamgimdeffniia	FALSE
aaapillpmemfclp	FALSE
akkhpfnfjamanld	FALSE
akldiomciohjaim	FALSE
begihmkhinkcbaa	FALSE
behfmpifcfepbaa	FALSE
bpfadfochlhkgpa	FALSE
bpikhnhliihcaga	FALSE
cjnnkdodpdoikaa	FALSE
cjpdonedndkfpaa	FALSE
deoegjmlefccnaa	FALSE
deoklldhhncdhaa	FALSE
dolaclfbolhieca	FALSE
donhkjjodbogana	FALSE
eimgkblhihncjaa	FALSE
eimgnceblngdpaa	FALSE
fcbkdjimomflbaa	FALSE
fccfoihcjindcaa	FALSE
flglhdhfocldfaa	FALSE
flgococobpdobaa	FALSE
ggaeobikodoblna	FALSE
ggcbhibffeafnda	FALSE
hapgbhpglpjhabn	FALSE
haplbehldaiaoga	FALSE
hjmkmcehgfnogaa	FALSE
hjpnhgojgbpofaa	FALSE
iemhbiocfcmheaa	FALSE
iempebdkjkopjaa	FALSE
ionhdehocelhnaa	FALSE
ionphlbahbjoalh	FALSE
jijfejciljadoka	FALSE
jilbhllfjddfiaa	FALSE
kccahaebmfoafnc	FALSE
kcfcnimhpkfgdaa	FALSE
kmodmflggimebaa	FALSE
kmofjndieajohia	FALSE
lhaffamkldjpdii	FALSE
lhajaknjielijdk	FALSE
mapicklnhjjdmac	FALSE
mapnbopjbfbgiba	FALSE
mmcpjahplhmlepa	FALSE
mmcpjbkncdmmgaa	FALSE
ngdnmlnhnhcjhaa	FALSE
ngfckdihpkpiaka	FALSE
obcchnahljicbma	FALSE
obcfcfgjkkjpiaa	FALSE
olafncfkgpfancb	FALSE
olbmhgceadmpgab	FALSE
pfkfcanldhpeima	FALSE
pfnendokelooaba	FALSE
abbbjlcjeilkighl	TRUE
abbpccpgipfbhpkl	TRUE
ajnlcikijenbccbg	TRUE
ajomnlcjknefdjpi	TRUE
beimademejmphnik	TRUE
bejnjcnblibhhjpn	TRUE
bofpddfngaeofbmm	TRUE
bohkboknilajgedn	TRUE
chogcmgjdfgiejac	TRUE
chpdcidnilfjdbna	TRUE
ddaeekokgekcgjhb	TRUE
ddajcgekmiibncmb	TRUE
dojeopmpcjdmjghn	TRUE
dojfaejlmmkglhom	TRUE
einajndjegldbene	TRUE
einccpghodcnknep	TRUE
fddlekloeaekllhm	TRUE
fdelagndcekkfghj	TRUE
fmijhddcdabeblmc	TRUE
fmkmpjhiokldlnoc	TRUE
ggkigcfefgdhemda	TRUE
gglbhkmmblollchc	TRUE
haphefimdnfndnno	TRUE
hapkkbbjnojgjphb	TRUE
hkinabehdmlenbfg	TRUE
hkjabkbkcebdjoce	TRUE
iffimmmhopmhkppc	TRUE
ifggniahbbiopiek	TRUE
ipiijjpbcfnhbgne	TRUE
ipjpkeonpjenljoi	TRUE
jjjfjbbfglickccf	TRUE
jjjpkkknibdepocf	TRUE
keegafgpopfehlbl	TRUE
keephifkkgghlddd	TRUE
knomkidcmgnlbglc	TRUE
knphfekhkdgkhnef	TRUE
lhojmifknmbimbji	TRUE
liahmjbenofjoekb	TRUE
mbikmbfhjdhmheon	TRUE
mbjkhncgjilbebbk	TRUE
mlidoeebkfkcihao	TRUE
mllifcijojnjieoj	TRUE
ngcaekhgddgkmbep	TRUE
ngdgbfnejcgkomaf	TRUE
oagjcmcjlbidoheh	TRUE
oahgodomnimlgjhl	TRUE
olmjlcnbofihbcil	TRUE
olpfapdjhlocbhnm	TRUE
pfhcedclpfgmeodh	TRUE
pfhokdanpplkjion	TRUE
aaapkdlpabmhnlan	FALSE
aadpfccccocmehgj	FALSE
ajdjdhonamkkknpo	FALSE
ajdkfgmlfhlbbajh	FALSE
bdnpakkhfjcjmmea	FALSE
bdoaclpmlkdfilha	FALSE
bohbellpnmiemhaa	FALSE
bojfecdgeejkcaca	FALSE
cialhmjbncjljgla	FALSE
cibdiedccadgipja	FALSE
dcicidacebkkpnia	FALSE
dciocnidnbjbknaa	FALSE
doflapajghgpflhk	FALSE
dofodlpeiggcloaa	FALSE
eigggeodacmckcoa	FALSE
eihdiobamnmfnoja	FALSE
fdfgnpobcfgcfnaa	FALSE
fdfjfcgfmkcagola	FALSE
fngbnmeddbamelda	FALSE
fngfkmjkphkganda	FALSE
ghkhlpfbdejofoaa	FALSE
ghkohelmnjhafipa	FALSE
hbddfdpfidekefaa	FALSE
hbddngelcdknfnaa	FALSE
hkoffnilckicciaa	FALSE
hkogakcmolbnggna	FALSE
iejdbdfmkocoepaa	FALSE
iejemcdddkdbcpaa	FALSE
ipkjnbkghpdhihaa	FALSE
iplpahgnlokphgna	FALSE
jkamhmfflcnndjca	FALSE
jkanlledaieccpfo	FALSE
kdppefjpkhbldoaa	FALSE
keamdfppdmgmnima	FALSE
knpilafjcbooclam	FALSE
knpkklkieegmcgaa	FALSE
lhhefmnbcabioeia	FALSE
lhjbgknmhdfplbaa	FALSE
mbhadneigjfepbpa	FALSE
mbhnfpcgjhghiiaa	FALSE
mlobnhencmkijgaa	FALSE
mmbjifknmbimbjaa	FALSE
ngfaodkabdfjangf	FALSE
ngfkghboaoanfknp	FALSE
oakolbadmpbgplga	FALSE
oalinbfimbancnjn	FALSE
ollimfnompkkfiaa	FALSE
ollkiedijkfhgoaa	FALSE
pfkenghahhkfkkga	FALSE
pfkmlclnnecpnada	FALSE
abcoimhpclgfgpolc	TRUE
abdkhppmpjckmhocc	TRUE
akdcjbmoplihiknhe	TRUE
akdmfpcdpepigbmkd	TRUE
bemnijiaclndhkdmg	TRUE
benaibfigiknolcdi	TRUE
bplildkombhabpcll	TRUE
bpngadnkkdlegbdfn	TRUE
cjemilglppaiiimkk	TRUE
cjhgmhgdmccmmboed	TRUE
denocaidbedjikihe	TRUE
deocadbfimlbeobjm	TRUE
dpeklobfpkfpgcegp	TRUE
dpgjmgjggfalnpgbg	TRUE
eilbhlmijkeolkgbg	TRUE
eilbjagbnkmcbhggd	TRUE
fcimpbmicflcpcemb	TRUE
fcioflloopmeoglbf	TRUE
flbdbdnpadfmebepc	TRUE
flbdmhokknngignog	TRUE
gfjlphdfnpeghpbfc	TRUE
gfkdlfngaoeejjkdi	TRUE
gonbpjcpgckliagdi	TRUE
gonfcmaidghmdejoc	TRUE
hkgfmalpmnlioobon	TRUE
hkghfdpmplfhbfeoj	TRUE
idhdgmgjjhjmdmfhf	TRUE
idiikanmnnfcljebf	TRUE
iohgcjpifoogaihji	TRUE
ioibcmeihibejlanc	TRUE
jioepbcfgdopanfop	TRUE
jiopjackiihkbnfih	TRUE
kdnjifjhmpooghjci	TRUE
kdoncdogeghmmgkai	TRUE
knndjlapkloephoke	TRUE
knogmkdnjiccnmghd	TRUE
lhngfaomhpidmifbm	TRUE
lhnnpkcjhmeaoeemp	TRUE
mbdmjddjmbbkdmklo	TRUE
mbfdepdoicakiklpc	TRUE
mmadgccbjmcckgpfk	TRUE
mmaeclekodhelhiid	TRUE
nfekhkpnlcijgdoai	TRUE
nffblpcdemhlgpapc	TRUE
oaocfjmlnhfjohdej	TRUE
oaodbindblieelngo	TRUE
okgaenhodnghnmpdn	TRUE
okgkgpmkchlnccloi	TRUE
pebaennfbphhbbffg	TRUE
pebfdeblofmnmjceo	TRUE
aaciknlnafgeljgaf	FALSE
aaeckpoihdhomalgb	FALSE
akcbhkdiphejobmna	FALSE
akchdgolbfbkgceal	FALSE
bdnombhohdipnibaa	FALSE
beacbbjeldoffmbea	FALSE
bmoohfncnikapplna	FALSE
bmpinpkilkngnkjaa	FALSE
cgplkldbaehjbpeoa	FALSE
cgpmneccejfhopcaa	FALSE
dakiaaaheekopnjjm	FALSE
dakldojppkdlobpca	FALSE
dkmnkhjdholkkfkaa	FALSE
dkoabebbpokbcfkca	FALSE
eepnnnliljbamgjna	FALSE
eeppcjkfjgkejheaa	FALSE
fafpgkkgfldcnkhga	FALSE
fagfbeceadilpabal	FALSE
flbmjlfafonbifeea	FALSE
flcgflmmbkndbkpaa	FALSE
genjleoigihlnkjaa	FALSE
geomogfjgnmkcfoaa	FALSE
haeaiebppmgkmmldc	FALSE
haebmokjaodlandha	FALSE
hkaojjhmefebjomam	FALSE
hkclbkakdcelolnfa	FALSE
iepmhapmfkfadicbp	FALSE
iepoeoagflgjhoian	FALSE
ipemcjlkmgacdfahb	FALSE
ipempacpbcbiblfoa	FALSE
jkbhhphbfomemofaa	FALSE
jkbkelohggafkjjca	FALSE
kecoggjjohnjaahod	FALSE
keddkfnhjjpchenaa	FALSE
kpheankdpajgikpoa	FALSE
kphhbkckodmhampba	FALSE
lkakjfkdbkcmkjhma	FALSE
lkanahcccfihfkcbl	FALSE
megjdbdgmofbhgfaa	FALSE
megonlpeffpagoina	FALSE
mobdehbkphglkmaja	FALSE
mocgndnbblkaehefa	FALSE
nifdnoaahojbffgbi	FALSE
nihmbfmhfapmfjhja	FALSE
ocaldeckpgahkaofo	FALSE
occiobaaaoebklgio	FALSE
olofjjfkogcoihkaa	FALSE
ologafphgjcplcila	FALSE
pgeilmjiddacaiiab	FALSE
pgelboocdifiillaa	FALSE
abbjieipnbmhclpddh	TRUE
abbphlepfcbmjncebp	TRUE
akkiknkboihfekjkbp	TRUE
akknnnggfdgliinmje	TRUE
bdcepnfmbpgldeoeko	TRUE
bdcflpmmmnlceabogk	TRUE
bnljpojiepndbpgekd	TRUE
bnlnfoljogpjgggfko	TRUE
cgofimfdoionjbnlkf	TRUE
cgongbbnjahkfjjjhg	TRUE
dagmpdddgnkekmepfe	TRUE
dahmjpgiegkicgiifd	TRUE
djnppbleoldhaomnkd	TRUE
djonnniboojcbmpofj	TRUE
efgbkdmbojgcmgllbe	TRUE
efgjinhnjabcgmjcil	TRUE
faiobefdfjiomkmiok	TRUE
fajjllepdcfpfjokhn	TRUE
fkhcbgbblpnglpllek	TRUE
fkheedcdhenbchdlfo	TRUE
gfcmhnanbdbdkdpgjk	TRUE
gfdalnhneepfngfkem	TRUE
hackhbcgbfdbdbgkko	TRUE
haekgopkhjeogjmmmh	TRUE
hkcggjkcmpkfimckhk	TRUE
hkdblhfliengbmnlkg	TRUE
ifelbajnkohdbkolcb	TRUE
ifepoedffleogjnein	TRUE
ipdakkjmfkdkncfegm	TRUE
ipediabecpdpippmkg	TRUE
jjdokgeceegecbmeab	TRUE
jjeangnbgdippeolmo	TRUE
kedghglineieklldlj	TRUE
keehnfemblkeapodfe	TRUE
kolbaiipiemgfmdpkd	TRUE
kongcknjiodhmdkkgc	TRUE
ljgenhimbhkopanidm	TRUE
ljgjjmeekknekmgafd	TRUE
mdkhbkphodfakbdekl	TRUE
mdnfllajicpkomnjhf	TRUE
mnhnmhmhjcfldohbmn	TRUE
mnjnojekodempcbnjf	TRUE
nighpoejbmhiecingj	TRUE
nihiiffeejndhnajpm	TRUE
obkakdglodhdjpnlpc	TRUE
oboobpddpbhnmjlpkb	TRUE
olgojhhmcmdagdbjkf	TRUE
olhijpdalneeegfleg	TRUE
pgaefiojobnilkdpkb	TRUE
pgaffddjbhefdlcpni	TRUE
aaadcfpnhmckimjena	FALSE
aabenlgpjpndbombob	FALSE
alagjodiohgmenlaee	FALSE
albgiccaonkpgicnml	FALSE
belhhaibhbeedclpga	FALSE
beonccpkjjbkjlanja	FALSE
bniilnneadlcdnckca	FALSE
bnkgffjcgbdlgnndaa	FALSE
choefoccnnaihmdmda	FALSE
chonijbmpncnffkkaa	FALSE
dbjmdgkdfhmiapjoha	FALSE
dbkefkgicminhmonaa	FALSE
dlggkbbdnhfkbgdoaa	FALSE
dlglfdkckpnldcbafa	FALSE
eemjnminccgfdcgaja	FALSE
eemnkodinnbpoaamga	FALSE
epblgalfojinaemeog	FALSE
epcpoiakolpnfnelpa	FALSE
fkijhcjfoakjfjedha	FALSE
fkjhdnblciafnflnba	FALSE
geahmaacipjlaknagh	FALSE
gebehfmepkbhbofpaa	FALSE
gnchigfommdoeigmaa	FALSE
gnckamklgkfhnhbmja	FALSE
hghgiafkpmpmgaakhg	FALSE
hghnahdfnengigcfoa	FALSE
iaocaledpjllaknmog	FALSE
iaphpgjifbddgobpka	FALSE
illbpgaoemjcjeeika	FALSE
ilnejdlnokphpdibaa	FALSE
jgelhckmfmcbbdhcaa	FALSE
jgfgmenngmgopnmapa	FALSE
kaijnlcjcikjjgadac	FALSE
kajfokpkeollondnad	FALSE
kkgbpebljhjifklmaa	FALSE
kkghlampjghlklhhja	FALSE
lfbdpgjkecedlfbbaa	FALSE
lfdanmgblinefdbeka	FALSE
lpldgmgnhafdcjmdia	FALSE
lplohjcblafphaaaja	FALSE
mlelhlaemlfjmdlkca	FALSE
mlffldekagpodhobpa	FALSE
nfnbgmbahclbeomkla	FALSE
nfpfgkhnmdkdigegaa	FALSE
oamiapmgejhmdphehp	FALSE
oamlccabpljlokmljd	FALSE
olmgmnijmjkceleapa	FALSE
olmhngmpejbaieljka	FALSE
pfcldlgmaicghcjabf	FALSE
pfdmjpbpohicanjhpa	FALSE
abbojnnibnlleochcob	TRUE
abcpbeenkepghfcfedp	TRUE
akbediljdbmehngfmec	TRUE
akbojlopcjdmollohlf	TRUE
beggdgnfijgnabimmol	TRUE
begjckpfpjnfdnhcfph	TRUE
bnhgfahpgnklnhddhfj	TRUE
bnhifmffdhpimbfpicc	TRUE
cglllgcokjamkfkbgcg	TRUE
cgmlffmnpcdofphfjbo	TRUE
danlbmklpknhebnmcdn	TRUE
dapcecehobonklmcmfn	TRUE
dloelfjdhinnonangbj	TRUE
dlojkhanmlmfdgbbhoh	TRUE
egkehcgfmjcbfdleppg	TRUE
egknhijjiganmliongj	TRUE
fcedanpdhhkphnpldpe	TRUE
fcehghkjdjnbjfcfpai	TRUE
fmjhacplngbionochoi	TRUE
fmlldojcjakgbnmfopi	TRUE
ggdcdndajgofbhbglmo	TRUE
ggealolpimbigdkekkd	TRUE
hbegghicnffhjblffak	TRUE
hbfnnillbbmibedfmlc	TRUE
hlihlihljocghifanij	TRUE
hljhincgfllljocngld	TRUE
ifdhlckaidbjkbdppkh	TRUE
ifedbagndedmogfobii	TRUE
iphkpionpjcjlnmenmk	TRUE
ipinedmgbjkobjojpjl	TRUE
jkmonlnelgmiidegnei	TRUE
jkngneiiejhbnhjfjec	TRUE
kebopfhhpmdkgbggbea	TRUE
kecdapnffbllplgfgeg	TRUE
kopjdfoofhknfndgghj	TRUE
kpamnecgiildncjdfgc	TRUE
ljokedkeeffecamjfkj	TRUE
ljoognoiokfhohkpoji	TRUE
medpdehfedeogcaglfg	TRUE
meefbimpkimghcikkeg	TRUE
mofggiaolbpgimkonbp	TRUE
mogfjbabjfckfljoohm	TRUE
nicljkhainiinkogmpj	TRUE
nicnefmifhcfdpfnhan	TRUE
obpeakdjhnebckmlghl	TRUE
obpkgfladmnkjfngdeb	TRUE
omndfchllhppbacmncb	TRUE
ompgaenligmfbldjfmn	TRUE
pgpaghmmhbkoldkboem	TRUE
pgpekpcomaglbjlglof	TRUE
aaaohcepalljldfdndo	FALSE
aabdhajgalgdcekopeh	FALSE
albffkhapepihedncik	FALSE
alblgnlincloaoihfjl	FALSE
bfejmmiepmmcobbmeaa	FALSE
bfepbfpghgbailcgmae	FALSE
bohhejcdbpggdgboiaa	FALSE
boifinfmjihejccmkaa	FALSE
chcfimfjjiollmcghaa	FALSE
chfngckhahegebgjeoa	FALSE
daonkgngdgegobkboaj	FALSE
dbakonnldlidgdnpema	FALSE
dlfgfgppaikgcbabofj	FALSE
dlgbeihgkpbmllklkaa	FALSE
efhpoidcgdigbgfhhaa	FALSE
efjebigjmbeibficaja	FALSE
epmpbkagbjhhmdomooa	FALSE
epnaeipchngpmfkhhea	FALSE
fkanhpledaicdooapkm	FALSE
fkbbkolfcnikahcpcma	FALSE
gehccdbjaapdfcheecm	FALSE
gejboldnffcedcbodaa	FALSE
gojoeefclfdbpfpdnaa	FALSE
gomlkpleiepcbhacgba	FALSE
hiianbjphiiniadidhi	FALSE
hiibhfhggckhceggkaa	FALSE
icohieckihcgjoomnaa	FALSE
icpibillnkcbpepihaa	FALSE
imlmhcpcoohdcaoagad	FALSE
imlpkogaegjpaolfjie	FALSE
jhldecfoadcecehcdca	FALSE
jhmdjpcdidfgejfhoaa	FALSE
kcepoijgfknfhdehana	FALSE
kcfdkobgmdoidbbjoaa	FALSE
kmeddbbbamfbdnoeagh	FALSE
kmeolaghbcakpddnlgk	FALSE
lfifklgomdgdbbmnbaa	FALSE
lfildbohjamnnhifhda	FALSE
lpoflolfohfejokbiaa	FALSE
lpokdoiadaclmoekmjo	FALSE
mkmnjdgakooodljnpca	FALSE
mknifkahpcbdegmpfla	FALSE
nfdohepmcgjikhaocba	FALSE
nfegbkfheggcncicgaa	FALSE
oafngcfaimojcpbcjdn	FALSE
oagegjkmgifekkgadla	FALSE
okhgmopablhbchlnmma	FALSE
okihnpjbmppknkafnea	FALSE
pffbeicnfempnolbcaa	FALSE
pffemmjaibgepphgpka	FALSE
