aaacfaklpp	TRUE
aaafeaekap	TRUE
ajkljmkccg	TRUE
ajkloomhej	TRUE
bdolcgooao	TRUE
bdophblmcn	TRUE
bohgompiba	TRUE
boieblfjlk	TRUE
chlnecfkgj	TRUE
chngnlloan	TRUE
dcdhnblnak	TRUE
dcdkcbelgj	TRUE
dmocdjolgf	TRUE
dmoohffeca	TRUE
ehjpbkeddp	TRUE
ehkheingnp	TRUE
fbfpbggano	TRUE
fbgchedale	TRUE
fkhpngjnec	TRUE
fkidgkjiph	TRUE
ggcpfdidje	TRUE
ggelpnbkog	TRUE
gpnipmmaei	TRUE
gpoijhfpmp	TRUE
hkmgffegpg	TRUE
hknaihaeeo	TRUE
ifbjchdglj	TRUE
ifcbkdnpcl	TRUE
ipdldigdmo	TRUE
ipfkkbknhb	TRUE
jjamnhklhe	TRUE
jjcdmjpklh	TRUE
kblllnhand	TRUE
kblpkhhang	TRUE
kmlnibblkc	TRUE
kmmnmjnceb	TRUE
lhjhnfkkmb	TRUE
lhjjpphlfa	TRUE
mcaankpece	TRUE
mcaeoakpan	TRUE
mloolboppa	TRUE
mlpfiffcho	TRUE
nfpgngoaca	TRUE
ngagenkmej	TRUE
npmfiefclp	TRUE
npmjlcbpch	TRUE
okbkbafoch	TRUE
okbpogapen	TRUE
pekejcmfoa	TRUE
pemgfhfkfn	TRUE
aabijaacli	FALSE
aacdbffakh	FALSE
aipbadhjkp	FALSE
aipjnpgoeb	FALSE
beddhhicab	FALSE
bedimbmiab	FALSE
boehmbedab	FALSE
boepfjomab	FALSE
cifcbdebab	FALSE
cihmkpooab	FALSE
dcmoannncb	FALSE
dcmokdgbab	FALSE
dndbifbpab	FALSE
dndemohgab	FALSE
ehhhlapggb	FALSE
ehifdbinab	FALSE
fbhencjmab	FALSE
fbhgdpelab	FALSE
fmfheeokab	FALSE
fmgbnjpnab	FALSE
gffhklofab	FALSE
gffmoeelab	FALSE
gpngnnbdab	FALSE
gpnkobljab	FALSE
hkemejjdab	FALSE
hkfehgiiab	FALSE
iephbokfab	FALSE
iepjhcfgab	FALSE
ipeaibobji	FALSE
ipeekpogab	FALSE
jjenfiieab	FALSE
jjfcohbkab	FALSE
kbpohmdiab	FALSE
kcadlpmaob	FALSE
kmebknhbab	FALSE
kmekedmhab	FALSE
lgllimibab	FALSE
lgnjjlodab	FALSE
mbfbigbhab	FALSE
mbgffdloab	FALSE
mlgnljobab	FALSE
mlkemjopab	FALSE
ngflpbinab	FALSE
nggdfdahdb	FALSE
npjnlacghb	FALSE
npnoenjkab	FALSE
okfmmjapcb	FALSE
okgddgbgab	FALSE
pepolcfpab	FALSE
pfaldahdeb	FALSE
aaacfaklppe	TRUE
aaafaekaphi	TRUE
ajickhclflp	TRUE
ajiljcpgcgl	TRUE
bdkonjcpnld	TRUE
bdlgbddjhoh	TRUE
bnmokmeijlf	TRUE
bnnclcjmdme	TRUE
ciliihmacpe	TRUE
cimahfoflcg	TRUE
ddcnklfhbid	TRUE
dddpilmfooh	TRUE
dnfgijhonpa	TRUE
dnfpdldgpjk	TRUE
ehakfafadgm	TRUE
ehblffggghn	TRUE
fbdahohlhhl	TRUE
fbegnnbdobl	TRUE
fllfmaihfpg	TRUE
fllhhemniae	TRUE
gfhdpgadflg	TRUE
gfjodjcojle	TRUE
gpmhlkgpajo	TRUE
gpniaalhllo	TRUE
hlgcegfblof	TRUE
hlikclaanfl	TRUE
iejjfpfgpbn	TRUE
iekhafnggdc	TRUE
ipbadahdcla	TRUE
ipbdhchnepg	TRUE
jigkaciohfj	TRUE
jihfmghjnam	TRUE
kckllhfpccb	TRUE
kckooppbepl	TRUE
knbemmjadee	TRUE
knbngbgipac	TRUE
lhbneccahnp	TRUE
lhciefjocha	TRUE
mbcmkkpaphg	TRUE
mbdieccokih	TRUE
mljpjdbkajc	TRUE
mlmcdlphgem	TRUE
ngfonojhjof	TRUE
nghgcacpoia	TRUE
npkpgnapiid	TRUE
npmlndbeoef	TRUE
okbhbfcddnm	TRUE
okcbdddbebe	TRUE
pfbdadggece	TRUE
pfbkanngdfl	TRUE
aaapbnpdaai	FALSE
aabbcnjpfpn	FALSE
ajmfklgjclb	FALSE
ajnbcffpcjp	FALSE
bdhiodfmiab	FALSE
bdhmilliacb	FALSE
bobeanoobci	FALSE
boboolcniab	FALSE
cigaaccedlb	FALSE
cigpmbdbakb	FALSE
dcfhbgodcab	FALSE
dcgdpnphnab	FALSE
dnocmdfggab	FALSE
dnoflgfciab	FALSE
eiflebhbmab	FALSE
eifmdmflkab	FALSE
feojmjojcab	FALSE
fepbacpdkpb	FALSE
fpddnjofmab	FALSE
fpdglgghmab	FALSE
gjemdeeipab	FALSE
gjenfaobdbi	FALSE
hddepadialb	FALSE
hddlnhkhfab	FALSE
hnemfbgfbab	FALSE
hnenpalfaib	FALSE
igjgiegknab	FALSE
igjjimkpkab	FALSE
japfgnobggk	FALSE
japgmgpnngb	FALSE
jkfffjbioab	FALSE
jkgclaooeob	FALSE
kelmnbefhab	FALSE
kembpeecaeb	FALSE
kpmaeaapgob	FALSE
kpmhmepkkab	FALSE
ljhgpkcnakb	FALSE
ljifpekeeab	FALSE
mcmjhpkncab	FALSE
mcmmihamdhb	FALSE
mmkphapjbeg	FALSE
mmmehemnbab	FALSE
nhgpcgglnab	FALSE
nhhaofpgbko	FALSE
obkbpceeeab	FALSE
obmnkejfdab	FALSE
onajodikcbf	FALSE
onamohjdeab	FALSE
pghkcbghjab	FALSE
pghloaboioa	FALSE
aaaijpiacjoa	TRUE
aaakmoogfepn	TRUE
akhokdfaogki	TRUE
akidccaolkhg	TRUE
bdmhaddflmmo	TRUE
bdmjmaejniph	TRUE
boakalkiijmg	TRUE
bobccgkegfgm	TRUE
chpmfmpgndgc	TRUE
ciadnccjicil	TRUE
dcbadkkhokgk	TRUE
dccdbicamjjk	TRUE
dmikaedelknc	TRUE
dmjgchaceman	TRUE
ejmepcmohkcc	TRUE
ejmjbdikfpih	TRUE
ffaicfckkmaf	TRUE
ffcglbfbkikp	TRUE
fomhjfobkeln	TRUE
fomifojhhfde	TRUE
gjkmkfhphnpg	TRUE
gjknoaenhddl	TRUE
hdjankohklfj	TRUE
hdjoopccdegg	TRUE
hnmfjcnhakeo	TRUE
hnndnlpcfnpk	TRUE
ihilcdaelmnn	TRUE
ihkhmiaoejck	TRUE
jbcaffeoffmf	TRUE
jbclddnennkn	TRUE
jkeaplcmfhoh	TRUE
jkhajohdcmgc	TRUE
kfcnhicmgopm	TRUE
kffecddkcbgb	TRUE
kpknghlnfeak	TRUE
kpncecdikogl	TRUE
ljhlblglffpb	TRUE
ljicfkdbhbla	TRUE
mcpcebjlpeho	TRUE
mcpcgjdpdand	TRUE
mmkaoaffmnho	TRUE
mmkemdkakmlp	TRUE
nhjfkhgpamho	TRUE
nhkcnagpjhgi	TRUE
ocfkdhkcadip	TRUE
ocggplkofelc	TRUE
omahjeljfjfm	TRUE
ombfibflffff	TRUE
pfkcnfnegnbi	TRUE
pfkoflkfcgik	TRUE
aaacdpkbbbdg	FALSE
aaahhhfacmgb	FALSE
algahdebpfgj	FALSE
algclglnloab	FALSE
bepjfkakkgdb	FALSE
bepobpfehbab	FALSE
bpmjkpjnleab	FALSE
bpndmcjngiab	FALSE
clcmmchapjeb	FALSE
clcpccdegjab	FALSE
dfpnapjdgadb	FALSE
dgaheagehkpb	FALSE
doodeomdnafb	FALSE
dpbcpcjlejab	FALSE
eiodnaapjfbc	FALSE
eionlfnaoopb	FALSE
fdfegnplopab	FALSE
fdffolodangb	FALSE
fnallhhkfmdb	FALSE
fnaogjbldafn	FALSE
ggkokpahkjnb	FALSE
ggllolhnmnab	FALSE
hccmjadelfkb	FALSE
hcdhbnafnjpb	FALSE
hmcmbinffdab	FALSE
hmdokaaeocdb	FALSE
igccjlliadpb	FALSE
igcjjfiiggab	FALSE
jajfeckiblce	FALSE
jaklejhcmopb	FALSE
jlhkakjmhmgb	FALSE
jlhngefjohab	FALSE
kfpglojpjiab	FALSE
kfpiehghlmab	FALSE
kpniggfeogab	FALSE
kpoehlpcjoab	FALSE
lkdboofhnfab	FALSE
lkddjihjdbab	FALSE
megcmlobapgb	FALSE
megicnobejab	FALSE
mnjlhdccjbab	FALSE
mnkbehpomnab	FALSE
nhbdacaecieb	FALSE
nhcjcfcjeiab	FALSE
oambdkhfdhca	FALSE
oanoaigdaemb	FALSE
oloimkpagodb	FALSE
olojinmigmab	FALSE
pgcaanmnibah	FALSE
pgdkkfondajb	FALSE
aaaeemkcmpeap	TRUE
aaaonfiadakai	TRUE
akgmadlikoman	TRUE
akhggmicjadmn	TRUE
bfglgbkbfkmnk	TRUE
bfhobhjhglmfn	TRUE
bpmolchalhnlj	TRUE
bpnakplmmdipp	TRUE
clcakafahpgim	TRUE
cldbhdhhkleah	TRUE
dfokahgglopcn	TRUE
dfomdehkohdjm	TRUE
dpafjfipmijon	TRUE
dpapcajmjgkhd	TRUE
eijoapcldclpe	TRUE
eiklmfnjgkiak	TRUE
fdcbnlddjegbf	TRUE
fdcnkncjppoho	TRUE
fngicpnhlnjni	TRUE
fnhacpdlcmdmd	TRUE
ghjenjafggjgo	TRUE
ghkbjkofffmdm	TRUE
hcbbbenpcgfjk	TRUE
hcboheeffkngc	TRUE
hmcjkenigmagm	TRUE
hmckhogddijjm	TRUE
igmcicnkhgocp	TRUE
ignlamkenmkdi	TRUE
jajgfkhdfcoih	TRUE
jajidaaedmeha	TRUE
jlghpmhnhannp	TRUE
jlhfbgcciamef	TRUE
kfmhgmnbpggcf	TRUE
kfmnlfkkmblip	TRUE
kpmlmneejkijg	TRUE
kpoomhojncoom	TRUE
lkmpikhokjlpg	TRUE
lkpjamghnnoph	TRUE
mehlmiefpglbd	TRUE
mehnmglnpkokk	TRUE
mnojapenomlka	TRUE
mnpcafkkleajm	TRUE
nhidemeojdhna	TRUE
nhidnegamjdla	TRUE
oaoeajmpconhd	TRUE
oaomekknjngpc	TRUE
oleapnnanhhml	TRUE
olelimnndehom	TRUE
pgjlmgmpmfbmg	TRUE
pgmainpfmpneo	TRUE
aabkggakdjonp	FALSE
aadjleihmhhjb	FALSE
akdhnhckbcboj	FALSE
akdnidlldkmgb	FALSE
beclnbkhdhkab	FALSE
befhemnageodb	FALSE
bopkebkjpbmab	FALSE
bpajkjgdobice	FALSE
ciginjpeklkab	FALSE
cijlomlgamfdb	FALSE
dblhnjllcjeab	FALSE
dbmipjocoofab	FALSE
dlocdefndihab	FALSE
dlohgijldlhab	FALSE
egdlaenmggigb	FALSE
egfoedmghpoab	FALSE
fagbhjimolbco	FALSE
fahaenjahlaib	FALSE
fmhhbijpbcjab	FALSE
fmkcffdlfbiab	FALSE
ggkppociopjab	FALSE
gglaocmgkmgib	FALSE
hafmmdmkdgjkb	FALSE
hahcedglekjdb	FALSE
hlepnphicpeab	FALSE
hlfbpcbfjooab	FALSE
ifaimchgnaikb	FALSE
ifbjmghegbeab	FALSE
ipgihdoncpgab	FALSE
ipiabefpeagfk	FALSE
jmcdphbjekcab	FALSE
jmchcpifobbab	FALSE
kgoggngbhialb	FALSE
kgoiogddebdab	FALSE
lanbngjohckij	FALSE
lanehfmgnlchb	FALSE
lkcfcgejekmab	FALSE
lkchgbclfeeab	FALSE
mdklgnpalncnb	FALSE
mdlggclpjonab	FALSE
mnanjpjpkfmgb	FALSE
mnbhanmbnkcpc	FALSE
nhlajdnhhpmjb	FALSE
nhmddojgmmkab	FALSE
occdfnciibaeb	FALSE
ocemfjdjjdeab	FALSE
omilcjbdgeacb	FALSE
omipfimhljcab	FALSE
pfpmiecbbkjab	FALSE
pgaenokfcoolb	FALSE
aafcjlplnkkemf	TRUE
aaffakngalneho	TRUE
akgmmemldgapmo	TRUE
akhhigelcjiaai	TRUE
beillfkipjclen	TRUE
beimhefdajdnkc	TRUE
bpigdipdnanoke	TRUE
bpikbgohehfdkk	TRUE
chmbpacahfgagd	TRUE
chnlgnclcohjlf	TRUE
dcjpadjanlcoog	TRUE
dclfdidilagjli	TRUE
dljanjoglflnel	TRUE
dlkmidpaldammd	TRUE
efmmbdoddbdjaa	TRUE
efmmecihpbohhj	TRUE
faghkigfkjkang	TRUE
fagndepmngjhol	TRUE
fllogkfolhkcho	TRUE
flmbmlegmlnieb	TRUE
gglndbenfmkmoj	TRUE
ggmpioemglaemp	TRUE
haeemhchfepglf	TRUE
haejeddhgipfdn	TRUE
hkhcmpkadfdngd	TRUE
hkhihplkfdpdjb	TRUE
ifcailhclokklm	TRUE
ifcdmenjjljoja	TRUE
ipjajjfmhilnoh	TRUE
ipjeghdfchbpjc	TRUE
jlfmphebeejenl	TRUE
jlgnkcnaecdakh	TRUE
kgbojbohcpolhp	TRUE
kgcjkfmghimaon	TRUE
lamplchnjdfonh	TRUE
lancmcnjaakgci	TRUE
lkoojbkiaohaaf	TRUE
lkopljaiphfcfl	TRUE
medelpdgggjmgc	TRUE
meeoghfbgcffkg	TRUE
mnmhaogfmalaci	TRUE
mnmnfcmjkdbgbo	TRUE
njacaghahglmcf	TRUE
njacjngikfcpha	TRUE
ocjifajiddfelc	TRUE
ocjmfblddknlmg	TRUE
omblgiagjedfpk	TRUE
omdccapmllkccg	TRUE
pflgkjnhelandh	TRUE
pflpihcimhoepi	TRUE
aaackegmmaeakb	FALSE
aabeokhpbfakjf	FALSE
ajmknjceelllib	FALSE
ajnaiokoiplfab	FALSE
beideaoccejaib	FALSE
beihfckfdkelab	FALSE
bnjokdodaadafb	FALSE
bnkafojphllbfi	FALSE
cinhfamchfibeh	FALSE
cinphfhlhegcab	FALSE
ddgfecgcdljkab	FALSE
ddhjcfgpbolnab	FALSE
dndngfhglnckab	FALSE
dndnmpbdmgmcab	FALSE
egnglnckechgab	FALSE
egnhefjjanelab	FALSE
fcjakfpgniafnb	FALSE
fcjolhoidcjbab	FALSE
fmgmfbejcdfiab	FALSE
fmhehicpmgngab	FALSE
ghganobaopodgj	FALSE
ghhpjilcgnplab	FALSE
hbiejjccogbaba	FALSE
hbihmfkbhomiab	FALSE
hljdlgdaegopmb	FALSE
hljfbcfbilcpab	FALSE
igalmpclcemgjb	FALSE
igceimpjpcpdab	FALSE
ipjfpgloahjldb	FALSE
ipjmieopahcjib	FALSE
jjjhgcaboahaha	FALSE
jjkcillacaoklb	FALSE
kddoedknmgjgab	FALSE
kdekhmlfijdjab	FALSE
knpdpbaecakdib	FALSE
knphefglbaahob	FALSE
lhnegbbjlggbab	FALSE
lhngahgebehfig	FALSE
mcgmdbmpghekab	FALSE
mchdjpapdklnab	FALSE
mlpfejphmjobab	FALSE
mlppabgfdklioo	FALSE
ngeddnhdjnljab	FALSE
ngefpmgkkcocab	FALSE
oadllafhpdclgb	FALSE
oaenbenmbhfpgl	FALSE
olhollkkamphab	FALSE
oljpbiiadokcnb	FALSE
pfhlhllddecnab	FALSE
pfhpalhplfmebl	FALSE
aaaemejecghdfao	TRUE
aaagilpondnhpph	TRUE
akicdaljopfjjei	TRUE
akilecfpdoheoek	TRUE
bdoelnjpoccikef	TRUE
bdplpkfoicbmbfk	TRUE
bnmogfmhfoanemf	TRUE
bnmomcdidnlcclg	TRUE
cieepdfdbbeghop	TRUE
cielfdhgbdjlpna	TRUE
ddcjoafchcfaipf	TRUE
dddcddjeelakejc	TRUE
dobifdankecikfc	TRUE
doegkblgnanjcdg	TRUE
ehdkdbbpcelhmaj	TRUE
ehegflpdgkaalhl	TRUE
fcapagdgeghldjd	TRUE
fccadloklmpnpln	TRUE
fnjbmlnggpnmned	TRUE
fnjnkjpefepmbel	TRUE
ghkdlccjhlnldlk	TRUE
ghkjakfpfnnekmo	TRUE
hbdeepamofjddem	TRUE
hbemkhbocgglfca	TRUE
hleacolknaclhed	TRUE
hlehganlofcdlan	TRUE
iepgoojbggalhed	TRUE
ifalnclkednhlmd	TRUE
iplfijfelfndadi	TRUE
iplkpdienclafno	TRUE
jjlgkonhjjkioae	TRUE
jjllohkideffhkh	TRUE
keangcopldaplkm	TRUE
keaomkmlefikpio	TRUE
knkmfdkdchmdnoe	TRUE
knkoflbgffkkdjf	TRUE
liegpbfhlffbdfm	TRUE
liehljfbmlicbjo	TRUE
mcgiojojfjjhphd	TRUE
mchaidehcihlcci	TRUE
mmdpepcpbblpocf	TRUE
mmedfhiflnfbgmb	TRUE
nggpjohcnmghhaf	TRUE
nghcholpgbbkgcb	TRUE
oacnlccpmlcolfk	TRUE
oacoaedfpofldfa	TRUE
okmomjfkigjjckl	TRUE
okmpfahgjnfhape	TRUE
pfppjpoephnohkd	TRUE
pgbaknjhdgpcfeo	TRUE
aaaacbealilddnd	FALSE
aaaegedkgcbllmm	FALSE
alihgkjepopmmjb	FALSE
alkmokihpjcgbdh	FALSE
belbdhgmbbbihab	FALSE
beljmgelbjomiab	FALSE
bopdjkfdehojjab	FALSE
bopnplejjiijbab	FALSE
clbaejbgaaldhbm	FALSE
clcdhjkpobbadcb	FALSE
dejdcekbemopbab	FALSE
dejhlohpfkhbgab	FALSE
dopjfhibgdnkgab	FALSE
dpaabjienahmbod	FALSE
ejfmpghojjaamfb	FALSE
ejfppddcajmkicb	FALSE
feabifoocecpekb	FALSE
feahffnkddlhinb	FALSE
fnhmnkjcnjeimab	FALSE
fnjaaodkjdbncge	FALSE
ghpaofiodlakjbm	FALSE
ghpgdmgmpcmbacb	FALSE
hbhlonkjabhjdok	FALSE
hbhneminnmkojab	FALSE
hmckndldebjopab	FALSE
hmdpakejjndfjmb	FALSE
ihaaolfondefeib	FALSE
ihdjepmblgeeiab	FALSE
jbdhelnpabogopm	FALSE
jbeicdndpebeoab	FALSE
jmccjpficdnbeab	FALSE
jmcpbieifahiinb	FALSE
kfocdmalmhciagb	FALSE
kfpebjlnngcefab	FALSE
labblfioilnepmp	FALSE
labcmodghnncnmm	FALSE
lkmhlckobabokdh	FALSE
lkndjjjbjbmpkab	FALSE
mefegnodkdpngab	FALSE
meflpekcoaalmjb	FALSE
mnmfdllkkigbpab	FALSE
mnmgcbhdkdphdab	FALSE
nigpamcjnohpegb	FALSE
nihhpcnbfjondab	FALSE
oclgknakhieaokb	FALSE
oclhbofndhofdab	FALSE
olkpomfhcdgdiab	FALSE
ollpehfabamppck	FALSE
pggaenklilpaaob	FALSE
pgjgddpgmdiecab	FALSE
aaangjhmnnemeefe	TRUE
aachinedjehlngie	TRUE
aleojoecigpjogla	TRUE
alfijgkeefnckmcn	TRUE
bfnelielmcmkdopn	TRUE
bfoekkbckmokmmhl	TRUE
bpceleeaplcdhonn	TRUE
bpcnpkmilnihchpj	TRUE
claicjfpijoohhgp	TRUE
clcohkidnmagpcim	TRUE
dfcjlbmoppchgkgp	TRUE
dfckldkcdpkbgehm	TRUE
donljchibjbglbad	TRUE
donndpelpkflegaa	TRUE
eikoojgefnophcfh	TRUE
eilcojlihkibhpli	TRUE
fehgdgiofcamdoda	TRUE
fehgldbddidbdcfo	TRUE
fnjoncbomepicnmg	TRUE
fnkgffljnppcmocm	TRUE
ghecmmhdeiifbjch	TRUE
ghfbckjlpmheogji	TRUE
hbgfcadmkjaiijgi	TRUE
hbhpjibhhoeacloe	TRUE
hljdhgggnmccnjga	TRUE
hlkafpledkjmjmcd	TRUE
ihagcljemikndajn	TRUE
ihahkimajgjniehl	TRUE
japhfmccgoioaejf	TRUE
jbafinmkfgjcehoi	TRUE
jmhafmoijiegoloo	TRUE
jmighffnojanophg	TRUE
kgcbjmbbfadlennp	TRUE
kgcfoibgpbikiceb	TRUE
laacnaacdpnkgojn	TRUE
lacneghphgagejnn	TRUE
lkjfljckajnpoapf	TRUE
lkllogjcfcflmpka	TRUE
mfbgfjjfcaehlfip	TRUE
mfcfijhobdgobmpa	TRUE
moiaccaafegnjffn	TRUE
mojfgnklilpaaphj	TRUE
nhiofhobkalielia	TRUE
nhipmobejfeldpgk	TRUE
obofnilkcggbcoke	TRUE
obolnjomigbimalo	TRUE
olkhlnmoedbfjfip	TRUE
ollcdealkmgaoknl	TRUE
pfndncikfbhbfhpb	TRUE
pfnfcipmhdbjflao	TRUE
aacibobcfehmpkga	FALSE
aadgmiaaplihgpeb	FALSE
aldbgcidocelgpgd	FALSE
aldeafehkohmneob	FALSE
begdmdfcfkplopab	FALSE
begnbgmdlckbniab	FALSE
bpcjfonbhebipeab	FALSE
bpcloepmadnjijjb	FALSE
clgapdkcedoomjkb	FALSE
clhdhechkgcheiab	FALSE
dfjinnfpobadjgnb	FALSE
dfjnklfjhlofplab	FALSE
eacamnhhibpgnjjg	FALSE
eacgbcgmbkhamjfh	FALSE
ejhmihbinaihcbab	FALSE
ejjekengclecmhab	FALSE
fdoohhfabfnaadlj	FALSE
fdookcdjobhlfgab	FALSE
fohnijjdmabhnehl	FALSE
fohpflceiaedicob	FALSE
giokoddloddifmab	FALSE
gjafoilhijkhcbkn	FALSE
hdfdfemdelpgjdab	FALSE
hdfnhjghjoakdghb	FALSE
hmpfghkimhgclbab	FALSE
hmpiioiopocgbmab	FALSE
ihekpikipknjnhab	FALSE
ihfhipdilomhioab	FALSE
jbcdlihkmkjjicab	FALSE
jbcoimmklbmekmab	FALSE
jklbenfdamlbkdno	FALSE
jklkmlmfindkflab	FALSE
kfhkapgpmcoklmmb	FALSE
kfigjjkcnebbneab	FALSE
kpbaipkmcgnlkngb	FALSE
kpblknadoefpbgef	FALSE
lioegcabgajpfekk	FALSE
liokdolicdilfkab	FALSE
mddhgcblmcpioeab	FALSE
mdhhbmakhjhkeajb	FALSE
mojlgfnkokomannb	FALSE
mokbodemjbloelab	FALSE
nipigjjimlonndab	FALSE
njabbmcdgbhkifon	FALSE
ocdgoliihionniab	FALSE
ocebmealdgbcncdh	FALSE
omcpijllpkjbdmab	FALSE
omdnnianbnnfigeh	FALSE
pfjbdgffhlohgmab	FALSE
pfkflhekkiblaecb	FALSE
aaafkhamgcnlmhilk	TRUE
aaagmnachaekjgjhe	TRUE
akmepmfmhfopeiijp	TRUE
akmhjidlfdfmapmkg	TRUE
bfgfaakhkhghkoafg	TRUE
bfgifbfeklnhmgbkh	TRUE
caioenlnaaejipejm	TRUE
cajcjeijemhhkkknj	TRUE
cjffefdhjomaaegkl	TRUE
cjgalakglgedefelp	TRUE
ddcgalfglicogclnk	TRUE
dddoammoodoflmlgg	TRUE
dnegimfhaomcpanlj	TRUE
dnepfhahklkfmkgkd	TRUE
ehdglklopimhhppij	TRUE
ehdmoikgfgegjpfkb	TRUE
fbpnefmgdhhmoekok	TRUE
fcafpplefgleffhjo	TRUE
fmmfplkmohjnipebl	TRUE
fmoimjcknnbfanamm	TRUE
gggomfhodgiddmmnh	TRUE
ggiadcjmklanoocih	TRUE
hbkndldmiedhhccdo	TRUE
hblcknfpeibjopbfe	TRUE
hlofkcpgpomggllce	TRUE
hlpfogamgjejimcok	TRUE
ifpdanpledeikicpg	TRUE
ifpipghbplnhmjacc	TRUE
ipbcadcjdjpjkfkih	TRUE
ipbmlhofhinlefonj	TRUE
jjlecmhijdlahjoef	TRUE
jjmadmjjhdficeefm	TRUE
kenfpgafdinaemlah	TRUE
kepmhhgiiilcpbndp	TRUE
kolenplhhjahpoalh	TRUE
kolpheghaaneflgpc	TRUE
ljdaleahhhgjegiio	TRUE
ljdanolgdfhiipnhe	TRUE
mdelopfddggdlfkbb	TRUE
mdgandphlgoecgafc	TRUE
mmghminaafmplikek	TRUE
mmgjfdcjehbdnaiii	TRUE
nheeohgfcmknibkea	TRUE
nhehlckofgdoobpap	TRUE
objnhfnjajnlmclhf	TRUE
obkenahonnlglhnmk	TRUE
oloiiokkkffniacak	TRUE
olpafmfikflkhmfop	TRUE
phdnhmcpbbhnleobf	TRUE
phfhibgekjhkccmlh	TRUE
aaafboeekkbaohdli	FALSE
aaakdlaedpldfiefb	FALSE
akdhfebpccbilokhj	FALSE
akehokpflppebfakk	FALSE
bfhleodnlngddcgab	FALSE
bfibiannopjfefdob	FALSE
cahcmpidogfejbacm	FALSE
cahjbhgccackknafm	FALSE
cjklkpaicgmiejedb	FALSE
cjlhmlmgimlgjagkb	FALSE
ddbejlgaamdfaokcb	FALSE
ddbjjiecaofffkccb	FALSE
dngdjgeidpcjgbgab	FALSE
dnggleinfknmbopab	FALSE
ehlpappagbjcgmmkp	FALSE
ehmbdlenlebealkdb	FALSE
fbkobjfocicojbkab	FALSE
fbkomikihcomjjoab	FALSE
fmloapmiiffdfiaba	FALSE
fmnkolhpaibmfmllm	FALSE
ggmjjlomandmlbemp	FALSE
ggndnajploekhnfcb	FALSE
hbngiddmmnhakcbil	FALSE
hbpjamnnbhgabchmp	FALSE
hmifiojiaphbfgiil	FALSE
hmiidfgohhmkgieab	FALSE
igaakaigioiongmmb	FALSE
igaepkbcmmcnjeini	FALSE
ionopokeblnaiejbm	FALSE
iooiimlfaohbikjdo	FALSE
jjpbnppljagbnikkk	FALSE
jkchfajnfcnbgfgcj	FALSE
kejhodlopffpkfcab	FALSE
kejmcdbloomknhcab	FALSE
koejnmdmmhjkgdpab	FALSE
koempemgafcmnonhb	FALSE
lipadaipnjabmdppb	FALSE
lipmajheldcglaaib	FALSE
mdcfbnfkdldgjijab	FALSE
mddpbkcpbbmahkdob	FALSE
mnbegilhbcfbgkcab	FALSE
mncpekljefoppkoab	FALSE
ngmpljgcjoiefjnab	FALSE
ngnobenbfekjnfiab	FALSE
obmakejcjoleiiidb	FALSE
obmkhjegilpjihjab	FALSE
omgdpnkekjidlhaeb	FALSE
omimmohaaeklpanhb	FALSE
pgcpbfkmmkelfbnab	FALSE
pgdfnfhnhcdhcfhab	FALSE
aacdcdiafniifkcfam	TRUE
aachofpjolnfcihfgd	TRUE
aljofdekkmhjdjmakf	TRUE
alkfmeojpplaelnldm	TRUE
bflcignihnalpninkf	TRUE
bfmgcinngcagepcegm	TRUE
cadfjgiiejahphdjmp	TRUE
cadgfdffphjekgccfg	TRUE
ckmhkkeedhnafaijma	TRUE
ckmogncohdajgkomjp	TRUE
dfboccmijfcnajmdom	TRUE
dfcfbahmffpgndgjao	TRUE
dpjdpphbpfoknbohmo	TRUE
dpkonhbencbkjieiif	TRUE
ejicaolhcgdkoneiij	TRUE
ejifjjlpfmiienpneb	TRUE
feanojoejflhdcfaaj	TRUE
fecgibnkcpldplfndk	TRUE
fofdkjlhnfjilceooh	TRUE
fofmdhnjdadphgnkek	TRUE
gickohfcakdpihankk	TRUE
gidhhnbkkbocakckmc	TRUE
hbolnligcidgeiogdo	TRUE
hbpelfcaojllljklli	TRUE
hmjfalieelkanoijkc	TRUE
hmjiicffbahdfhaigf	TRUE
ihopogeffieddangfl	TRUE
iiachgjalgdgkpkajc	TRUE
jcapoapoiijalnohgi	TRUE
jcbdjccdiojfdahpfp	TRUE
jlnmchcnlfkccoegmc	TRUE
jlollmadglfchoefki	TRUE
kfldmhcelkpgjmjlfg	TRUE
kfmiinhfhcpmacgjid	TRUE
kpaiocookcicdnmjnd	TRUE
kpaoeelchodclcnehe	TRUE
lidanmmaenkddghlne	TRUE
lidkgbfeojfgjleemg	TRUE
mcoillkcbnmdpodoim	TRUE
mcpcdaogkcjpjcecac	TRUE
mnebgeaodafdnoajjh	TRUE
mnejaglloehokoaeea	TRUE
niaeoapfmidkjlpepo	TRUE
nibfmfepcnfepcmgff	TRUE
ocgmfeapiikcppjoig	TRUE
ochbhdnkbiemkadkmm	TRUE
olmmojikdofmjfleja	TRUE
olnbljbhfgimfcppea	TRUE
pfgeolebhjbmbbbaca	TRUE
pfgoopnhihjblhenan	TRUE
aaacpmhbhjpchdpgmf	FALSE
aabfldbilobpdpljhl	FALSE
akinjakmdeklmopaob	FALSE
akmepcgmgaiodpcgnb	FALSE
beicmekmndhpbhglab	FALSE
beinpecmilkaocepjb	FALSE
boggbbfmpfnlbledab	FALSE
bogjhjmdiljohodlab	FALSE
cipgpmnoeodbibebab	FALSE
ciplpnopajdhmiodgb	FALSE
dcpijaibeamgokfgod	FALSE
ddapeneneedpcgjalb	FALSE
dmjhbjkhhhbeabomni	FALSE
dmkmdljccjnacmlcab	FALSE
ehphohdeicibolgiab	FALSE
ehpocfomkcgphcghab	FALSE
fcaeaodncachbmobpk	FALSE
fcaliammbofgkmbbif	FALSE
floffjidpgkgbcpnab	FALSE
flojhpejnkakgloidb	FALSE
ggfhhppplifbhbipab	FALSE
ggfjfcnbdpjngfceab	FALSE
hakagdckffhdgfbbbm	FALSE
hakfihnodmphaelneb	FALSE
hliclhhihdhhdedeab	FALSE
hlipoojbmldmcpcajb	FALSE
ifeggfjcapmpbkoipc	FALSE
ifeklpbinpffnoloab	FALSE
ipgpklnkloncnddeab	FALSE
ipheeagdcmofidmmnb	FALSE
jjnagdogaknpconaeb	FALSE
jjnnjhaopdedpmlejb	FALSE
kdeoeobdchfojkjiab	FALSE
kdfohklbngnhpiogab	FALSE
knppjbdjkjhmkeihab	FALSE
kobaidoacjlkcacbep	FALSE
lhpdphjpobbmjdniab	FALSE
lhpgmhmonmbemgnbab	FALSE
mbdpdocffgcpfpmcab	FALSE
mbgldfamcpnbbadheg	FALSE
mmoknjjgehhibkciab	FALSE
mmomjbahmanhaiaaib	FALSE
nhldiljpmpjippgmab	FALSE
nhnjonnmepopbonfab	FALSE
oblndjbkhagbabcghl	FALSE
obmbbekikdeenjlgab	FALSE
olocogjpcmmoggdiab	FALSE
olonjlncccmbhmkjab	FALSE
pggkanlooeodgdogeb	FALSE
pgjcfhflgbfighjgab	FALSE
aaainngdjamceknhlmh	TRUE
aaclnoaalfnlgidoljl	TRUE
alchnkeklklepnknjin	TRUE
aldgjkmencalmjcegjd	TRUE
bflhaikiofpdadhlkhm	TRUE
bfmkgbafpkodhdicpji	TRUE
bpmdhbljaenhhefohgi	TRUE
bpmkifiepnoncpgihmo	TRUE
ckimnaeakaoodjckpck	TRUE
ckjihhnjmoidmjpblbm	TRUE
dfbcomnbdlgchfhiadc	TRUE
dfbjbafjmlekcjjajla	TRUE
dpjlkmeghilloaphgae	TRUE
dpkddnfjfalnnhiijfg	TRUE
ejlbmffmahcjpdgkoci	TRUE
ejlngaijjlcogajjjnl	TRUE
fdjklkfjdphoelhibml	TRUE
fdkaccoieclhnilaokf	TRUE
fncffjcjcpoiakkeaod	TRUE
fndpefojmcahkgpalmg	TRUE
ggkgddmhglnigphconl	TRUE
ggkgemladiljhcaojco	TRUE
gomgomhobjjjefbbhci	TRUE
gomkpjehkjfkcjcdllp	TRUE
hjjnmdmkeakkellenha	TRUE
hjkfkgmomeegdphomip	TRUE
ieialileocipkcjejjk	TRUE
ieiidefmnahfenfdghf	TRUE
ioghddklmaiimfcjnki	TRUE
iogphdkbfalggnamnaj	TRUE
jijedocdjbfggjgmkbi	TRUE
jijnbnmcbhojjndhmbc	TRUE
kdgobenoflfcdgknfda	TRUE
kdhdlmcdjahpifnkejf	TRUE
knjhhbcophnbaodeadi	TRUE
knjpclchghindclndeo	TRUE
lihkgcjjmbdcmdhdnff	TRUE
lihmmjkcjfbdaifepdh	TRUE
mblempedplhpnmkldfa	TRUE
mblmhjfkbdckkaikjkj	TRUE
mmkbfjmlcpmcbkdjnhn	TRUE
mmkollimimdpcbbcdlg	TRUE
nhghgeocamegiechihj	TRUE
nhhclokjdeekenipibn	TRUE
obbedlfjjdoaahjoghc	TRUE
obbnlhehpbjjlgnialj	TRUE
oldhfnbklcogacfpklh	TRUE
olgjchfpkcihlenjble	TRUE
pfijcfjcbmglkmcdjhc	TRUE
pfinokfmmkaijoadlin	TRUE
aabdgdjiipgapjgfenb	FALSE
aacpoilknnenhhmmfpb	FALSE
akoegfbfeakaclfjfcd	FALSE
akoijlfbhoejchkonof	FALSE
bfdhiciogimelnnogab	FALSE
bfeailpdabhlkhpibnp	FALSE
bpjekgkghbmgalddhkb	FALSE
bpkjfpknibeebcnaahb	FALSE
ckkejnpmallphpdfipb	FALSE
ckkpmhfjnnfcbloebab	FALSE
demlfgdnefefjgodnab	FALSE
demlnogkmbfpaabngbe	FALSE
dopjbokocjmijbleiab	FALSE
dopoaloebnibeodkgla	FALSE
ejjaeahkmfbfhohknid	FALSE
ejjfbeodcnnokcbkhab	FALSE
fdcmbjacncgdkponfnb	FALSE
fdcpcpckbhnoikhnkab	FALSE
fmkcniijggonkfmoakb	FALSE
fmmbikbghjngkpoekab	FALSE
gfnmdfjffomdjfkllab	FALSE
gfnoklcdjoimhkokjab	FALSE
gooelcpgemedfdbopab	FALSE
gooieboncjakangdgba	FALSE
hjmajjjbbefncclgjbp	FALSE
hjphbjdaphagbaafbog	FALSE
ifacjkdmogjflcohnob	FALSE
ifdeghecaecefpcbeie	FALSE
iolcomkhcgbipjdmkab	FALSE
ioleifhodkhdalcollb	FALSE
jipegnkaeddnppgehhb	FALSE
jjehapdegkffchgafbm	FALSE
kdolfjpnhjlikfmnlab	FALSE
kdpoimaghbfndncmhhm	FALSE
knaoigoghogkhcbijfe	FALSE
knbjbdpmelcikifioab	FALSE
lhhjidamacpcfnoohcb	FALSE
lhipoeacpoeimaklkbd	FALSE
mbiigmkclhmkmgobhab	FALSE
mbjjhohmdjldgmfamgb	FALSE
mnilfnkdkbagohfkfnb	FALSE
mnkmibhnahjcjhfakcb	FALSE
nhaaiblejpfbgcaikol	FALSE
nhbdmlaoiffkdkcpkcb	FALSE
objlnppcefibpghkpab	FALSE
obkdofghceokblggnab	FALSE
olikopbkddplmdeokab	FALSE
olklcigdcmoeoellcab	FALSE
pfnklnhpkcmddplgnab	FALSE
pfoacfaojdnfpemdggb	FALSE
